Bacterium, DNA, Iteration Born, Iteration Died, Life Span, Generation, Parent Bacterium, Number of Offspring, Alive at End
1,ACGTCGAATCTAGGGA,3,4,1,2,0,0,0
2,ACGTCGAATCTAGGGA,6,9,3,2,0,0,0
3,ACGTCGAATCTAGGGA,9,12,3,2,0,0,0
5,ACGTCGAATCTAGGGA,15,22,7,2,0,1,0
7,ACGTCGAATCTAGGGA,18,22,4,2,0,0,0
4,ACGTCGAATCTAGGGA,12,24,12,2,0,3,0
13,ACGTCGAATCTAGGGA,23,24,1,4,6,0,0
10,ACGTCGAATCTAGGGA,20,25,5,4,6,1,0
15,ACGTCGAATCTAGGGA,23,25,2,4,9,0,0
14,ACGTCGAATCTAGGGA,23,27,4,4,8,0,0
17,ACGTCGAATCTAGGGA,24,27,3,5,10,0,0
0,ACGTCGAATCTAGGGA,0,29,29,1,0,9,0
9,ACGTCGAATCTAGGGA,19,29,10,3,5,2,0
8,ACGTCGAATCTAGGGA,19,30,11,3,4,3,0
20,ACGTCGAATCTAGGGA,26,30,4,4,8,0,0
26,ACGTCGAATCTAGGGA,29,30,1,4,6,0,0
27,ACGTCGAATCTAGGGA,29,30,1,4,8,0,0
11,ACGTCGAATCTAGGGA,21,31,10,2,0,2,0
12,ACGTCGAATCTAGGGA,22,31,9,3,4,2,0
16,ACGTCGAATCTAGGGA,24,31,7,2,0,1,0
23,ACGTCGAATCTAGGGA,27,32,5,2,0,1,0
32,ACGTCGAATCTAGGGA,30,32,2,5,22,0,0
36,ACGTCGAATCTAGGGA,32,33,1,4,24,0,0
22,ACGTCGAATCTAGGGA,26,34,8,4,12,2,0
29,ACGTCGAATCTAGGGA,29,34,5,4,18,1,0
21,ACGTCGAATCTAGGGA,26,36,10,4,9,2,0
31,ACGTCGAATCTAGGGA,30,36,6,5,21,1,0
43,ACGTCGACTCTAGGGA,34,36,2,6,30,0,0
44,ACGTCGAATCTAGGGA,34,36,2,6,31,0,0
18,ACGTCGAATCTAGGGA,25,37,12,3,11,3,0
37,ACGTCGAATCTAGGGA,32,37,5,4,25,1,0
54,ACGTCGAATCTAGGGA,36,37,1,5,37,0,0
24,ACGTCGAATCTAGGGA,28,38,10,3,11,2,0
51,ACGTCGAATCTAGGGA,36,38,2,5,28,0,0
19,ACGTCGACTCTAGGGA,26,39,13,4,6,3,0
28,ACGTCGAATCTAGGGA,29,39,10,4,12,2,0
40,ACGTCGAATCTAGGGA,33,39,6,5,22,1,0
47,ACGTCGAATCTAGGGA,35,39,4,4,24,0,0
6,ACGTCGAATCTAGGGA,16,40,24,3,4,7,0
52,ACGTCGAATCTAGGGA,36,40,4,5,34,0,0
59,ACGTCGAATCTAGGGA,37,40,3,6,41,0,0
68,ACGTCGAATCTAGGGA,39,40,1,5,48,0,0
38,ACGTCGACTCTAGGGA,33,41,8,5,19,2,0
62,ACGTCGAATCTAGGGA,38,41,3,4,25,0,0
60,ACGTCGAATCTAGGGA,37,42,5,6,42,1,0
35,ACGTCGAATCTAGGGA,32,43,11,4,18,3,0
63,ACGTCGAATCAAGGGA,38,43,5,4,33,1,0
66,ACGTCGGATCTAGGGA,39,43,4,5,45,0,0
74,ACGTCGAATCTAGGGA,40,43,3,6,42,0,0
78,ACGTCGAATCAAGGGA,41,43,2,4,33,0,0
84,ACGTCGAATCTAGGGA,42,43,1,5,34,0,0
88,ACGTCGAATCTAGGGA,42,43,1,5,48,0,0
25,ACGTCGAATCTAGGGA,28,44,16,3,16,4,0
49,ACGTCGAATCAAGGGA,35,44,9,4,33,2,0
75,ACGTCGACTCTAGGGA,40,44,4,6,50,0,0
90,ACGTCGAATCTAGGGA,42,44,2,5,61,0,0
97,ACGTCGAATCTAGGGA,43,44,1,6,53,0,0
67,ACGTCGAATCTAGGGA,39,45,6,5,46,1,0
76,ACGTCGAATCTAGGGA,40,45,5,6,53,1,0
87,ACGTCGAATCTAGGGA,42,45,3,5,46,0,0
100,ACGTCGAATCTAGGGA,43,45,2,6,67,0,0
34,ACGTCGAATCTAGGGA,32,46,14,4,6,4,0
41,ACGTCGAATCTAGGGA,33,46,13,5,28,3,0
82,ACGTCGAATCTAGGGA,41,46,5,7,58,1,0
98,ACGTCGAATCTAGGGA,43,46,3,6,64,0,0
114,ACGTCGAATCTAGGGA,45,46,1,5,46,0,0
48,ACGTCGAATCTAGGGA,35,47,12,4,25,3,0
91,ACGTCGAATCAAGGGA,42,47,5,5,63,1,0
101,ACGTCGAATCAAGGGA,43,47,4,6,69,0,0
104,ACGTCGACTCTAGGGA,44,47,3,7,56,0,0
108,ACGTCGACTCTAGGGC,44,47,3,7,71,0,0
109,ACGTCGAATCTAGGGA,44,47,3,7,72,0,0
85,ACGTCGAATCTAGGGA,42,48,6,5,35,1,0
107,ACGTCGACTCTAGGGA,44,48,4,7,70,0,0
58,ACGTCGAATCTAGGGA,37,49,12,6,40,3,0
86,ACGTCGGATCTAGGGA,42,49,7,5,45,1,0
93,ACGTCGAATCTAGGGA,43,49,6,6,39,1,0
105,ACGTCGAATCTAGGGA,44,49,5,7,57,1,0
126,ACGTCGACTCTAGGGA,46,49,3,6,50,0,0
148,ACGTCGACTCTAGGGA,47,49,2,7,96,0,0
151,ACGTCGAATCTAGGGA,48,49,1,5,46,0,0
161,ACGTCGAATCTAGGGA,48,49,1,8,106,0,0
39,ACGTCGAATCTAGGGA,33,50,17,5,21,5,0
53,ACGTCGAATCTAGGGA,36,50,14,5,35,4,0
118,ACGTCGACTCTAGGGA,45,50,5,8,79,1,0
140,ACGTCGACTCTAGGGA,47,50,3,7,70,0,0
157,ACGTCGAATCTAGGGA,48,50,2,8,83,0,0
162,ACGTCGAATCTAGGGA,48,50,2,8,110,0,0
169,ACGTCGAATCTAGGGA,49,50,1,6,64,0,0
177,ACGTCGAATCTAGGGA,49,50,1,6,117,0,0
33,ACGTCGAATCAAGGGA,31,51,20,3,23,6,0
111,ACGTCGAATCTAGGGA,44,51,7,7,76,1,0
129,ACGTCGAATCTAGGGA,46,51,5,6,65,1,0
139,ACGTCGAATCTAGGGA,47,51,4,7,58,0,0
146,ACGTCGAATCTAGGGA,47,51,4,7,94,0,0
160,ACGTCGAATCTAGGGA,48,51,3,8,105,0,0
173,ACGTCGAATCTAGGGA,49,51,2,6,112,0,0
61,ACGTCGAATCTAGGGA,38,52,14,4,6,4,0
77,ACGTCGAATCTAGGGA,41,52,11,4,25,3,0
94,ACGTCGAATCTAGGGA,43,52,9,6,41,2,0
95,ACGTCGAATCTAGGGA,43,52,9,6,42,2,0
117,ACGTCGAATCTAGGGA,45,52,7,5,77,1,0
127,TCGTCGAATCTAGGGA,46,52,6,6,53,1,0
135,ACGTCGAATCAAGGGA,47,52,5,4,33,1,0
142,ACGTCGAATCTAGGGA,47,52,5,7,72,1,0
144,ACGTCGACTCTAGGGA,47,52,5,7,92,1,0
184,ACGTCGACTCTAGGGA,50,52,2,7,55,0,0
202,ACGTCGAATCAAGGGA,50,52,2,7,130,0,0
205,ACGTCGAATCAAGGGA,50,52,2,7,133,0,0
211,ACGTCGACTCTAGGGA,51,52,1,8,79,0,0
220,ACGTCGACTCTAGGGA,51,52,1,8,136,0,0
227,ACGTCGAATCTAGGGA,51,52,1,8,145,0,0
45,ACGTCGGATCTAGGGA,35,53,18,4,6,5,0
55,ACGTCGACTCTAGGGA,37,53,16,6,30,4,0
96,ACGTCGACTCTAGGGA,43,53,10,6,50,2,0
124,ACGTCGAATCTAGGGA,46,53,7,6,39,1,0
134,ACGTCGAATCAAGGGA,46,53,7,6,91,1,0
147,ACGTCGAATCTAGGGA,47,53,6,7,95,1,0
154,ACGTCGACTCTAGGGA,48,53,5,8,79,1,0
155,ACGTCGACTCTAGGGA,48,53,5,8,80,1,0
182,ACGTCGAATCTAGGGA,49,53,4,9,122,0,0
188,ACGTCGACTCTAGGGA,50,53,3,7,71,0,0
194,ACGTCGACTCTAGGGA,50,53,3,7,96,0,0
217,ACGTCGAATCTAGGGA,51,53,2,8,106,0,0
225,ACGTCGAATCTAGGGA,51,53,2,8,143,0,0
238,ACGTCGGATCTAGGGA,52,53,1,6,113,0,0
240,ACGTCGAATCTAGGGA,52,53,1,6,116,0,0
245,ACGTCGGATCTAGGGA,52,53,1,6,150,0,0
248,ACGTCGACTCTAGGGT,52,53,1,9,154,0,0
46,ACGTCGAATCTAGGGA,35,54,19,4,18,5,0
92,ACGTCGACTCTAGGGA,43,54,11,6,30,3,0
99,ACGTCGAATCTAGGGA,43,54,11,6,65,3,0
165,ACGTCGAATCTAGGGA,49,54,5,6,39,1,0
167,ACGTCGACTCTAGGGA,49,54,5,6,50,1,0
172,ACGTCGAATCAAGGGA,49,54,5,6,89,1,0
191,ACGTCGACTCTAGGGA,50,54,4,7,92,0,0
210,ACGTCGAATCTAGGGA,51,54,3,5,77,0,0
212,ACGTCGACTCTAGGGA,51,54,3,8,80,0,0
226,ACGTCGACTCTAGGGA,51,54,3,8,144,0,0
232,ACGTCGACTCTAGGGA,52,54,2,6,50,0,0
237,ACGTCGAATCTAGGGA,52,54,2,6,112,0,0
242,ACGTCGAATCTAGGGA,52,54,2,9,120,0,0
244,ACGTCGAATCTAGGGA,52,54,2,9,122,0,0
249,ACGTCGACTCTAGGGA,52,54,2,9,155,0,0
252,ACGTCGACTCTAGGGA,52,54,2,9,159,0,0
253,ACGTCGAATCTAGGGA,52,54,2,9,163,0,0
270,ACGTCGAATCTAGGGA,53,54,1,7,165,0,0
278,ACGTCGAATCTAGGGA,53,54,1,7,175,0,0
72,ACGTCGAATCTAGGGA,40,55,15,6,39,4,0
119,ACGTCGACTCTAGGGA,45,55,10,8,80,2,0
131,ACGTCGAATCTAGGGA,46,55,9,6,85,2,0
153,ACGTCGAATCTAGGGA,48,55,7,5,77,1,0
207,ACGTCGGATCTAGGGA,51,55,4,5,45,0,0
215,ACGTCGAATCAAGGGA,51,55,4,5,102,0,0
233,ACGTCGAATCTAGGGA,52,55,3,6,64,0,0
255,ACGTCGAATCAAGGGA,53,55,2,7,57,0,0
257,ACGTCGACTCTAGGGA,53,55,2,7,71,0,0
276,ACGTCGAATCAAGGGA,53,55,2,7,172,0,0
291,ACGTCGAATCTAGGGA,54,55,1,8,110,0,0
307,ACGTCGAATCTAGGGA,54,55,1,8,195,0,0
309,ACGTCGAATCTAGGGA,54,55,1,8,197,0,0
79,ACGTCGACTCTAGGGA,41,56,15,7,55,4,0
83,ACGTCGAATCTAGGGA,41,56,15,7,60,4,0
115,ACGTCGAATCTAGGGA,45,56,11,5,48,3,0
123,ACGTCGACTCTAGGGA,46,56,10,6,30,2,0
152,ACGTCGAATCTAGGGA,48,56,8,5,61,2,0
168,ACGTCGAATCTAGGGA,49,56,7,6,53,1,0
223,ACGTCGACTCGAGGGA,51,56,5,8,141,1,0
282,ACGTCGAATCTAGGGA,53,56,3,10,180,0,0
284,ACGTCGACTCTAGGGA,54,56,2,8,79,0,0
289,ACGTCGACTCTAGGGA,54,56,2,8,103,0,0
310,ACGTCGAATCTAGGGA,54,56,2,8,198,0,0
314,ACGTCGAATCTAGGGA,54,56,2,8,203,0,0
332,ACGTCGAATCTAGGGA,55,56,1,6,152,0,0
336,ACGTCGAATCTAGGGA,55,56,1,9,163,0,0
348,ACGTCGAATCTAGGGA,55,56,1,9,228,0,0
71,ACGTCGACTCTAGGGA,40,57,17,6,38,5,0
133,ACGTCGAATCAAGGGA,46,57,11,6,89,3,0
159,ACGTCGACTCTAGGGA,48,57,9,8,103,2,0
176,ACGTCGAATCTAGGGA,49,57,8,6,116,2,0
183,ACGTCGAATCAAGGGA,50,57,7,4,33,1,0
185,ACGTCGACTCTAGGGA,50,57,7,7,56,1,0
189,ACGTCGAATCTAGGGA,50,57,7,7,72,1,0
200,ACGTCGAATCTAGGGA,50,57,7,7,128,1,0
209,ACGTCGAATCTAGGGA,51,57,6,5,61,1,0
218,ACGTCGAATCTAGGGA,51,57,6,8,110,1,0
256,ACGTCGACTCTAGGGA,53,57,4,7,70,0,0
265,ACGTCGAATCAAGGGA,53,57,4,7,130,0,0
266,ACGTCGAATCTAGGGA,53,57,4,7,131,0,0
277,ACGTCGGATCTAGGGA,53,57,4,7,174,0,0
280,ACGTCGACTCTAGGGA,53,57,4,10,178,0,0
294,ACGTCGAATCTAGGGA,54,57,3,8,138,0,0
306,ACGTCGAATCTAGGGA,54,57,3,8,193,0,0
334,ACGTCGAATCAAGGGA,55,57,2,6,158,0,0
341,ACGTGGACTCTAGGGA,55,57,2,9,216,0,0
344,ACGTCGACTCTAGGGA,55,57,2,9,221,0,0
346,ACGTCGACTCGAGGGA,55,57,2,9,223,0,0
350,ACGTCGACTCTAGGGA,56,57,1,7,56,0,0
359,ACGTCGAATCAAGGGA,56,57,1,7,133,0,0
364,ACGTCGGATCTAGGGA,56,57,1,7,174,0,0
370,ACGTCGAATCTAGGGA,56,57,1,10,181,0,0
130,ACGTCGAATCAAGGGA,46,58,12,6,69,3,0
138,ACGTCGAATCTAGGGA,47,58,11,7,57,3,0
166,ACGTCGAATCTAGGGA,49,58,9,6,42,2,0
170,ACGTCGAATCTAGGGA,49,58,9,6,65,2,0
199,TCGTCGAATCTAGGGA,50,58,8,7,127,2,0
206,ACGTCGAATCAAGGGA,50,58,8,7,134,2,0
228,ACGTCGAATCTAGGGA,51,58,7,8,147,1,0
271,ACGTCGAATCTAGGGA,53,58,5,7,166,1,0
275,ACGTCGAATCAAGGGA,53,58,5,7,171,1,0
293,ACGTCGACTCTAGGGA,54,58,4,8,137,0,0
312,ACGTCGAATCTAGGGA,54,58,4,8,200,0,0
320,ACGTCGAATCTAGGGA,55,58,3,6,64,0,0
321,ACGTCGAATCTAGGGA,55,58,3,6,65,0,0
333,ACGTCGAATCTAGGGA,55,58,3,9,156,0,0
340,ACGTCGAATCTAGGGA,55,58,3,9,214,0,0
356,ACGTCGAATCTAGGGA,56,58,2,7,128,0,0
385,ACGTCGAATCAAGGGA,57,58,1,5,102,0,0
403,ACGTCGAATCTAGGGA,57,58,1,8,197,0,0
407,ACGTCGAATCTAGGGA,57,58,1,8,203,0,0
419,ACGTCGAATCAAGGGA,57,58,1,8,268,0,0
89,ACGTCGAATCAAGGGA,42,59,17,5,49,5,0
150,ACGTCGGATCTAGGGA,48,59,11,5,45,3,0
179,ACGTCGACTCTAGGGA,49,59,10,9,119,2,0
181,ACGTCGAATCTAGGGA,49,59,10,9,121,2,0
190,GCGTCGAATCTAGGGA,50,59,9,7,73,2,0
198,ACGTCGAATCTAGGGA,50,59,9,7,125,2,0
208,ACGTCGAATCTAGGGA,51,59,8,5,46,2,0
272,ACGTCGACTCTAGGGA,53,59,6,7,167,1,0
273,ACGTCGAATCTAGGGA,53,59,6,7,168,1,0
324,ACGTCGAATCTAGGGA,55,59,4,6,112,0,0
349,ACGTCGAATCTAGGGA,55,59,4,9,229,0,0
357,ACGTCGAATCAAGGGA,56,59,3,7,130,0,0
371,ACGTCGACTCTAGGGA,56,59,3,7,230,0,0
375,ACGTCGAATCAAGGGA,56,59,3,7,236,0,0
376,ACGTCGAATCTAGGGA,56,59,3,7,239,0,0
380,ACGTCGAATCTAGGGA,56,59,3,7,247,0,0
392,ACGTCGACTCTAGGGA,57,59,2,8,141,0,0
396,ACGTCGAATCTAGGGA,57,59,2,8,186,0,0
410,ACGTCGACTCTAGGGA,57,59,2,8,254,0,0
425,ACGTCGAATCAAGGGA,57,59,2,8,275,0,0
427,ACGTCGACTCTAGGGA,57,59,2,11,281,0,0
431,ACGTCGACTCTAGGGA,58,59,1,6,50,0,0
435,ACGTCGAATCAAGGGA,58,59,1,6,89,0,0
454,ACGTCGAATCTAGGGA,58,59,1,9,229,0,0
459,ACGTCGAATCTAGGGA,58,59,1,9,290,0,0
464,ACGTCGAATCTAGGGA,58,59,1,9,298,0,0
30,ACGTCGACTCTAGGGA,30,60,30,5,19,9,0
56,ACGTCGACTCTAGGGA,37,60,23,6,38,7,0
57,ACGTCGAATCTAGGGA,37,60,23,6,39,7,0
70,ACGTCGACTCTAGGGA,40,60,20,6,30,6,0
81,ACGTCGAATCTAGGGA,41,60,19,7,57,5,0
156,ACGTCGAATCTAGGGA,48,60,12,8,81,3,0
203,ACGTCGAATCTAGGGA,50,60,10,7,131,2,0
221,ACGTCGACTCTAGGGA,51,60,9,8,137,2,0
230,ACGTCGACTCTAGGGA,52,60,8,6,30,2,0
283,ACGTCGAATCTAGGGA,53,60,7,10,181,1,0
296,ACGTCGAATCTAGGGA,54,60,6,8,143,1,0
300,ACGTCGACTCTAGGGA,54,60,6,8,185,1,0
330,ACGTCGAATCTAGGGA,55,60,5,9,122,1,0
335,ACGTCGACTCTAGGGA,55,60,5,9,159,1,0
394,ACGTCGAATCTAGGGA,57,60,3,8,145,0,0
395,ACGTCGAATCTAGGGA,57,60,3,8,149,0,0
405,TCGTCGAATCTAGGGA,57,60,3,8,199,0,0
409,ACGTCGAATCAAGGGA,57,60,3,8,206,0,0
461,ACGTCGACTCTAGGGA,58,60,2,9,295,0,0
462,ACGTCGAATCTAGGGA,58,60,2,9,296,0,0
473,TCGTCGAATCTAGGGA,58,60,2,9,311,0,0
483,ACGTCGGATCTAGGGA,59,60,1,7,132,0,0
495,ACGTCGAATCTAGGGA,59,60,1,7,239,0,0
497,ACGTCGAATCTAGGGA,59,60,1,10,243,0,0
501,ACGTCGAATCAAGGGA,59,60,1,7,251,0,0
515,ACGTCGAATCTAGGGA,59,60,1,7,337,0,0
65,ACGTCGAATCTAGGGA,39,61,22,5,35,6,0
69,ACGTCGAATCAAGGGA,39,61,22,5,49,6,0
80,ACGTCGACTCTAGGGA,41,61,20,7,56,6,0
128,ACGTCGAATCTAGGGA,46,61,15,6,64,4,0
141,ACGTCGACTCTAGGGA,47,61,14,7,71,4,0
149,ACGTCGAATCTAGGGA,47,61,14,7,99,4,0
213,ACGTCGAATCTAGGGA,51,61,10,8,81,2,0
235,ACGTCGAATCAAGGGA,52,61,9,6,69,2,0
247,ACGTCGAATCTAGGGA,52,61,9,6,153,2,0
254,ACGTCGACTCTAGGGA,53,61,8,7,56,2,0
323,ACGTCGAATCAAGGGA,55,61,6,6,89,1,0
327,ACGTCGAATCTAGGGA,55,61,6,6,116,1,0
331,ACGTCGGATCTAGGGA,55,61,6,6,150,1,0
352,ACGTCGACTCTAGGGA,56,61,5,7,70,1,0
387,ACGTCGAATCTAGGGA,57,61,4,8,106,0,0
389,ACGTCGACTCTAGGGA,57,61,4,8,136,0,0
426,ACGTCGAATCTAGGGA,57,61,4,8,279,0,0
447,ACGTCGAATCTAGGGA,58,61,3,9,213,0,0
458,ACGTCGAATCAAGGGA,58,61,3,6,288,0,0
472,ACGGCGACTCTAGGGA,58,61,3,9,308,0,0
478,ACGTCGAATCTAGGGA,59,61,2,7,57,0,0
479,ACGTCGACTCTAGGGA,59,61,2,7,70,0,0
480,ACGTCGAATCTAGGGA,59,61,2,7,73,0,0
488,ACGTCGACTCTAGGGA,59,61,2,10,178,0,0
505,ACGTCGAATCAAGGGA,59,61,2,7,322,0,0
517,ACGTCGAATCTAGGGA,59,61,2,10,339,0,0
521,ACGTCGAATCTAGGGA,59,61,2,10,347,0,0
527,ACGTCGACTCTAGGGA,60,61,1,8,136,0,0
552,ACGCCGACTCTAGGGA,60,61,1,8,269,0,0
555,ACGTCGACTCTAGGGA,60,61,1,11,281,0,0
559,ACGTCGAATCTAGGGA,60,61,1,8,354,0,0
73,ACGTCGAATCTAGGGA,40,62,22,6,41,6,0
116,ACGTCGAATCTAGGGA,45,62,17,5,61,5,0
120,ACGTCGAATCTAGGGA,45,62,17,8,81,5,0
164,ACGTCGACTCTAGGGA,49,62,13,6,30,3,0
171,ACGTCGAATCAAGGGA,49,62,13,6,69,3,0
229,ACGTCGAATCTAGGGA,51,62,11,8,149,3,0
251,ACGTCGAATCAAGGGA,52,62,10,6,158,2,0
267,ACGTCGGATCTAGGGA,53,62,9,7,132,2,0
292,ACGTCGACTCTAGGGA,54,62,8,8,136,2,0
299,ACGTCGAATCAAGGGA,54,62,8,5,183,2,0
329,ACGTCGAATCTAGGGA,55,62,7,9,121,1,0
363,ACGTCGAATCAAGGGA,56,62,6,7,171,1,0
388,ACGTCGAATCTAGGGA,57,62,5,8,110,1,0
391,ACGTCGAATCTAGGGA,57,62,5,8,138,1,0
393,ACGTCGAATCTAGGGA,57,62,5,8,143,1,0
411,ACGTCGAATCTAGGGA,57,62,5,8,258,1,0
415,ACGTCGACTCTAGGGA,57,62,5,8,262,1,0
416,ACGTCGAATCTAGGGA,57,62,5,8,263,1,0
433,ACGTCGAATCTAGGGA,58,62,4,6,65,0,0
436,ACGTCGAATCTAGGGA,58,62,4,6,112,0,0
443,ACGTCGAATCTAGGGA,58,62,4,9,156,0,0
450,ACGTCGAATCAAGGGA,58,62,4,6,219,0,0
468,ACGTCGACTCTAGGGA,58,62,4,9,302,0,0
481,ACGTCGAATCTAGGGA,59,62,3,7,125,0,0
486,ACGTCGGATCTAGGGA,59,62,3,7,174,0,0
504,ACGTCGACTCTAGGGA,59,62,3,7,319,0,0
513,ACGTCGGATCTAGGGA,59,62,3,7,331,0,0
514,ACGTCGACTCTAGGGA,59,62,3,10,335,0,0
543,ACGTCGAATCTAGGGA,60,62,2,8,258,0,0
544,ACGTCGAATCTAGGGA,60,62,2,8,259,0,0
560,ACGTCGAATCTAGGGA,60,62,2,8,355,0,0
590,ACGTCGAATCTAGGGA,61,62,1,9,214,0,0
594,ACGTCGAATCTAGGGA,61,62,1,9,224,0,0
605,ACGTCGAATCAAGGGA,61,62,1,6,299,0,0
609,GCGTCGAATCTAGGGA,61,62,1,9,304,0,0
611,ACGTCGACTCTAGGGA,61,62,1,9,308,0,0
630,ACGTCGAATCTAGGGA,61,62,1,9,406,0,0
631,TCGTCGGATCTAGGGA,61,62,1,9,408,0,0
64,ACGTCGAATCTAGGGA,39,63,24,5,34,7,0
145,ACGTCGAATCTAGGGA,47,63,16,7,93,4,0
195,ACGTCGAATCTAGGGA,50,63,13,7,99,3,0
234,ACGTCGAATCTAGGGA,52,63,11,6,65,3,0
286,ACGTCGAATCTAGGGA,54,63,9,8,81,2,0
290,ACGTCGAATCTAGGGA,54,63,9,8,106,2,0
298,ACGTCGAATCTAGGGA,54,63,9,8,149,2,0
301,ACGTCGAATCTAGGGA,54,63,9,8,186,2,0
325,ACGTCGGATCTAGGGA,55,63,8,6,113,2,0
326,ACGTCGAATCTAGGGA,55,63,8,6,115,2,0
354,ACGTCGAATCTAGGGA,56,63,7,7,73,1,0
401,ACGTCGAATCTAGGGA,57,63,6,8,195,1,0
430,ACGTCGAATCTAGGGA,58,63,5,6,42,1,0
449,ACGTGGACTCTAGGGA,58,63,5,9,216,1,0
453,ACGTCGAATCTAGGGA,58,63,5,9,224,1,0
465,ACGTCGAATCAAGGGA,58,63,5,6,299,1,0
476,ACGTCGAATCAAGGGA,58,63,5,9,316,1,0
482,ACGTCGAATCTAGGGA,59,63,4,7,128,0,0
487,ACGTCGAATCTAGGGA,59,63,4,7,175,0,0
489,ACGTCGAATCTAGGGA,59,63,4,10,180,0,0
520,ACGTCGAATCTAGGGA,59,63,4,10,345,0,0
528,ACGTCGACTCTAGGGA,60,63,3,8,137,0,0
535,ACGTCGAATCTAGGGA,60,63,3,8,192,0,0
561,ACGTCGGATCTAGGGA,60,63,3,8,358,0,0
581,ACGTCGAATCTAGGGA,61,63,2,6,64,0,0
607,ACGTCGTCTCTAGGGA,61,63,2,9,302,0,0
610,ACGTCGAATCTAGGGA,61,63,2,9,305,0,0
627,ACGTCGAATCTAGGGA,61,63,2,9,401,0,0
636,ACGTCGACTCTAGGGA,61,63,2,9,415,0,0
645,ACGTCGAATCTAGGGA,61,63,2,12,428,0,0
650,ACGTCGACTCTAGGGA,62,63,1,10,178,0,0
676,ACGTCGAATCTAGGGA,62,63,1,7,432,0,0
684,ACGTCGAATCAAGGGA,62,63,1,7,444,0,0
694,ACGTCGAATCTAGGGA,62,63,1,10,457,0,0
696,ACGTCGAATCTAGGGA,62,63,1,10,463,0,0
700,ACGTCGAATCTAGGGA,62,63,1,10,469,0,0
704,ACGTCGGATCTAGGGA,62,63,1,10,475,0,0
174,ACGTCGGATCTAGGGA,49,64,15,6,113,4,0
175,ACGTCGAATCTAGGGA,49,64,15,6,115,4,0
250,ACGTCGAATCTAGGGA,52,64,12,9,156,3,0
263,ACGTCGAATCTAGGGA,53,64,11,7,125,3,0
295,ACGTCGACTCTAGGGA,54,64,10,8,141,2,0
303,ACGTCGAATCTAGGGA,54,64,10,8,189,2,0
316,ACGTCGAATCAAGGGA,54,64,10,8,206,2,0
400,ACGTCGAATCTAGGGA,57,64,7,8,193,1,0
404,ACGTCGAATCTAGGGA,57,64,7,8,198,1,0
492,ACGTCGAATCTAGGGA,59,64,5,7,234,1,0
498,ACGTCGAATCTAGGGA,59,64,5,7,246,1,0
500,ACGTCGAATCTAGGGA,59,64,5,10,250,1,0
508,ACGTCGAATCTAGGGA,59,64,5,7,326,1,0
511,ACGTCGAATCTAGGGA,59,64,5,10,329,1,0
538,ACGTCGACTCTAGGGA,60,64,4,8,196,0,0
562,ACGTCGACTCTAGGGA,60,64,4,8,360,0,0
569,ACGTCGACTCTAGGGA,60,64,4,11,368,0,0
575,ACGTCGAATCTAGGGA,60,64,4,11,378,0,0
585,ACGTCGAATCTAGGGA,61,64,3,9,120,0,0
592,ACGTCGAATCAAGGGA,61,64,3,6,219,0,0
596,ACGTCGACTCTAGGGA,61,64,3,9,285,0,0
600,ACGTCGAATCTAGGGA,61,64,3,9,290,0,0
601,ACGTCGACTCTAGGGA,61,64,3,9,292,0,0
606,ACGTCGAATCTAGGGA,61,64,3,9,301,0,0
629,ACGTCGAATCTAGGGA,61,64,3,9,404,0,0
635,ACGTCGAATCTAGGGA,61,64,3,9,414,0,0
646,ACGACGAATCTAGGGA,62,64,2,7,125,0,0
647,ACGTCGGATCTAGGGA,62,64,2,7,132,0,0
648,ACGTCGGATCTAGGGA,62,64,2,7,174,0,0
653,ACGTCGAATCTAGGGA,62,64,2,7,234,0,0
654,ACGTCGAATCAAGGGA,62,64,2,7,236,0,0
659,ACGTCGAATCTAGGGA,62,64,2,10,250,0,0
667,ACGTCGAATCTAGGGA,62,64,2,7,337,0,0
677,ACGTCGAATCAAGGGA,62,64,2,7,434,0,0
695,ACGTCGACTCTAGGGA,62,64,2,10,460,0,0
703,ACGTCGAATCTCGGGA,62,64,2,10,474,0,0
717,ACGTCGACTCTAGGGA,63,64,1,8,196,0,0
721,ACGTCGAATCTAGGGA,63,64,1,8,258,0,0
726,ACGTCGAATCTAGGGA,63,64,1,8,263,0,0
734,ACGTCGACTCTAGGGA,63,64,1,8,353,0,0
748,ACGTCGACTCTAGGGA,63,64,1,11,377,0,0
770,ACGTCGAATCTAGGGA,63,64,1,8,509,0,0
137,ACGTCGACTCTAGGGA,47,65,18,7,56,5,0
163,ACGTCGAATCTAGGGA,48,65,17,8,111,5,0
262,ACGTCGACTCTAGGGA,53,65,12,7,123,3,0
288,ACGTCGAATCAAGGGA,54,65,11,5,102,3,0
308,ACGTCGACTCTAGGGA,54,65,11,8,196,3,0
317,ACGTCGACTCTAGGGA,55,65,10,6,30,2,0
338,ACGTCGAATCTAGGGA,55,65,10,6,209,2,0
383,ACGTCGACTCTAGGGA,57,65,8,8,80,2,0
384,ACGTCGAATCTAGGGA,57,65,8,8,81,2,0
421,ACGTCGAATCTAGGGA,57,65,8,8,271,2,0
423,ACGTCGAATCTAGGGA,57,65,8,8,273,2,0
432,ACGTCGAATCTAGGGA,58,65,7,6,64,1,0
434,ACGTCGAATCAAGGGA,58,65,7,6,69,1,0
451,ACGTCGACTCTAGGGA,58,65,7,9,221,1,0
452,ACGTCGAATCTAGGGA,58,65,7,9,222,1,0
506,ACGTCGAATCAAGGGA,59,65,6,7,323,1,0
526,ACGTCGAATCTAGGGA,60,65,5,8,110,1,0
529,ACGTCGACTCTAGGGA,60,65,5,8,141,1,0
536,ACGTCGAATCTAGGGA,60,65,5,8,193,1,0
539,ACGTCGAATCTAGGGA,60,65,5,8,197,1,0
550,ACGTCGGATCTAGGGA,60,65,5,8,267,1,0
554,ACGTCGAATCTAGGGA,60,65,5,8,279,1,0
567,ACGTCGAATCTAGGGA,60,65,5,8,366,1,0
570,ACGTCGAATCTAGGGA,60,65,5,11,369,1,0
576,ACGTCGAATCTAGGGA,60,65,5,8,379,1,0
617,ACGTCGAATCTAGGGA,61,65,4,9,384,0,0
628,ACGTCGACTCTAGGGA,61,65,4,9,402,0,0
639,ACGTCGGATCTAGGGA,61,65,4,9,418,0,0
640,ACGCCGACTCTAGGGA,61,65,4,9,420,0,0
641,ACGTCGAATCTAGGGA,61,65,4,9,421,0,0
665,ACGTCGAATCTAGGGA,62,65,3,7,326,0,0
666,ACGTCGAATCTAGGGA,62,65,3,10,328,0,0
670,ACGTCGAATCTAGGGA,62,65,3,10,342,0,0
671,ACGTCGAATCAAGGGA,62,65,3,7,343,0,0
672,ACGTCGAATCTAGGGA,62,65,3,10,345,0,0
689,ACGTCGACTCTAGGGA,62,65,3,10,451,0,0
690,ACGTCGAATCTAGGGA,62,65,3,10,452,0,0
692,ACGTCGACTCTAGGGA,62,65,3,10,455,0,0
723,ACGTCGACTCTAGGGA,63,65,2,8,260,0,0
727,ACGTCGAATCTAGGGA,63,65,2,8,264,0,0
728,ACGTCGAATCAAGGGA,63,65,2,8,268,0,0
741,ACGTCGAATCTAGGGA,63,65,2,8,366,0,0
761,ACGTCGACTCTAGGGA,63,65,2,11,496,0,0
767,ACGTCGAATCAAGGGA,63,65,2,8,506,0,0
795,GCGTCGAATCTAGGGA,64,65,1,9,304,0,0
813,ACGTCGAATCTAGGGA,64,65,1,9,414,0,0
816,ACGCCGACTCTAGGGA,64,65,1,9,420,0,0
834,ACGTCGAATCTAGGGA,64,65,1,9,537,0,0
836,ACGTCGAATCTAGGGA,64,65,1,9,540,0,0
849,ACGTCGACTCTAGGGA,64,65,1,9,557,0,0
851,ACGTCGAATCTAGGGA,64,65,1,9,563,0,0
853,ACGTCGAATCAAGGGA,64,65,1,9,565,0,0
855,ACGTCGAATCTAGGGA,64,65,1,9,567,0,0
861,ACGTCGACTCTAGGGA,64,65,1,12,574,0,0
862,ACGTCGAATCTAGGGA,64,65,1,9,576,0,0
864,ACGTCGAATCAAGGGA,64,65,1,9,578,0,0
112,ACGTCGAATCTAGGGA,45,66,21,5,34,6,0
192,ACGTCGAATCTAGGGA,50,66,16,7,94,4,0
201,ACGTCGAATCTAGGGA,50,66,16,7,129,4,0
214,ACGTCGAATCTAGGGA,51,66,15,8,83,4,0
260,ACGTCGACTCTAGGGA,53,66,13,7,92,3,0
285,ACGTCGACTCTAGGGA,54,66,12,8,80,3,0
311,TCGTCGAATCTAGGGA,54,66,12,8,199,3,0
337,ACGTCGAATCTAGGGA,55,66,11,6,208,3,0
374,ACGTCGAATCAAGGGA,56,66,10,7,235,2,0
397,ACGTCGACTCTAGGGA,57,66,9,8,187,2,0
420,ACGCCGACTCTAGGGA,57,66,9,8,269,2,0
446,ACGTCGAATCTAGGGA,58,66,8,6,208,2,0
499,ACGTCGAATCTAGGGA,59,66,7,7,247,1,0
503,ACGTCGAATCTAGGGA,59,66,7,7,318,1,0
549,ACGTCGAATCTAGGGA,60,66,6,8,264,1,0
558,ACGTCGACTCTAGGGA,60,66,6,8,353,1,0
565,ACGTCGAATCAAGGGA,60,66,6,8,363,1,0
566,ACGTCGAATCTAGGGA,60,66,6,8,365,1,0
578,ACGTCGAATCAAGGGA,60,66,6,8,382,1,0
595,ACGTCGAATCTAGGGA,61,66,5,9,229,1,0
625,ACGTCGAATCTAGGGA,61,66,5,9,399,1,0
633,ACGTCGAATCTAGGGA,61,66,5,9,412,1,0
651,ACGTCGAATCTAGGGA,62,66,4,10,180,0,0
652,ACGTCGAATCTAGGGA,62,66,4,7,231,0,0
662,ACGTCGACTCTAGGGA,62,66,4,7,319,0,0
687,ACGTCGAATCTAGGGA,62,66,4,10,448,0,0
710,ACGTCGACTCTAGGGA,63,66,3,8,136,0,0
720,ACGTCGGATCTAGGGA,63,66,3,8,204,0,0
743,ACGTCGACTCTAGGGA,63,66,3,11,368,0,0
768,ACGTCGGATCTAGGGA,63,66,3,8,507,0,0
777,ACGTCGAATCTAGGGA,64,66,2,6,42,0,0
782,ACGTCGAATCTAGGGA,64,66,2,9,122,0,0
810,ACGTCGGATCTAGGGA,64,66,2,9,408,0,0
819,ACGTCGAATCTAGGGA,64,66,2,9,423,0,0
827,ACGTCGACTCTAGGGA,64,66,2,9,529,0,0
831,ACGTCGAATCTAGGGA,64,66,2,9,533,0,0
835,ACGTCGAATCTAGGGA,64,66,2,9,539,0,0
852,ACGTCGAATCTAGGGA,64,66,2,9,564,0,0
865,ACGTCGAATCTAGGGA,65,66,1,7,125,0,0
867,ACGTCGACTCTAGGGA,65,66,1,10,178,0,0
868,ACGTCGAATCTAGGGA,65,66,1,10,180,0,0
877,ACGTCGAATCAAGGGA,65,66,1,7,322,0,0
882,ACGTCGAATCAAGGGA,65,66,1,7,343,0,0
887,ACGTCGAATCTAGGGA,65,66,1,7,438,0,0
889,ACGTCGAATCTAGGGA,65,66,1,10,440,0,0
917,ACGTGGACTCTAGGGA,65,66,1,10,591,0,0
926,ACGTCGAATCTAGGGA,65,66,1,10,608,0,0
933,ACGTCGAATCTAGGGA,65,66,1,10,619,0,0
945,ACGTCGAATCTAGGGA,65,66,1,10,638,0,0
113,ACGTCGGATCTAGGGA,45,67,22,5,45,6,0
187,ACGTCGACTCTAGGGA,50,67,17,7,70,5,0
231,ACGTCGAATCTAGGGA,52,67,15,6,42,4,0
239,ACGTCGAATCTAGGGA,52,67,15,6,115,4,0
241,ACGTCGACTCTAGGGA,52,67,15,9,119,4,0
287,ACGTCGAATCTAGGGA,54,67,13,8,83,3,0
319,ACGTCGACTCTAGGGA,55,67,12,6,50,3,0
322,ACGTCGAATCAAGGGA,55,67,12,6,69,3,0
366,ACGTCGAATCTAGGGA,56,67,11,7,176,3,0
372,ACGTCGAATCTAGGGA,56,67,11,7,231,3,0
377,ACGTCGACTCTAGGGA,56,67,11,10,241,3,0
412,ACGTCGAATCTAGGGA,57,67,10,8,259,2,0
422,ACGTCGACTCTAGGGA,57,67,10,8,272,2,0
429,ACGTCGACTCTAGGGA,58,67,9,6,30,2,0
457,ACGTCGAATCTAGGGA,58,67,9,9,287,2,0
484,ACGTCGACTCTAGGGA,59,67,8,7,164,2,0
494,ACGTCGAATCAAGGGA,59,67,8,7,236,2,0
507,ACGTCGGATCTAGGGA,59,67,8,7,325,2,0
523,ACGTCGAATCAAGGGA,60,67,7,5,102,1,0
573,ACGTCGAATCAAGGGA,60,67,7,8,374,1,0
644,ACGTCGAATCTAGGGA,61,67,6,9,424,1,0
664,ACGTCGGATCTAGGGA,62,67,5,7,325,1,0
682,ACGTCGAATCTAGGGA,62,67,5,10,441,1,0
711,ACGTCGACTCTAGGGA,63,67,4,8,137,0,0
729,ACGCCGACTCTAGGGA,63,67,4,8,269,0,0
749,ACGTCGAATCTAGGGA,63,67,4,11,378,0,0
751,ACGTCGAATCTAGGGA,63,67,4,11,381,0,0
765,ACGTCGACTCTAGGGA,63,67,4,8,502,0,0
798,TCGTCGAATCTAGGGA,64,67,3,9,311,0,0
801,ACGTCGACTCTAGGGA,64,67,3,9,383,0,0
802,ACGTCGAATCTAGGGA,64,67,3,9,384,0,0
805,ACGTCGACTCTAGGGA,64,67,3,9,397,0,0
823,ACGTCGAATCAAGGGA,64,67,3,6,523,0,0
828,ACGTCGAATCTAGGGA,64,67,3,9,530,0,0
840,ACGTCGAATCTAGGGA,64,67,3,9,546,0,0
856,ACGTCGACTGTAGGGA,64,67,3,12,568,0,0
874,ACGTCGAATCTAGGGA,65,67,2,7,246,0,0
884,ACGTCGAATCTAGGGA,65,67,2,10,347,0,0
902,ACGTCGAATCTAGGGA,65,67,2,10,467,0,0
907,ACGTCGGATCTAGGGA,65,67,2,10,475,0,0
909,ACGTCGACTCTAGGGA,65,67,2,7,580,0,0
931,ACGTCGACTCTAGGGA,65,67,2,10,616,0,0
937,ACGTCGACTCTAGGGA,65,67,2,10,623,0,0
943,ACGTCGACTCTAGGGA,65,67,2,10,634,0,0
947,ACGTCGAATCTAGGGA,65,67,2,10,643,0,0
954,ACGTCGAATCTAGGGA,66,67,1,8,143,0,0
957,ACGTCGAATCTAGGGA,66,67,1,8,193,0,0
962,ACGTCGAATCTAGGGA,66,67,1,8,259,0,0
974,ACGTCGACTCTAGGGA,66,67,1,8,360,0,0
978,ACGTCGAATCTAGGGA,66,67,1,8,366,0,0
987,ACGTCGAATCTAGGGA,66,67,1,11,381,0,0
1001,ACGTCGAATCTAGGGA,66,67,1,11,512,0,0
1022,ACGTCGAATCTAGGGA,66,67,1,11,681,0,0
216,ACGTGGACTCTAGGGA,51,68,17,8,103,5,0
268,ACGTCGAATCAAGGGA,53,68,15,7,133,4,0
305,ACGTCGAATCTAGGGA,54,68,14,8,192,4,0
315,ACGTCGGATCTAGGGA,54,68,14,8,204,4,0
355,ACGTCGAATCTAGGGA,56,68,12,7,125,3,0
382,ACGTCGAATCAAGGGA,56,68,12,7,251,3,0
414,ACGTCGAATCTAGGGA,57,68,11,8,261,3,0
439,ACGTCGAATCTAGGGA,58,68,10,9,120,2,0
444,ACGTCGAATCAAGGGA,58,68,10,6,158,2,0
460,ACGTCGACTCTAGGGA,58,68,10,9,292,2,0
485,ACGTCGAATCAAGGGA,59,68,9,7,171,2,0
490,ACGTCGACTCTAGGGA,59,68,9,7,230,2,0
516,ACGTCGAATCTAGGGA,59,68,9,7,338,2,0
542,ACGTCGACTCTAGGGA,60,68,8,8,254,2,0
551,ACGTCGAATCAAGGGA,60,68,8,8,268,2,0
582,ACGTCGAATCTAGGGA,61,68,7,6,112,1,0
593,ACGTCGAATCTAGGGA,61,68,7,9,222,1,0
613,ACGTCGAATCTCGGGA,61,68,7,9,313,1,0
614,ACGTCGGATCTAGGGA,61,68,7,9,315,1,0
616,ACGTCGACTCTAGGGA,61,68,7,9,383,1,0
658,ACGTCGAATCTAGGGA,62,68,6,7,246,1,0
681,ACGTCGAATCTAGGGA,62,68,6,10,440,1,0
691,AGGTCGAATCTAGGGA,62,68,6,10,453,1,0
712,ACGTCGAATCTAGGGA,63,68,5,8,143,1,0
714,ACGTCGACTCTAGGGA,63,68,5,8,187,1,0
719,ACGTCGAATCTAGGGA,63,68,5,8,201,1,0
722,ACGTCGAATCTAGGGA,63,68,5,8,259,1,0
744,ACGTCGAATCTAGGGA,63,68,5,11,369,1,0
756,ACGTCGACTCTAGGGA,63,68,5,8,490,1,0
788,ACGTCGAATCTAGGGA,64,68,4,9,222,0,0
794,ACGTCGACTCTAGGGA,64,68,4,9,302,0,0
815,ACGTCGGATCTAGGGA,64,68,4,9,418,0,0
844,ACGTCGGATCTAGGGA,64,68,4,9,550,0,0
919,ACGTCGAATCTAGGGA,65,68,3,10,595,0,0
921,ACGTCGAATCTAGGGA,65,68,3,10,598,0,0
927,TCGTCGAATCTAGGGA,65,68,3,10,612,0,0
940,ACGTCGAATCTAGGGA,65,68,3,10,626,0,0
961,ACGTCGAATCTAGGGA,66,68,2,8,258,0,0
966,ACGCCGACTCTAGGGA,66,68,2,8,269,0,0
973,ACGTCGGATCTAGGGA,66,68,2,8,358,0,0
977,ACGTCGAATCTAGGGA,66,68,2,8,365,0,0
994,ACGTCGAATCAAGGGA,66,68,2,8,493,0,0
1043,ACGTCGAATCTAGGGA,67,68,1,9,222,0,0
1054,ACGTCGAATCTAGGGA,67,68,1,9,399,0,0
1056,ACGTCGAATCTAGGGA,67,68,1,9,406,0,0
1057,ACGTCGGATCTAGGGA,67,68,1,9,408,0,0
1069,ACGTCGAATCTAGGGA,67,68,1,9,532,0,0
1078,ACGTCGACTCTAGGGA,67,68,1,9,547,0,0
1085,ACGTCGAATCTAGGGA,67,68,1,9,564,0,0
1092,ACGTCGACTCTAGGGA,67,68,1,9,707,0,0
1098,ACGTCGAATCTAGGGA,67,68,1,9,715,0,0
1099,ACGTCGAATCTAGGGA,67,68,1,9,716,0,0
1124,ACGTCGAATCAAGGGA,67,68,1,9,755,0,0
1125,ACGTCGACTCTAGGGA,67,68,1,9,756,0,0
110,ACGTCGAATCTAGGGA,44,69,25,7,73,7,0
143,ACGTCGAATCTAGGGA,47,69,22,7,73,6,0
196,ACGTCGACTCTAGGGA,50,69,19,7,123,5,0
219,ACGTCGAATCAAGGGA,51,69,18,5,135,5,0
261,ACGTCGAATCTAGGGA,53,69,16,7,99,4,0
274,ACGTCGAATCTAGGGA,53,69,16,7,170,4,0
279,ACGTCGAATCTAGGGA,53,69,16,7,176,4,0
365,ACGTCGAATCTAGGGA,56,69,13,7,175,3,0
442,ACGTCGGATCTAGGGA,58,69,11,6,150,3,0
509,ACGTCGAATCTAGGGA,59,69,10,7,327,2,0
532,ACGTCGAATCTAGGGA,60,69,9,8,149,2,0
537,ACGTCGAATCTAGGGA,60,69,9,8,195,2,0
589,ACGTCGAATCTAGGGA,61,69,8,9,163,2,0
615,ACGTCGAATCAAGGGA,61,69,8,9,316,2,0
621,ACGTCGAATCTAGGGA,61,69,8,9,391,2,0
624,GCGTCGAATCTAGGGA,61,69,8,9,398,2,0
632,ACGTCGAATCTAGGGA,61,69,8,9,411,2,0
669,ACGTCGAATCTAGGGA,62,69,7,10,339,1,0
673,ACGTCGAATCTAGGGA,62,69,7,10,347,1,0
713,ACGTCGAATCTAGGGA,63,69,6,8,186,1,0
736,ACGTCGGATCTAGGGA,63,69,6,8,358,1,0
739,ACGTCGAATCTAGGGA,63,69,6,8,362,1,0
745,ACGTCGAATCTAGGGA,63,69,6,8,372,1,0
754,ACGTCGACTCTAGGGA,63,69,6,8,484,1,0
779,ACGTCGAATCTAGGGA,64,69,5,6,112,1,0
814,ACGTCGAATCTAGGGA,64,69,5,9,417,1,0
821,ACGTCGAATCTAGGGA,64,69,5,12,428,1,0
863,ACGTCGAATCTAGGGA,64,69,5,12,577,1,0
886,ACGTCGCATCTAGGGA,65,69,4,7,437,0,0
896,ACGTCGACTCTAGGGA,65,69,4,10,455,0,0
908,ACGTCGAATCTAGGGA,65,69,4,7,579,0,0
942,ACGTCGAATCTAGGGA,65,69,4,10,633,0,0
953,ACGTCGACTCTAGGGA,66,69,3,8,136,0,0
958,ACGTCGACTCTAGGGA,66,69,3,8,196,0,0
964,ACGTCGAATCTAGGGA,66,69,3,8,264,0,0
980,ACGTCGACTCTAGGGA,66,69,3,11,368,0,0
989,ACGTCGACTCTAGGGA,66,69,3,8,477,0,0
990,ACGTCGACTCTAGGGA,66,69,3,8,484,0,0
996,ACGTCGACTCTAGGGA,66,69,3,11,496,0,0
1004,ACGTCGAATCAAGGGA,66,69,3,8,519,0,0
1013,ACGTCGGATCTAGGGA,66,69,3,8,664,0,0
1015,ACGTCGAATCTAGGGA,66,69,3,11,669,0,0
1019,ACGTCGCATCTAGGGA,66,69,3,8,678,0,0
1038,ACGTCGAATCTAGGGA,67,69,2,9,121,0,0
1072,ACGTCGAATCTAGGGA,67,69,2,9,537,0,0
1073,ACGTCGAATCTAGGGA,67,69,2,9,540,0,0
1097,ACGTCGACTCTAGGGA,67,69,2,9,714,0,0
1101,ACGTCGAATCTAGGGA,67,69,2,9,719,0,0
1104,ACGTCGACTCTAGGGA,67,69,2,9,725,0,0
1107,ACGTCGACTCTAGGGA,67,69,2,12,732,0,0
1132,ACGTCGAATCTAGGGA,67,69,2,12,764,0,0
1153,ACGTCGAATCTAGGGA,68,69,1,10,345,0,0
1181,ACGTCGAATCTAGGGA,68,69,1,10,597,0,0
1194,ACGTCGAATCTAGGGA,68,69,1,10,622,0,0
1198,ACGTCGAATCTAGGGA,68,69,1,10,632,0,0
1206,ACGTCGGATCTAGGGA,68,69,1,7,780,0,0
1236,ACGTCGACTCTAGGGA,68,69,1,10,824,0,0
1250,ACGTCGAACCTAGGGA,68,69,1,10,846,0,0
373,ACGTCGAATCTAGGGA,56,70,14,7,234,4,0
398,GCGTCGAATCTAGGGA,57,70,13,8,190,3,0
417,ACGTCGAATCTAGGGA,57,70,13,8,264,3,0
455,ACGTCGACTCTAGGGA,58,70,12,9,285,3,0
474,ACGTCGAATCTCGGGA,58,70,12,9,313,3,0
518,ACGTCGAATCTAGGGA,59,70,11,10,342,3,0
580,ACGTCGACTCTAGGGA,61,70,9,6,50,2,0
591,ACGTGGACTCTAGGGA,61,70,9,9,216,2,0
649,ACGTCGAATCTAGGGA,62,70,8,7,175,2,0
656,ACGTCGACTCTAGGGA,62,70,8,10,241,2,0
701,GCGTCGAATCTAGGGA,62,70,8,10,470,2,0
773,ACGTCGAATCTAGGGA,63,70,7,11,512,1,0
785,ACGTCGAATCTAGGGA,64,70,6,9,214,1,0
824,ACGTCGACTCTAGGGA,64,70,6,9,524,1,0
832,ACGTCGACTCTAGGGA,64,70,6,9,534,1,0
839,ACGTCGACTCTAGGGA,64,70,6,9,545,1,0
845,ACGTCGAATCAAGGGA,64,70,6,9,551,1,0
846,ACGTCGAACCTAGGGA,64,70,6,9,553,1,0
869,ACGTCAAATCTAGGGA,65,70,5,7,231,1,0
915,ACGTCGAATCAAGGGA,65,70,5,7,588,1,0
923,ACGTCGACTCTAGGGC,65,70,5,10,602,1,0
928,ACGTCGAATCTCGGGA,65,70,5,10,613,1,0
969,ACGTCGACTCTAGGGA,66,70,4,11,281,0,0
975,ACGTCGAATCTAGGGA,66,70,4,8,361,0,0
991,ACGTCGAATCAAGGGA,66,70,4,8,485,0,0
992,ACGTCGACTCTAGGGA,66,70,4,8,490,0,0
1008,ACGTCGAATCTAGGGA,66,70,4,11,657,0,0
1035,ACGTCGAATCAAGGGA,66,70,4,11,705,0,0
1036,ACGTCGAATCTAGGGA,67,70,3,6,42,0,0
1041,ACGTGGACTCTAGGGA,67,70,3,9,216,0,0
1052,ACGTCGACTCTAGGGA,67,70,3,9,390,0,0
1077,ACGTCGAATCTAGGGA,67,70,3,9,546,0,0
1113,ACGTCGAATCTAGGGA,67,70,3,9,739,0,0
1115,ACGTCGACTCTAGGGA,67,70,3,12,742,0,0
1136,ACGTCGAATCTAGGGA,67,70,3,12,772,0,0
1144,ACGTCGAATCTAGGGA,68,70,2,10,180,0,0
1154,ACGTCGAATCTAGGGA,68,70,2,10,347,0,0
1161,ACGTCGAATCTAGGGA,68,70,2,10,448,0,0
1164,ACGTCGAATCTAGGGA,68,70,2,10,463,0,0
1175,ACGTCGAATCTAGGGA,68,70,2,7,584,0,0
1177,ACGTCGAATCTAGGGA,68,70,2,10,587,0,0
1183,ACGTCGAATCAAGGGA,68,70,2,7,599,0,0
1218,ACGTCGAATCTAGGGA,68,70,2,10,796,0,0
1226,ACGTCGACTCTAGGGA,68,70,2,10,808,0,0
1231,ACGTCGAATCTAGGGA,68,70,2,10,817,0,0
1238,ACGTCGAATCTAGGGA,68,70,2,10,826,0,0
1244,ACGTCGACTCTAGGGA,68,70,2,10,838,0,0
1263,ACGTCGACTCTAGGGA,69,70,1,8,136,0,0
1268,ACGTCGAATCTAGGGA,69,70,1,8,258,0,0
1307,ACGTCGAATCTAGGGA,69,70,1,11,680,0,0
1320,ACGTCAAATCTAGGGA,69,70,1,8,869,0,0
1334,ACGTCGAATCTAGGGA,69,70,1,11,890,0,0
1345,ACGTCGAATCTAGGGA,69,70,1,11,903,0,0
1349,ACGTCGAATCTAGGGA,69,70,1,8,910,0,0
1364,ACGTCGAATCAAGGGA,69,70,1,11,930,0,0
1365,ACGTCGACTCTAGGGA,69,70,1,11,932,0,0
121,ACGTCGAATCTAGGGA,45,71,26,8,82,8,0
178,ACGTCGACTCTAGGGA,49,71,22,9,118,6,0
402,ACGTCGACTCTAGGGA,57,71,14,8,196,4,0
524,ACGTCGACTCTAGGGA,60,71,11,8,103,3,0
563,ACGTCGAATCTAGGGA,60,71,11,8,361,3,0
574,ACGTCGACTCTAGGGA,60,71,11,11,377,3,0
577,ACGTCGAATCTAGGGA,60,71,11,11,381,3,0
584,ACGTCGAATCTAGGGA,61,71,10,6,116,2,0
587,ACGTCGAATCTAGGGA,61,71,10,9,122,2,0
619,ACGTCGAATCTAGGGA,61,71,10,9,388,2,0
622,ACGTCGAATCTAGGGA,61,71,10,9,393,2,0
623,ACGTCGACTCTAGGGA,61,71,10,9,397,2,0
638,ACGTCGAATCTAGGGA,61,71,10,9,417,2,0
657,ACGTCGAATCTAGGGA,62,71,9,10,243,2,0
718,ACGTCGAATCTAGGGA,63,71,8,8,197,2,0
750,ACGTCGAATCTAGGGA,63,71,8,8,379,2,0
762,ACGTCGAATCTAGGGA,63,71,8,8,498,2,0
763,ACGTCGAATCTAGGGA,63,71,8,8,499,2,0
799,ACGTCGAATCTCGGGA,64,71,7,9,313,1,0
803,ACGTCGACTCTAGGGA,64,71,7,9,386,1,0
806,GCGTCGAATCTAGGGA,64,71,7,9,398,1,0
809,ACGTCGAATCTAGGGA,64,71,7,9,406,1,0
822,ACGTCGACTCTAGGGA,64,71,7,9,522,1,0
829,ACGTCGAATCTAGGGA,64,71,7,9,531,1,0
843,ACGTCGAATCTAGGGA,64,71,7,9,549,1,0
860,ACGTCGAATCAAGGGA,64,71,7,9,573,1,0
872,ACGTCGACTCTAGGGA,65,71,6,10,241,1,0
891,ACGTCGGATCTAGGGA,65,71,6,7,442,1,0
895,ACGTCGAATCTAGGGA,65,71,6,10,448,1,0
900,ACGTCGAATCTAGGGA,65,71,6,10,463,1,0
930,ACGTCGAATCAAGGGA,65,71,6,10,615,1,0
951,ACGTCGAATCTAGGGA,66,71,5,8,106,1,0
983,ACGTCGAATCTAGGGA,66,71,5,8,373,1,0
1006,ACGTCGAATCTAGGGA,66,71,5,8,655,1,0
1007,ACGTCGACTCTAGGGA,66,71,5,11,656,1,0
1018,ACGTCGAATCTAGGGA,66,71,5,8,675,1,0
1020,ACGTCGAATCTAGGGA,66,71,5,8,679,1,0
1029,ACGTCGAGTCTAGGGA,66,71,5,11,693,1,0
1040,ACGTCGAATCAAGGGA,67,71,4,6,158,0,0
1044,ACGTCGAATCTAGGGA,67,71,4,9,224,0,0
1045,ACGTCGAATCTAGGGA,67,71,4,9,297,0,0
1053,GCGTCGAATCTAGGGA,67,71,4,9,398,0,0
1068,ACGTCGAATCTAGGGA,67,71,4,9,531,0,0
1075,ACGTCGACTCTAGGGA,67,71,4,9,542,0,0
1079,ACGTCGAATCTAGGGA,67,71,4,9,548,0,0
1089,ACGTCGACTCTAGGGA,67,71,4,12,574,0,0
1090,ACGTCGAATCTAGGGA,67,71,4,12,577,0,0
1102,ACGTCGAATCTAGGGA,67,71,4,9,722,0,0
1103,ACGTCGAATCTAGGGA,67,71,4,9,724,0,0
1121,ACGTCGAATCAAGGGA,67,71,4,9,752,0,0
1126,ACGTCGAATCTAGGGA,67,71,4,9,757,0,0
1130,ACGTCGAATCTAGGGA,67,71,4,9,762,0,0
1140,ACGTCGAATCAAGGGA,67,71,4,9,776,0,0
1142,ACGTCGGATCTAGGGA,68,71,3,7,132,0,0
1151,ACGTCGAATCTAGGGA,68,71,3,10,342,0,0
1182,ACGTCGAATCTAGGGA,68,71,3,10,598,0,0
1246,ACGTCGACTCTAGGGA,68,71,3,10,841,0,0
1266,ACGTCGAATCTAGGGA,69,71,2,8,197,0,0
1279,ACGTCGACTCTAGGGA,69,71,2,11,367,0,0
1298,ACGTCGAATCTAGGGA,69,71,2,11,657,0,0
1304,ACGTCGAATCTAGGGA,69,71,2,8,675,0,0
1311,ACGTGGACTCTAGGGA,69,71,2,11,688,0,0
1329,ACGTCGAATCTAGGGA,69,71,2,11,880,0,0
1332,ACGTCGACTCTAGGGA,69,71,2,8,885,0,0
1335,ACGTCGGATCTAGGGA,69,71,2,8,891,0,0
1340,ACGTCGAATCTAGGGA,69,71,2,11,897,0,0
1344,ACGTCGACTCTAGGGA,69,71,2,11,901,0,0
1347,ACGTCGAATCTAGGGA,69,71,2,11,905,0,0
1359,ACGTCGACTCTAGGGC,69,71,2,11,923,0,0
1373,ACGTCGACTCTAGGGA,69,71,2,11,946,0,0
1377,ACGTCGAATCAAGGGA,70,71,1,9,121,0,0
1391,ACGTCGGATCTAGGGA,70,71,1,9,408,0,0
1398,ACGTCGAATCTAGGGA,70,71,1,9,525,0,0
1402,ACGTCGACTCTAGGGA,70,71,1,9,534,0,0
1424,ACGTCGAATCTAGGGA,70,71,1,9,716,0,0
1445,ACGTCGAATCAAGGGA,70,71,1,9,759,0,0
1449,ACGTCGAATCTAGGGA,70,71,1,12,764,0,0
1462,ACGTCGACTCTAGGGA,70,71,1,9,956,0,0
1470,ACGTCAACTCTAGGGA,70,71,1,9,971,0,0
1471,ACGTCGAATCTAGGGA,70,71,1,9,972,0,0
1486,ACGTCGAATCTAGGGA,70,71,1,12,1000,0,0
193,ACGTCGAATCTAGGGA,50,72,22,7,95,6,0
222,ACGTCGAATCTAGGGA,51,72,21,8,138,6,0
304,GCGTCGAATCTAGGGA,54,72,18,8,190,5,0
353,ACGTCGACTCTAGGGA,56,72,16,7,71,4,0
358,ACGTCGGATCTAGGGA,56,72,16,7,132,4,0
362,ACGTCGAATCTAGGGA,56,72,16,7,170,4,0
445,ACGTCGAATCTAGGGA,58,72,14,9,163,4,0
469,ACGTCGAATCTAGGGA,58,72,14,9,303,4,0
608,ACGTCGAATCTAGGGA,61,72,11,9,303,3,0
618,ACGTCGACTCTAGGGA,61,72,11,9,386,3,0
642,ACGTCGACTCTAGGGA,61,72,11,9,422,3,0
668,ACGTCGAATCTAGGGA,62,72,10,7,338,2,0
674,ACGTCGACTCTAGGGA,62,72,10,7,429,2,0
688,ACGTGGACTCTAGGGA,62,72,10,10,449,2,0
716,ACGTCGAATCTAGGGA,63,72,9,8,193,2,0
747,ACGTCGAATCAAGGGA,63,72,9,8,374,2,0
755,ACGTCGAATCAAGGGA,63,72,9,8,485,2,0
771,ACGTCGAATCTAGGGA,63,72,9,11,510,2,0
776,ACGTCGAATCAAGGGA,63,72,9,8,519,2,0
783,ACGTCGAATCAAGGGA,64,72,8,6,158,2,0
807,ACGTCGAATCTAGGGA,64,72,8,9,399,2,0
812,ACGTCGACTCTAGGGA,64,72,8,9,413,2,0
841,ACGTCGACTCTAGGGA,64,72,8,9,547,2,0
890,ACGTCGAATCTAGGGA,65,72,7,10,441,1,0
904,GCGTCGAATCTAGGGA,65,72,7,10,470,1,0
910,ACGTCGAATCTAGGGA,65,72,7,7,582,1,0
948,ACGTCGAATCTAGGGA,65,72,7,10,644,1,0
950,ACGTCGACTCTAGGGA,66,72,6,8,103,1,0
972,ACGTCGAATCTAGGGA,66,72,6,8,355,1,0
984,ACGTCGACTCTAGGGA,66,72,6,11,377,1,0
993,ACGTCGAATCTAGGGA,66,72,6,8,491,1,0
1009,ACGTCGAATCTAGGGA,66,72,6,8,658,1,0
1012,ACGTCGAATCAAGGGA,66,72,6,8,663,1,0
1014,ACGTCGAATCTAGGGA,66,72,6,8,668,1,0
1026,ACGTCGAATCTAGGGA,66,72,6,8,686,1,0
1047,GCGTCGAATCTAGGGA,67,72,5,9,304,1,0
1064,ACGTCGACTCTAGGGA,67,72,5,9,522,1,0
1080,ACGTCGAATCAAGGGA,67,72,5,9,551,1,0
1082,ACGTCGAATCTAGGGA,67,72,5,9,556,1,0
1131,ACGTCGAATCTAGGGA,67,72,5,9,763,1,0
1138,ACGTCGAATCTAGGGA,67,72,5,9,774,1,0
1190,ACGTCGACTCTAGGGA,68,72,4,10,618,0,0
1191,ACGTCGAATCTAGGGA,68,72,4,10,619,0,0
1224,GCGTCGAATCTAGGGA,68,72,4,10,806,0,0
1253,ACGTCGACTCTAGGGA,68,72,4,10,850,0,0
1256,ACGTCGAATCTAGGGA,68,72,4,10,858,0,0
1262,ACGTCGAATCTAGGGA,69,72,3,8,106,0,0
1272,ACGTCGACTCTAGGGA,69,72,3,11,281,0,0
1273,ACGTCGAATCTAGGGA,69,72,3,8,351,0,0
1275,ACGTCGGATCTAGGGA,69,72,3,8,358,0,0
1305,ACGTCGCATCTAGGGA,69,72,3,8,678,0,0
1310,ACGTCGAATCTAGGGA,69,72,3,8,686,0,0
1355,ACGTCGAATCTAGGGA,69,72,3,11,916,0,0
1357,ACGTAGAATCTAGGGA,69,72,3,11,920,0,0
1358,ACGTCGAATCAAGGGA,69,72,3,8,922,0,0
1371,ACGTCGAATCTAGGGA,69,72,3,11,941,0,0
1384,GCGTCGAATCTAGGGA,70,72,2,9,304,0,0
1387,ACGTCGACTCTAGGGA,70,72,2,9,390,0,0
1392,ACGTCGACTCTAGGGA,70,72,2,9,413,0,0
1425,ACGTCGAATCTAGGGA,70,72,2,9,718,0,0
1440,ACGTCGAATCAAGGGA,70,72,2,9,752,0,0
1450,ACGTCGAATCTAGGGA,70,72,2,9,766,0,0
1455,ACGTCGAATCTAGGGA,70,72,2,12,775,0,0
1456,ACGTCGAATCAAGGGA,70,72,2,9,776,0,0
1457,ACGTCGAATCAAGGGA,70,72,2,6,949,0,0
1460,ACGTCGAATCTAGGGA,70,72,2,9,952,0,0
1468,ACGTCGAATCTAGGGA,70,72,2,9,968,0,0
1473,ACGTCGACTCTAGGGA,70,72,2,12,979,0,0
1485,ACGTCGAATCTAGGGA,70,72,2,9,999,0,0
1488,ACGTCGAATCTAGGGA,70,72,2,12,1003,0,0
1501,ACGTCGAATCTAGGGA,70,72,2,12,1021,0,0
1502,ACGTCGAATCTAGGGC,70,72,2,12,1023,0,0
1503,ACATCGGATCTAGGGA,70,72,2,9,1024,0,0
1532,ACGTCGAATCTAGGGA,71,72,1,10,448,0,0
1561,ACGTCGGATCTAGGGA,71,72,1,7,780,0,0
1568,ACGTCGACTCTAGGGA,71,72,1,10,790,0,0
1580,ACGTCGAATCTAGGGA,71,72,1,10,817,0,0
1594,ACGTCGAATCTAGGGA,71,72,1,10,854,0,0
1599,ACGTCGAATCTAGGGA,71,72,1,10,1039,0,0
1625,ACGTCGACTCTAGGGA,71,72,1,10,1083,0,0
1626,ACGTCGAATCTAGGGA,71,72,1,10,1084,0,0
1644,ACGTCGAATCTAGGGA,71,72,1,13,1116,0,0
1645,ACGTCGAATCTAGGGA,71,72,1,10,1117,0,0
1655,ACGTCGAATCTAGGGA,71,72,1,10,1133,0,0
50,ACGTCGACTCTAGGGA,36,73,37,5,19,11,0
158,ACGTCGAATCAAGGGA,48,73,25,5,102,7,0
180,ACGTCGAATCTAGGGA,49,73,24,9,120,7,0
197,ACGTCGAATCTAGGGA,50,73,23,7,124,7,0
428,ACGTCGAATCTAGGGA,57,73,16,11,283,4,0
471,ACGTCGAATCTAGGGA,58,73,15,9,305,4,0
571,ACGTCGAATCTAGGGA,60,73,13,8,372,3,0
588,ACGTCGAATCAAGGGA,61,73,12,6,158,3,0
602,ACGTCGACTCTAGGGA,61,73,12,9,295,3,0
683,ACATCGGATCTAGGGA,62,73,11,7,442,3,0
732,ACGTCGACTCTAGGGA,63,73,10,11,281,2,0
769,ACGTCGAATCTAGGGA,63,73,10,8,508,2,0
772,ACGTCGAATCTAGGGA,63,73,10,11,511,2,0
775,ACGTCGAATCTAGGGA,63,73,10,11,518,2,0
786,ACGTGGACTCTAGGGA,64,73,9,9,216,2,0
811,ACGTCGAATCTAGGGA,64,73,9,9,412,2,0
818,ACGTCGACTCTAGGGA,64,73,9,9,422,2,0
848,ACGTCGAATCTAGGGA,64,73,9,9,556,2,0
905,ACGTCGAATCTAGGGA,65,73,8,10,471,2,0
934,ACCTCGACTCTAGGGA,65,73,8,10,620,2,0
941,ACGTCGAATCTAGGGA,65,73,8,10,632,2,0
944,ACGTCGAATCTAGGGA,65,73,8,10,637,2,0
955,ACGGCGAATCTAGGGA,66,73,7,8,186,1,0
960,ACGTCGGATCTAGGGA,66,73,7,8,204,1,0
998,ACGTCGGATCTAGGGA,66,73,7,8,507,1,0
1003,ACGTCGAATCTAGGGA,66,73,7,11,518,1,0
1093,ACGTCGAATCTAGGGA,67,73,6,9,708,1,0
1095,ACGTCGAATCTAGGGA,67,73,6,9,712,1,0
1116,ACGTCGAATCTAGGGA,67,73,6,12,744,1,0
1129,ACGTCGAATCAAGGGA,67,73,6,9,760,1,0
1137,ACGTCGAATCTAGGGA,67,73,6,12,773,1,0
1150,ACGTCGAATCTAGGGA,68,73,5,10,339,1,0
1163,ACGTCGAATCTAGGGA,68,73,5,10,456,1,0
1240,ACGTCGAATCTAGGGA,68,73,5,10,830,1,0
1270,ACGTCGAATCTAGGGA,69,73,4,8,264,0,0
1281,ACGTCGAATCTAGGGA,69,73,4,11,369,0,0
1294,ACGTCGAATCAAGGGA,69,73,4,8,519,0,0
1306,ACGTCGAATCTAGGGA,69,73,4,8,679,0,0
1338,ACGTCGAATCTAGGGA,69,73,4,8,894,0,0
1342,ACGTCGACTCTAGGGA,69,73,4,11,899,0,0
1354,ACGTCGAATCAAGGGA,69,73,4,8,915,0,0
1360,ACGTCGAATCTAGGGA,69,73,4,11,924,0,0
1374,ACGTCGAATCTAGGGA,69,73,4,11,948,0,0
1378,ACGTCGAATCTAGGGA,70,73,3,9,122,0,0
1380,ACGTCGAATCTAGGGA,70,73,3,9,222,0,0
1406,ACGTCGAATCTAGGGA,70,73,3,9,546,0,0
1410,ACGTCGAATCTAGGGA,70,73,3,9,556,0,0
1419,ACGTCGAATCAAGGGA,70,73,3,6,706,0,0
1435,ACGTCGAATCTAGGGA,70,73,3,9,740,0,0
1437,ACGTCGAATCTAGGGA,70,73,3,9,746,0,0
1474,ACGTCGAATCTAGGGA,70,73,3,12,981,0,0
1481,ACGTCGAATCTAGGGA,70,73,3,9,993,0,0
1483,ACGTCGACTCTAGGGA,70,73,3,9,997,0,0
1494,ACGTCGAATCTAGGGA,70,73,3,9,1011,0,0
1512,GCGTCGAATCTAGGGA,70,73,3,12,1033,0,0
1516,ACGTCGAATCTAGGGA,71,73,2,10,180,0,0
1523,ACGTCGAATCTAGGGA,71,73,2,10,342,0,0
1531,ACGTCGAATCTAGGGA,71,73,2,10,445,0,0
1560,ACGTCGACTCTAGGGA,71,73,2,7,778,0,0
1563,ACGTCGAATCAAGGGA,71,73,2,7,783,0,0
1569,ACGTCGAATCTAGGGA,71,73,2,10,791,0,0
1575,ACGTCGACTCTAGGGA,71,73,2,10,804,0,0
1578,ACGTCGAATCTAGGGA,71,73,2,10,811,0,0
1581,ACGTCGACTCTAGGGA,71,73,2,10,818,0,0
1587,ACGTCGGATCTAGGGA,71,73,2,10,837,0,0
1623,ACGTCGAATCTAGGGA,71,73,2,10,1081,0,0
1628,ACGTCGAATCTAGGGA,71,73,2,10,1087,0,0
1630,ACGTCGAATCAAGGGA,71,73,2,7,1091,0,0
1633,ACGTCGAATCTAGGGA,71,73,2,10,1095,0,0
1635,ACGTCGAATCTAGGGA,71,73,2,10,1100,0,0
1662,ACGTCGACTCTAGGGA,72,73,1,8,103,0,0
1678,ACGTCGAATCTAGGGA,72,73,1,11,369,0,0
1680,ACGTCGAATCTAGGGA,72,73,1,8,379,0,0
1687,ACGTCGAATCTAGGGA,72,73,1,11,510,0,0
1699,ACGTCGAATCTAGGGA,72,73,1,11,685,0,0
1705,ACGTCGAATCTAGGGA,72,73,1,11,702,0,0
1706,ACGTCGAATCAAGGGA,72,73,1,11,705,0,0
1764,ACGTCGAATCTAGGGA,72,73,1,11,1160,0,0
1776,AAGTCGGATCTAGGGA,72,73,1,8,1174,0,0
1795,ACGTCGACTCTAGGGA,72,73,1,11,1202,0,0
1797,ACGTCGACTCTAGGGA,72,73,1,8,1204,0,0
1810,ACGTCGACTCTAGGGA,72,73,1,11,1219,0,0
42,ACGTCGAATCTAGGGA,33,74,41,5,29,13,0
103,ACGTCGACTCTAGGGA,44,74,30,7,55,9,0
186,ACGTCGAATCTAGGGA,50,74,24,7,57,7,0
246,ACGTCGAATCTAGGGA,52,74,22,6,152,6,0
367,ACGTCGACTCTAGGGA,56,74,18,10,178,5,0
413,ACGTCGACTCTAGGGA,57,74,17,8,260,5,0
467,ACGTCGAATCTAGGGA,58,74,16,9,301,4,0
477,ACGTCGACTCTAGGGA,59,74,15,7,56,4,0
493,ACGTCGAATCAAGGGA,59,74,15,7,235,4,0
496,ACGTCGACTCTAGGGA,59,74,15,10,241,4,0
502,ACGTCGACTCTAGGGA,59,74,15,7,317,4,0
519,ACGTCGAATCAAGGGA,59,74,15,7,343,4,0
579,ACGTCGAATCTAGGGA,61,74,13,6,42,3,0
620,ACGTCGACTCTAGGGA,61,74,13,9,390,3,0
643,ACGTCGAATCTAGGGA,61,74,13,9,423,3,0
686,ACGTCGAATCTAGGGA,62,74,12,7,446,3,0
709,ACGTCGAATCTAGGGA,63,74,11,8,110,3,0
781,ACGTCGAATCTAGGGA,64,74,10,9,121,2,0
792,ACGTCGAATCAAGCGA,64,74,10,6,288,2,0
837,ACGTCGGATCTAGGGA,64,74,10,9,541,2,0
859,ACGTCGAATCTAGGGA,64,74,10,9,572,2,0
875,ACGTCGAATCTAGGGA,65,74,9,7,318,2,0
878,ACGTCGAATCTAGGGA,65,74,9,10,328,2,0
897,ACGTCGAATCTAGGGA,65,74,9,10,456,2,0
903,ACGTCGAATCTAGGGA,65,74,9,10,469,2,0
939,ACGTCGAATCTAGGGA,65,74,9,10,625,2,0
1002,ACGTCGAATCTAGGGA,66,74,8,8,516,2,0
1027,ACGTGGACTCTAGGGA,66,74,8,11,688,2,0
1050,ACGTAGGATCTAGGGA,67,74,7,9,315,1,0
1058,ACGTCGACTCTAGGGA,67,74,7,9,413,1,0
1060,ACGTCGAATCTAGGGA,67,74,7,9,417,1,0
1061,ACGTCGGATCTAGGGA,67,74,7,9,418,1,0
1071,ACGTCGACTCTAGGGA,67,74,7,9,534,1,0
1083,ACGTCGACTCTAGGGA,67,74,7,9,557,1,0
1100,ACGTCGAATCTAGGGA,67,74,7,9,718,1,0
1128,ACGTCGAATCAAGGGA,67,74,7,9,759,1,0
1156,ACGTCGAATCTAGGGA,68,74,6,7,438,1,0
1159,ACGTCGGATCTAGGGA,68,74,6,7,442,1,0
1168,GCGTCGAATCTAGGGA,68,74,6,10,470,1,0
1210,ACGTCGAATCTAGGGA,68,74,6,10,785,1,0
1211,ACGTGGACTCTAGGGA,68,74,6,10,786,1,0
1222,ACGTCGACTCTAGGGA,68,74,6,10,803,1,0
1232,ACGTCGACTCTAGGGA,68,74,6,10,818,1,0
1252,ACGTCGAATCTAGGGA,68,74,6,10,848,1,0
1288,ACGTCGAATCAAGGGA,69,74,5,8,493,1,0
1301,ACGTCGAATCAAGGGA,69,74,5,8,663,1,0
1302,ACGTCGAATCTAGGGA,69,74,5,8,668,1,0
1330,ACGTCGAATCTAGGGA,69,74,5,11,881,1,0
1333,ACGTCGAATCTAAGGA,69,74,5,11,888,1,0
1337,ACGTCGAATCTAGGGA,69,74,5,11,893,1,0
1339,ACGTCGAATCTAGGGA,69,74,5,11,895,1,0
1346,GCGTCGAATCTAGGGA,69,74,5,11,904,1,0
1372,ACGTCGAATCTAGGGA,69,74,5,11,944,1,0
1394,TCGTCGAATCTAGGGA,70,74,4,9,424,0,0
1395,ACGTCGAATCTAGGGA,70,74,4,12,428,0,0
1399,ACGTCGAATCTAGGGA,70,74,4,9,530,0,0
1426,ACGTCGAATCTAGGGA,70,74,4,9,724,0,0
1478,ACGTCGAATCTAGGGA,70,74,4,12,985,0,0
1493,ACGTCGACTCTAGGGA,70,74,4,9,1010,0,0
1499,ACGTCGAATCTAGGGA,70,74,4,9,1018,0,0
1522,ACGTCGAATCTAGGGA,71,74,3,10,339,0,0
1549,ACGTCGAATCTAGGGA,71,74,3,10,603,0,0
1553,ACGTCGACTCTAGGGA,71,74,3,10,618,0,0
1554,ACGTCGACTCTAGGGA,71,74,3,10,620,0,0
1559,ACGTCGAATCTAGGGA,71,74,3,10,643,0,0
1566,ACGTCGAATCAAGGGA,71,74,3,7,787,0,0
1582,ACGTCGAATCTAGGGA,71,74,3,10,820,0,0
1590,ACATCGAATCTAGGGA,71,74,3,10,842,0,0
1597,ACGTCGAATCTAGGGA,71,74,3,10,859,0,0
1607,ACGTCGACTCTAGGGA,71,74,3,10,1055,0,0
1609,ACGTCGAATCTAGGGA,71,74,3,10,1059,0,0
1617,ACGTCGAATCTAGGGA,71,74,3,10,1067,0,0
1619,ACGTCGACTCTAGGGA,71,74,3,10,1071,0,0
1620,ACGTCGGATCTAGGGA,71,74,3,10,1074,0,0
1637,ACGTCGAATCTAGGGA,71,74,3,10,1106,0,0
1640,AGGTCGGATCTAGGGA,71,74,3,10,1110,0,0
1642,ACGTCGAATCTAGGGA,71,74,3,10,1112,0,0
1658,ACGTCGAATCTAGGGA,71,74,3,13,1137,0,0
1676,ACGTCGACTCTAGGGA,72,74,2,11,367,0,0
1688,ACGTCGAATCTAGGGA,72,74,2,11,512,0,0
1701,ACGTCGAGTCTAGGGA,72,74,2,11,693,0,0
1703,ACGTCGACTCTAGGGA,72,74,2,11,698,0,0
1722,ACGTCGAATCTAGGGA,72,74,2,8,894,0,0
1733,ACGTCGAATCTAGGGA,72,74,2,11,914,0,0
1741,GCGTCGACTCTAGGGA,72,74,2,11,932,0,0
1749,ACGTCGACTCTAGGGA,72,74,2,11,946,0,0
1750,ACGTCGAATCTAGGGA,72,74,2,8,1141,0,0
1755,ACGTCGAATCTAGGGA,72,74,2,8,1148,0,0
1762,ACGTCGAATCTAGGGA,72,74,2,11,1158,0,0
1765,ACGTCGACTCTAGGGA,72,74,2,11,1162,0,0
1775,ACGTCGACTCTAGGGA,72,74,2,8,1173,0,0
1777,ACGTCGAATCTAGGGA,72,74,2,11,1176,0,0
1778,ACGTCGAATCAAGGGA,72,74,2,8,1178,0,0
1785,TCGTCGAATCTAGGGA,72,74,2,11,1188,0,0
1790,GCGTCGAATCTAGGGA,72,74,2,11,1196,0,0
1794,ACGTCGAATCTAGGGA,72,74,2,11,1201,0,0
1807,ACGTCGAATCTAGGGA,72,74,2,11,1215,0,0
1837,ACGTCGAATCTAGGGA,72,74,2,14,1255,0,0
1847,ACGTCGACTCTAGGGA,73,74,1,9,386,0,0
1872,ACGTCGAATCTAGGGA,73,74,1,9,572,0,0
1910,ACGTCGAATCTAGGGA,73,74,1,12,981,0,0
1921,ACGTCGACTCTAGGGA,73,74,1,9,1010,0,0
1923,ACGTCGAATCTAGGGA,73,74,1,12,1016,0,0
1926,ACGTCGAATCTAGGGA,73,74,1,12,1023,0,0
1932,ACGTCGACTCTAGGGA,73,74,1,12,1031,0,0
1939,ACGTCGAATCTAGGGA,73,74,1,9,1265,0,0
1943,ACGTCGACTCTAGGGA,73,74,1,9,1274,0,0
1992,ATGTCGAATCTAGGGA,73,74,1,12,1341,0,0
1996,AAGTCGGATCTAGGGA,73,74,1,9,1350,0,0
1997,ACGTCGAATCTAGGGA,73,74,1,9,1351,0,0
264,ACGTCGAATCTAGGGA,53,75,22,7,128,6,0
297,ACGTCGAATCTAGGGA,54,75,21,8,145,6,0
399,ACGTCGAATCTAGGGA,57,75,18,8,192,5,0
525,ACGTCGAATCTAGGGA,60,75,15,8,106,4,0
541,ACGTCGGATCTAGGGA,60,75,15,8,204,4,0
612,TCGTCGAATCTAGGGA,61,75,14,9,311,4,0
626,ACGTCGAATCTAGGGA,61,75,14,9,400,4,0
707,ACGTCGACTCTAGGGA,63,75,12,8,103,3,0
725,ACGTCGACTCTAGGGA,63,75,12,8,262,3,0
730,ACGTCGAATCTAGGGA,63,75,12,8,274,3,0
731,ACGTCGAATCTAGGGA,63,75,12,8,279,3,0
733,ACGTCGAATCTAGGGA,63,75,12,8,351,3,0
784,ACGTCGAATCTAGGGA,64,75,11,9,163,3,0
826,ACGTCGAATCTAGGGA,64,75,11,9,526,3,0
912,ACGTCGAATCTAGGGA,65,75,10,7,584,2,0
929,ACGTCGGATCTAGGGA,65,75,10,10,614,2,0
935,ACGTCGAATCTAGGGA,65,75,10,10,621,2,0
965,ACGTCGAATCAAGGGA,66,75,9,8,268,2,0
971,ACGTCGACTCTAGGGA,66,75,9,8,353,2,0
1011,ACGTCGAATCTAGGGA,66,75,9,8,661,2,0
1017,ACGTCGACTCTAGGGA,66,75,9,8,674,2,0
1028,AGGTCGAATCTAGGGA,66,75,9,11,691,2,0
1033,GCGTCGAATCTAGGGA,66,75,9,11,701,2,0
1110,AGGTCGGATCTAGGGA,67,75,8,9,736,2,0
1112,ACGTCGAATCTAGGGA,67,75,8,9,738,2,0
1122,ACGTCGACTCTAGGGA,67,75,8,9,753,2,0
1141,ACGTCGAATCTAGGGA,68,75,7,7,125,1,0
1155,ACGTCGCATCTAGGGA,68,75,7,7,437,1,0
1186,ACGTCGAATCTAGGGA,68,75,7,10,604,1,0
1200,ACGTCGAATCTAGGGA,68,75,7,10,637,1,0
1205,ACGTCGAATCTAGGGA,68,75,7,7,779,1,0
1213,ACGTCGAATCTAGGGA,68,75,7,10,789,1,0
1257,ACGTCGAATCTAGGGA,68,75,7,10,859,1,0
1267,ACGTCGGATCTAGGGA,69,75,6,8,204,1,0
1276,ACGTCGACTCTAGGGA,69,75,6,8,360,1,0
1283,ACGTCGAATCTAGGGA,69,75,6,11,378,1,0
1284,ACGTCGAATCTAGGGA,69,75,6,8,379,1,0
1287,ACGTCGAATCTAGGGA,69,75,6,8,491,1,0
1289,ACGTCGACTCTAGGGA,69,75,6,11,496,1,0
1318,ACGTCGAATCAAGGGA,69,75,6,11,705,1,0
1322,ACGTCGAATCTAGGGA,69,75,6,8,871,1,0
1336,ACGTCGAATCAAGGGA,69,75,6,8,892,1,0
1341,ACGTCGAATCTAGGGA,69,75,6,11,898,1,0
1393,ACGTCGGATCTAGGGA,70,75,5,9,418,1,0
1429,ACGTCGAATCTAGGGA,70,75,5,9,731,1,0
1443,ACGTCGAATCTAGGGA,70,75,5,9,757,1,0
1444,ACGTCGAATCTAGGCA,70,75,5,9,758,1,0
1447,ACGTCGAATCTAGGGA,70,75,5,9,762,1,0
1472,ACGTCGAATCTAGGGA,70,75,5,9,976,1,0
1489,ACGTCGAATCTAGGGA,70,75,5,9,1005,1,0
1539,ACGTCGAATCTATGGA,71,75,4,10,471,0,0
1602,GCGTCGAATCTAGGGA,71,75,4,10,1047,0,0
1606,ACGTCGACTCTAGGGA,71,75,4,10,1051,0,0
1653,ACGTCGAATCAAGGGA,71,75,4,10,1129,0,0
1660,ACGTCGAATCTAGGGA,71,75,4,13,1139,0,0
1671,ACGCCGACTCTAGGGA,72,75,3,8,269,0,0
1700,ACGTCGAAACTAGGGA,72,75,3,8,686,0,0
1730,AAGTCGGATCTAGGGA,72,75,3,8,911,0,0
1736,ACGTCGAATGTAGGGA,72,75,3,11,920,0,0
1738,ACGTCGAATCTAGGGA,72,75,3,11,924,0,0
1740,ACGTCGGATCTAGGGA,72,75,3,11,929,0,0
1744,ACGTCGAATCTAGGGA,72,75,3,11,936,0,0
1747,ACGTCGAATCTAGGGA,72,75,3,11,941,0,0
1748,ACGTCGAATCTAGGGA,72,75,3,11,944,0,0
1786,ACGTCGAATCAAGGGA,72,75,3,11,1189,0,0
1806,ACGTCGACTCTAGGGA,72,75,3,11,1214,0,0
1809,ACGTCGAATCTAGGGA,72,75,3,11,1217,0,0
1816,ACGTCGAATCTAGGGT,72,75,3,11,1227,0,0
1821,ACGTCGAATCTAGGGA,72,75,3,11,1233,0,0
1833,ACGTCGAATCAAGGGA,72,75,3,11,1249,0,0
1843,ACGTCGAATCTAGGGA,73,75,2,9,224,0,0
1850,ACGTCGAATCTAGGGA,73,75,2,9,406,0,0
1859,ACGTCGAATCTAGGGA,73,75,2,9,533,0,0
1880,ACGTCGAATCTAGGGA,73,75,2,9,730,0,0
1894,ACGTCGAATCAAGGGA,73,75,2,9,760,0,0
1906,ACGTCGAATCTGGGGA,73,75,2,9,970,0,0
1941,ACGTCGAATCTAGGGA,73,75,2,9,1269,0,0
1960,ACGGCGAATCTAGGGA,73,75,2,9,1295,0,0
1972,ACGTCGACTCTATGGA,73,75,2,12,1314,0,0
1975,ACGTCGAATCTAGGGA,73,75,2,12,1317,0,0
1976,ACGTCGAATCAAGGGA,73,75,2,12,1318,0,0
2002,ACGTCGAATCTCGGGA,73,75,2,12,1362,0,0
2010,ACGTCGAATCTAGGGA,74,75,1,7,125,0,0
2024,ACGTCGAATCTAGGGA,74,75,1,10,441,0,0
2025,ACGTCGAATCTAGGGA,74,75,1,10,448,0,0
2028,ACGTCGACTCTAGGGA,74,75,1,10,466,0,0
2033,ACGTCGAATCTAGGGA,74,75,1,10,597,0,0
2059,ACGTCGAATCTAGGGA,74,75,1,10,830,0,0
2061,ACGTCGACTCTAGGGA,74,75,1,10,838,0,0
2070,ACGTCGAATCAAGGGA,74,75,1,7,1042,0,0
2077,ACGTCGAATCTAGGGA,74,75,1,10,1062,0,0
2080,ACGTCGAATCTAGGGA,74,75,1,10,1066,0,0
2104,ACGTCGAATCTAGGGA,74,75,1,10,1120,0,0
2111,ACGTCGAATCTAGGGA,74,75,1,13,1139,0,0
2112,ACGTCGAATCTAGGGA,74,75,1,7,1375,0,0
2123,ACGTCGGATCTAGGGA,74,75,1,10,1393,0,0
2133,ACGTCGAATCTAGGGA,74,75,1,10,1409,0,0
2149,ACGTCGACTCTAGGGA,74,75,1,13,1430,0,0
2154,ACGTCGACTCTAGGGA,74,75,1,13,1436,0,0
2160,ACGTCGAATCTAGGCA,74,75,1,10,1444,0,0
2163,ACGTCGAATCTAGGGA,74,75,1,10,1448,0,0
2166,ACGTCGAATCTCGGGA,74,75,1,13,1453,0,0
2194,ACGTCGAATCTAGGGA,74,75,1,10,1500,0,0
102,ACGTCGAATCAAGGGA,44,76,32,4,33,10,0
132,ACGTCGGATCTAGGGA,46,76,30,6,86,9,0
243,ACGTCGAATCTAGGGA,52,76,24,9,121,7,0
339,ACGTCGAATCTAGGGA,55,76,21,9,213,6,0
351,ACGTCGAATCTAGGGA,56,76,20,7,57,6,0
368,ACGTCGACTCTAGGGA,56,76,20,10,179,6,0
470,GCGTCGAATCTAGGGA,58,76,18,9,304,5,0
510,ACGTCGAATCTAGGGA,59,76,17,10,328,5,0
530,ACGTCGAATCTAGGGA,60,76,16,8,143,4,0
557,ACGTCGACTCTAGGGA,60,76,16,8,352,4,0
572,ACGTCGAATCTAGGGA,60,76,16,8,373,4,0
702,ACGTCGAATCTAGGGA,62,76,14,10,471,4,0
708,ACGTCGAATCTAGGGA,63,76,13,8,106,3,0
724,ACGTCGAATCTAGGGA,63,76,13,8,261,3,0
757,ACGTCGAATCTAGGGA,63,76,13,8,491,3,0
758,ACGTCGAATCTAGGCA,63,76,13,8,492,3,0
787,ACGTCGAATCAAGGGA,64,76,12,6,219,3,0
800,ACGTCGGATCTAGGGA,64,76,12,9,315,3,0
817,ACGTCGAATCTAGGGA,64,76,12,9,421,3,0
847,ACGTCGAATCTAGGGA,64,76,12,9,554,3,0
854,ACGTCGAATCTAGGGA,64,76,12,9,566,3,0
892,ACGTCGAATCAAGGGA,65,76,11,7,444,3,0
893,ACGTCGAATCTAGGGA,65,76,11,10,445,3,0
918,ACGTCGAATCTAGGGA,65,76,11,10,593,3,0
956,ACGTCGACTCTAGGGA,66,76,10,8,187,2,0
963,ACGTCGAATCTAGGGA,66,76,10,8,261,2,0
997,ACGTCGACTCTAGGGA,66,76,10,8,502,2,0
1034,ACGTCGAATCTAGGGA,66,76,10,11,702,2,0
1051,ACGTCGACTCTAGGGA,67,76,9,9,386,2,0
1118,ACGTCGAATCTAGGGA,67,76,9,9,746,2,0
1160,ACGTCGAATCTAGGGA,68,76,8,10,445,2,0
1185,ACGTCGAATCTAGGGA,68,76,8,10,603,2,0
1204,ACGTCGACTCTAGGGA,68,76,8,7,778,2,0
1216,ACGTCGAATCAAGCGA,68,76,8,7,792,2,0
1221,ACGTCGGATCTAGGGA,68,76,8,10,800,2,0
1228,ACGTCGAATCTAGGGA,68,76,8,10,811,2,0
1251,ACGTCGAATCTAGGGA,68,76,8,10,847,2,0
1259,ACGTCGAATCTAGGGA,68,76,8,13,863,2,0
1261,ACGTCGACTCTAGGGA,69,76,7,8,103,1,0
1327,ACGTCGAATCTGGGGA,69,76,7,11,878,1,0
1388,ACGTCGAATCTAGGGA,70,76,6,9,399,1,0
1397,ACGTCGACTCTAGGGA,70,76,6,9,524,1,0
1404,ACGTCGGATCTAGGGA,70,76,6,9,541,1,0
1412,ACGTCGAATCTAGGGA,70,76,6,9,563,1,0
1421,ACGTCGAATCTAGGGA,70,76,6,9,708,1,0
1428,ACGTCGAATCTAGGGA,70,76,6,9,730,1,0
1442,ACGTCGAATCAAGGGA,70,76,6,9,755,1,0
1479,ACGTCGAATCTAGGGA,70,76,6,9,986,1,0
1491,ACGTCGACTCTAGGGA,70,76,6,12,1007,1,0
1497,ACGTCGAATCTAGGGA,70,76,6,12,1016,1,0
1509,ACGTCGAATCAAGGGA,70,76,6,9,1030,1,0
1511,ACGTCGAATCTAGGGA,70,76,6,12,1032,1,0
1513,ACGTCGAATCTAGGGA,70,76,6,12,1034,1,0
1570,ACGTCGAATCAAGCGA,71,76,5,7,792,1,0
1612,ACGTCGAATCTAGGGA,71,76,5,10,1062,1,0
1627,ACGTCGACTCTAGGGA,71,76,5,13,1086,1,0
1641,ACGTCGACTCTAGGGA,71,76,5,10,1111,1,0
1667,ACGTCGGATCTAGGGA,72,76,4,8,204,0,0
1669,ACGTCGAATCTAGGGA,72,76,4,8,259,0,0
1675,ACGTCGAATCTAGGGA,72,76,4,8,361,0,0
1681,ACGTCGAATCTAGGGA,72,76,4,11,381,0,0
1704,ACGTCGAATCTAGGGA,72,76,4,11,699,0,0
1732,ACGTCGAATCTAGGGA,72,76,4,11,913,0,0
1758,ACGTCGAATCAAGGGA,72,76,4,8,1152,0,0
1759,ACGTCGCATCTAGGGA,72,76,4,8,1155,0,0
1774,ACGTCGAATCTAGGGA,72,76,4,8,1172,0,0
1826,ACGTCGAATCTAGGGA,72,76,4,11,1240,0,0
1827,ACGTCGACTCTAGGGA,72,76,4,11,1241,0,0
1836,ACGTCGAATCTAGGGA,72,76,4,11,1254,0,0
1841,ACGTCGAATCTAGGGA,73,76,3,6,42,0,0
1851,CCGTCGGATCTAGGGA,73,76,3,9,408,0,0
1855,ACGTCGACTCTAGGGA,73,76,3,9,522,0,0
1861,ACGTCGAATCTAGGGA,73,76,3,9,540,0,0
1863,ACGTCGACTCTAGGGA,73,76,3,9,545,0,0
1868,ACGTCGAATCTAGGGA,73,76,3,9,556,0,0
1888,ACGTCGAATCTAGGGA,73,76,3,9,746,0,0
1896,ACGTCCAATCTAGGGA,73,76,3,9,766,0,0
1898,ACGTCGAATCAAGGGA,73,76,3,6,949,0,0
1908,ACGTCGAATCTAGGGA,73,76,3,9,976,0,0
1963,ACGTCGACTCTAGGGA,73,76,3,9,1299,0,0
1971,ACGTCGAATCAAGGGA,73,76,3,9,1313,0,0
2008,ACGTCGAATCTAGGGA,73,76,3,12,1370,0,0
2013,ACGTCGAATGTAGGGA,74,76,2,10,243,0,0
2041,ACGTCGAATCTAGGGA,74,76,2,10,637,0,0
2054,ACGTCGACTCTAGGGA,74,76,2,10,808,0,0
2084,ACGTCGACTCTAGGGA,74,76,2,10,1076,0,0
2085,ACGTCGAATCTAGGGA,74,76,2,10,1081,0,0
2121,ACGTCGACTCTAGGGA,74,76,2,10,1389,0,0
2128,ACGTCGAATCTAGGGA,74,76,2,10,1403,0,0
2130,ACGTCGACTCTCGGGA,74,76,2,10,1405,0,0
2139,ACGTCGAATCTAGGGA,74,76,2,10,1416,0,0
2142,ACGTCGACTCTCGGGA,74,76,2,10,1420,0,0
2152,ACGTCGACTCTAGGGA,74,76,2,10,1433,0,0
2158,ACGTCGAATCAAGGGA,74,76,2,10,1442,0,0
2164,ACGTCGAATCTAGGGA,74,76,2,10,1451,0,0
2165,ACGTCGAATCTAGGGA,74,76,2,13,1452,0,0
2182,ACATCGAATCAAGGGA,74,76,2,10,1480,0,0
2184,ACGTCGGATCTAGGGA,74,76,2,10,1484,0,0
2193,ACGTCGACTCTAGGGA,74,76,2,10,1498,0,0
2199,ACGTCGAGTCTAGGGA,74,76,2,13,1508,0,0
2201,ACGTCGACTCTAGGGA,74,76,2,13,1510,0,0
2206,ACGTCGACTCTAGGGA,75,76,1,8,136,0,0
2207,ACGTCGGATCTAGGGA,75,76,1,8,204,0,0
2217,ACGTCGAATCTAGGGA,75,76,1,11,378,0,0
2240,ACGTCGAATCTAGGGA,75,76,1,8,871,0,0
2243,ACGTCGAATCTAGGGA,75,76,1,8,879,0,0
2253,ACGTCGACTCTAGGGA,75,76,1,11,899,0,0
2268,ACGTCGACTCTAGGGA,75,76,1,11,946,0,0
2271,ACGTCGAATCTAGGGA,75,76,1,11,1146,0,0
2309,ACGTCGAATCAAGGGA,75,76,1,8,1208,0,0
2311,ACGTCGAATCAAGGGA,75,76,1,8,1212,0,0
2318,ACGTCGGATCTAGGGA,75,76,1,11,1221,0,0
2330,ACGTCGACTCTAGGGA,75,76,1,11,1241,0,0
2340,ACGTCGAATCAAGGGA,75,76,1,11,1258,0,0
2342,ACGTCGAATCTAGGGA,75,76,1,8,1514,0,0
2344,ACGTCGAATCAAGGGA,75,76,1,8,1517,0,0
2345,ACGTCGAATCTAGGGA,75,76,1,11,1518,0,0
2356,ACGTCGAATCTAGGGA,75,76,1,11,1533,0,0
2366,ACGTCGAATCAAGGGA,75,76,1,8,1544,0,0
2369,ACGTCGAATCAAGGGA,75,76,1,8,1547,0,0
2378,ACGTCGAATCTAGGGA,75,76,1,11,1562,0,0
2382,ACGTCGAATCAAGCGA,75,76,1,8,1570,0,0
2401,ACGTCGACTCTAGGGA,75,76,1,8,1598,0,0
2421,ACGTCGAATCTAGGGA,75,76,1,11,1631,0,0
2435,ACGTCGAACCAAGGGA,75,76,1,11,1652,0,0
236,ACGTCGAATCAAGGGA,52,77,25,6,89,7,0
328,ACGTCGAATCTAGGGA,55,77,22,9,120,6,0
345,ACGTCGAATCTAGGGA,55,77,22,9,222,6,0
360,ACGTCGACTCTAGGGA,56,77,21,7,164,6,0
369,ACGTCGAATCTAGGGA,56,77,21,10,180,6,0
441,ACGTCGAATCTAGGGA,58,77,19,9,122,5,0
548,ACGTCGAATCTAGGGA,60,77,17,8,263,5,0
556,ACGTCGAATCTAGGGA,60,77,17,8,351,5,0
698,ACGTCGACTCTAGGGA,62,77,15,10,466,4,0
705,ACGTCGAATCAAGGGA,62,77,15,10,476,4,0
746,ACGTCGAATCTAGGGA,63,77,14,8,373,4,0
780,ACGTCGGATCTAGGGA,64,77,13,6,113,3,0
808,ACGTCGACTCTAGGGA,64,77,13,9,402,3,0
833,ACGTCGAATCTAGGGA,64,77,13,9,536,3,0
916,ACGTCGAATCTAGGGA,65,77,12,10,589,3,0
924,ACGTCGAATCTAGGGA,65,77,12,10,603,3,0
952,ACGTCGAATCTAGGGA,66,77,11,8,110,3,0
968,ACGTCGAATCTAGGGA,66,77,11,8,279,3,0
1010,ACGTCGACTCTAGGGA,66,77,11,8,660,3,0
1021,ACGTCGAATCTAGGGA,66,77,11,11,680,3,0
1025,ACGTCGAATCTAGGGA,66,77,11,11,685,3,0
1031,ACGTCGACTCTAGGGA,66,77,11,11,698,3,0
1046,ACGTCGACTCTAGGGA,67,77,10,9,302,2,0
1094,ACGTCGAATCTAGGGA,67,77,10,9,709,2,0
1147,ACGTCGAATCTAGGGA,68,77,9,7,246,2,0
1166,ACGTCGAATCTAGGGA,68,77,9,10,467,2,0
1192,ACGTCGACTCTAGGGA,68,77,9,10,620,2,0
1214,ACGTCGACTCTAGGGA,68,77,9,10,790,2,0
1219,ACGTCGACTCTAGGGA,68,77,9,10,797,2,0
1220,ACGTCGAATCTCGGGA,68,77,9,10,799,2,0
1235,ACGTCGACTCTAGGGA,68,77,9,10,822,2,0
1269,ACGTCGAATCTAGGGA,69,77,8,8,259,2,0
1282,ACGTCGAATCTAGGGA,69,77,8,8,373,2,0
1297,ACGTCGACTCTAGGGA,69,77,8,11,656,2,0
1300,ACGTCGAATCTAGGGA,69,77,8,8,661,2,0
1356,ACGTCGAATCTAGGGA,69,77,8,11,918,2,0
1363,ACGTCGGATCTAGGGA,69,77,8,11,929,2,0
1375,ACGTCGAATCTAGGGA,70,77,7,6,42,1,0
1408,ACGTCGAATCTAGGGA,70,77,7,9,548,1,0
1414,ACGTCGACTCTAGGGA,70,77,7,12,568,1,0
1422,ACGTCGAATCTAGGGA,70,77,7,9,709,1,0
1469,ACGTCGAATCTAGGGA,70,77,7,9,970,1,0
1475,ACGTCGAATCTAGGGA,70,77,7,9,982,1,0
1482,ACGTCGAATCAAGGGA,70,77,7,9,995,1,0
1496,ACGTCGAATCTAGGGA,70,77,7,9,1014,1,0
1498,ACGTCGACTCTAGGGA,70,77,7,9,1017,1,0
1515,ACGTCGGATCTAGGGA,71,77,6,7,132,1,0
1544,ACGTCGAATCAAGGGA,71,77,6,7,588,1,0
1545,ACGTCGAATCTAGGGA,71,77,6,10,597,1,0
1548,ACGTCGACTCTAGGGA,71,77,6,10,602,1,0
1556,ACGTCGACTCTAGGGA,71,77,6,10,634,1,0
1557,ACGTCGAATCTAGGGA,71,77,6,10,637,1,0
1558,ACGTCGACTCTAGGGA,71,77,6,10,642,1,0
1573,ACGTCGACTCTAGGGA,71,77,6,10,797,1,0
1577,ACGTCGACTCTAGGGA,71,77,6,10,808,1,0
1610,ACGTCGAATCTAGGGA,71,77,6,10,1060,1,0
1615,ACGTCGACTCTAGGGA,71,77,6,10,1065,1,0
1632,ACGTCGAATCTAGGGA,71,77,6,10,1094,1,0
1636,ACGTCGAATCTAGGGA,71,77,6,10,1105,1,0
1657,ACGTCGAATCTAAGGA,71,77,6,13,1135,1,0
1668,ACGTCGAATCTAGGGA,72,77,5,8,258,1,0
1677,ACGTCGACTCTAGGGA,72,77,5,11,368,1,0
1707,ACGTCGGATCTAGGGA,72,77,5,8,866,1,0
1726,ACGTCGACTCTAGGGA,72,77,5,11,901,1,0
1728,ACGTCGAATCTAGGGA,72,77,5,11,905,1,0
1753,ACGTCGAATCTAGGGA,72,77,5,11,1146,1,0
1756,ACGTCGAATCTAGGGA,72,77,5,11,1149,1,0
1768,ACGTCGAATCTAGGGA,72,77,5,11,1166,1,0
1800,ACGTCGAATCAAGGGA,72,77,5,8,1208,1,0
1822,ACGTCGAATCTAGGGA,72,77,5,14,1234,1,0
1823,ACGTCGACTCTAGGGA,72,77,5,11,1235,1,0
1853,ACGTCGGATCTAGGGA,73,77,4,9,418,0,0
1885,ACGTCGAATCTCGGGA,73,77,4,9,738,0,0
1928,ACGTCGAATCTAGGGA,73,77,4,12,1025,0,0
1948,ACGTCGAATCTAGGGA,73,77,4,9,1282,0,0
1970,ACGTCGAGTCTAGGGA,73,77,4,12,1312,0,0
1974,GCGTCGAATCTAGGGA,73,77,4,12,1316,0,0
1983,ACGTCGACTCTAGGGA,73,77,4,9,1326,0,0
1986,ACGTCGAATCTAGGGA,73,77,4,12,1330,0,0
2017,ACGTCGAATCTAGGGA,74,77,3,10,342,0,0
2022,ACGTCGAATCTAGGGA,74,77,3,7,438,0,0
2029,GCGTCGAATCTAGGGA,74,77,3,10,470,0,0
2030,ACGTCGGATCTAGGGA,74,77,3,10,475,0,0
2040,ACGTCGACTCTAGGGA,74,77,3,10,634,0,0
2060,ACGTCGAATCTAGGGA,74,77,3,10,833,0,0
2064,ACGTCCACTCTAGGGA,74,77,3,10,850,0,0
2069,ACGTCGAATCTAGGGA,74,77,3,10,1039,0,0
2081,ACGTCGAATCTAGGGA,74,77,3,10,1067,0,0
2086,ACGTCGAATCTAGGGA,74,77,3,10,1084,0,0
2089,ACGTCGAATCTAGGGA,74,77,3,10,1088,0,0
2093,ACGTCGAATCTAGGGA,74,77,3,10,1105,0,0
2094,ACGTCGAATCTAGGGA,74,77,3,10,1106,0,0
2102,ACGTCGAATCTAGGGA,74,77,3,10,1118,0,0
2108,ACGTCGAATCTAGGGA,74,77,3,10,1133,0,0
2114,ACGTCGAATCAAGGGA,74,77,3,7,1379,0,0
2118,ACGTCGAATCTCGGGA,74,77,3,10,1385,0,0
2124,ACGTCGACTCTAGGGA,74,77,3,10,1396,0,0
2135,ACGTCGAATCTAGGGA,74,77,3,10,1412,0,0
2148,ACGTCGAATCTAGGGA,74,77,3,10,1429,0,0
2176,ACGTCGAATCTAGGCA,74,77,3,10,1469,0,0
2177,ACGTCGAATCTAGGGA,74,77,3,10,1472,0,0
2179,ACGTCGAATCTAGGGA,74,77,3,10,1476,0,0
2188,ACGTCGACTCTAGGGA,74,77,3,13,1491,0,0
2208,ACGTCGAATCTAGGGA,75,77,2,8,258,0,0
2220,ACGTCGAATCTAGGGA,75,77,2,8,491,0,0
2223,ACGTCGAATCTAGGGA,75,77,2,8,655,0,0
2266,ACGTCGAATCTAGGGA,75,77,2,11,936,0,0
2267,GCGTCGAATCTAGGGA,75,77,2,11,938,0,0
2279,ACGTCGACTCTAGGGA,75,77,2,11,1162,0,0
2284,ACGTCGAATCTCGGGA,75,77,2,11,1170,0,0
2288,AAGTCGGATCTAGGGA,75,77,2,8,1174,0,0
2300,ACGTCGACTCTAGGGA,75,77,2,11,1195,0,0
2325,ACGTCGAATCTAGGGA,75,77,2,11,1233,0,0
2338,ACGTCGAATCTAGGGA,75,77,2,11,1254,0,0
2349,ACGTCGAATCAAGGGA,75,77,2,8,1524,0,0
2351,ACGTCGAATCTAGGGA,75,77,2,11,1526,0,0
2376,ACGTCGAATCTAGGGA,75,77,2,11,1557,0,0
2383,ACGTCGAATCTAGGGA,75,77,2,11,1571,0,0
2388,ACGTCGACTCTAGGGA,75,77,2,11,1577,0,0
2403,ACGTCGACTCTAGGGA,75,77,2,11,1601,0,0
2412,ACGTCGACTCTAGGGA,75,77,2,11,1614,0,0
2461,ACGTCGAATCTAGGGA,76,77,1,9,564,0,0
2467,ACGTCGAATCTAGGGA,76,77,1,9,738,0,0
2488,ACGTCGAATCTAGGGA,76,77,1,12,985,0,0
2493,ACGTCGAATCTAGGGA,76,77,1,12,1000,0,0
2497,ACGTCGAATCTAGGGA,76,77,1,12,1021,0,0
2500,ACGTCGAATCTAGGGA,76,77,1,12,1025,0,0
2515,ACGTCGACTCTAGGGA,76,77,1,9,1286,0,0
2523,ACGTCGACTCTAGGGA,76,77,1,9,1299,0,0
2532,GCGTCGAATCTAGGGA,76,77,1,12,1316,0,0
2576,ACGTCGACTCTAGGGA,76,77,1,9,1691,0,0
2583,ACATCGGATCTAGGGA,76,77,1,9,1698,0,0
2589,ACGTCGAATCTAGGGA,76,77,1,9,1711,0,0
2591,ACGTCGAATCTAGGGA,76,77,1,12,1713,0,0
2605,ACGTCGAATCTAGGGA,76,77,1,12,1728,0,0
2618,ACGTCGAATCTAGGGA,76,77,1,12,1753,0,0
2633,ACGTCGAATCTAGGGA,76,77,1,12,1779,0,0
2637,ACGTCGAATCTAGGTA,76,77,1,12,1783,0,0
2645,ACGTCGAATCTAGGGA,76,77,1,12,1796,0,0
2646,ACGTCGAATCTAGGGA,76,77,1,9,1798,0,0
2650,ACGTCGAATCTAGGGA,76,77,1,12,1802,0,0
2651,ACGTGGACTCTAGGGA,76,77,1,12,1803,0,0
2667,ACGTCGAATCTAGGGA,76,77,1,12,1825,0,0
2668,ACGTCGAATCTAGGGA,76,77,1,12,1828,0,0
2671,CCATCGAATCTAGGGA,76,77,1,12,1831,0,0
2674,ACGTCGCATCTAGGGA,76,77,1,12,1835,0,0
2675,ACGTCGAATCTAGGGA,76,77,1,12,1838,0,0
2677,ACGTCGAATCTAGGGA,76,77,1,15,1840,0,0
269,ACGCCGACTCTAGGGA,53,78,25,7,164,7,0
448,ACGTCGAATCTAGGGA,58,78,20,9,214,6,0
531,ACGTCGAATCTAGGGA,60,78,18,8,145,5,0
604,ACGTCGAATCTAGGGA,61,78,17,9,298,5,0
825,ACGTCGAATCTAGGGA,64,78,14,9,525,4,0
876,ACGTCGACTCTAGGGA,65,78,13,7,319,3,0
899,ACGTCGACTCTAGGGA,65,78,13,10,460,3,0
936,ACGTCGAATCTAGGGA,65,78,13,10,622,3,0
1042,ACGTCGAATCAAGGGA,67,78,11,6,219,3,0
1067,ACGTCGAATCTAGGGA,67,78,11,9,530,3,0
1070,ACGTCGAATCTAGGGA,67,78,11,9,533,3,0
1127,ACGTCGAATCTAGGCA,67,78,11,9,758,3,0
1152,ACGTCGAATCAAGGGA,68,78,10,7,343,2,0
1171,ACGTCGGATCTAGGGA,68,78,10,10,475,2,0
1178,ACGTCGAATCAAGGGA,68,78,10,7,588,2,0
1193,ACGTCGAATCTAGGGA,68,78,10,10,621,2,0
1215,ACGTCGAATCTAGGGA,68,78,10,10,791,2,0
1248,ACGTCGAATCTAGGGA,68,78,10,10,843,2,0
1315,ACGTCGAATCTAGGGA,69,78,9,11,699,2,0
1403,ACGTCGAATCTAGGGA,70,78,8,9,540,2,0
1427,ACGTCGACTCTAGGGA,70,78,8,9,725,2,0
1433,ACGTCGACTCTAGGGA,70,78,8,9,737,2,0
1434,ACGTCGAATCTAGGGA,70,78,8,9,738,2,0
1441,ACGTCGACTCTAGGGA,70,78,8,9,753,2,0
1446,ACGTCGAATCAAGGGA,70,78,8,9,760,2,0
1461,ACGGCGAATCTAGGGA,70,78,8,9,955,2,0
1476,ACGTCGAATCTAGGGA,70,78,8,9,983,2,0
1484,ACGTCGGATCTAGGGA,70,78,8,9,998,2,0
1517,ACGTCGAATCAAGGGA,71,78,7,7,236,1,0
1555,ACGTCGAATCTAGGGA,71,78,7,10,626,1,0
1579,ACGTCGACTCTAGGGA,71,78,7,10,812,1,0
1584,ACGTCGAATCTAGGGA,71,78,7,10,826,1,0
1588,ACGTCGACTCTAGGGA,71,78,7,10,838,1,0
1648,ACGTCGAATCTAGGGA,71,78,7,10,1120,1,0
1672,ACGTCGACTCTAGGGA,72,78,6,11,281,1,0
1679,ACGTCGAATCTAGGGA,72,78,6,11,378,1,0
1729,ACGTCGAATCTCGGGA,72,78,6,11,906,1,0
1739,ACGTCGAATCTAGGGA,72,78,6,11,925,1,0
1745,GCGTCGAATCTAGGGA,72,78,6,11,938,1,0
1752,ACGTCGAATCAAGGGA,72,78,6,8,1145,1,0
1773,ACGTCGGATCTAGGGA,72,78,6,11,1171,1,0
1811,ACGTCGAATCTCGGGA,72,78,6,11,1220,1,0
1818,ACGTCGACTCTAGGGA,72,78,6,11,1229,1,0
1828,ACGTCGAATCTAGGGA,72,78,6,11,1242,1,0
1873,ACGTCGAATCAAGGGA,73,78,5,6,706,1,0
1877,ACGTCGAATCTAGGGA,73,78,5,9,715,1,0
1882,ACGTCGAATCTAGGGA,73,78,5,9,733,1,0
1914,ACATCGAATCAAGGGA,73,78,5,9,988,1,0
1919,ACGTCGAATCTAGGGA,73,78,5,9,1002,1,0
1927,ACATCGGATCTAGGGA,73,78,5,9,1024,1,0
1933,ACGTCGAATCTAGGGA,73,78,5,12,1032,1,0
1989,ACGTCGAATCAAGGGA,73,78,5,9,1336,1,0
1991,ACGTCGAATCTAGGGA,73,78,5,12,1339,1,0
1999,ACGTCGAATCTAGGGA,73,78,5,12,1353,1,0
2006,ACGTCGAATCTAGGGA,73,78,5,12,1368,1,0
2020,ACGTCGAATCTAGGGA,74,78,4,10,347,0,0
2032,ACGTCGAATCTAGGGA,74,78,4,10,586,0,0
2072,ACGTCGAATCTAGGGA,74,78,4,10,1048,0,0
2092,ACGTCGAATCTAGGGA,74,78,4,10,1096,0,0
2098,ACGTCGACTCTAGGGA,74,78,4,10,1111,0,0
2099,ACGTCGAATCTAGGGA,74,78,4,10,1112,0,0
2119,ACGTCGACTCTAGGGA,74,78,4,10,1386,0,0
2141,ACGTCGAATCCAGGGA,74,78,4,13,1418,0,0
2167,ACGTCGAATCTAGGGA,74,78,4,10,1454,0,0
2172,ACGTCGGATCTAGGGA,74,78,4,10,1464,0,0
2175,ACGTCGAATCTAGGCA,74,78,4,10,1467,0,0
2195,ACGTCGAATCTAGGGA,74,78,4,13,1504,0,0
2196,ACGTCGAATCTAGGGA,74,78,4,10,1505,0,0
2210,ACGCCGACTCTAGGGA,75,78,3,8,269,0,0
2213,ACGTCGACTCTAGGGA,75,78,3,8,360,0,0
2215,ACGTCGACTCTAGAGA,75,78,3,11,368,0,0
2239,ACGTCGAATCAAGGGA,75,78,3,8,870,0,0
2245,ACGTCGAATCTAGGGA,75,78,3,11,881,0,0
2274,ACGTCGAATCTAGGGA,75,78,3,11,1149,0,0
2277,ACGTCGAATCTAGGGA,75,78,3,11,1158,0,0
2280,ACGTCGACTCTAGGGA,75,78,3,11,1165,0,0
2287,ACGTCGACTCTAGGGA,75,78,3,8,1173,0,0
2301,GCGTCGAATCTAGGGA,75,78,3,11,1196,0,0
2304,ACGTCGAATCTAGGGA,75,78,3,11,1201,0,0
2320,ACGTCGAATCTAGGGA,75,78,3,11,1225,0,0
2323,ACGTCGACTCTAGGGA,75,78,3,11,1229,0,0
2329,ACGTCGAATCTAGGGA,75,78,3,11,1239,0,0
2334,ACATCGAATCTAGGGA,75,78,3,11,1247,0,0
2343,ACGTCGGATCTAGGGA,75,78,3,8,1515,0,0
2371,ACGTCGAATCTAGGGA,75,78,3,11,1550,0,0
2392,ACGTCGAATCTAGGGA,75,78,3,11,1585,0,0
2393,ACGTCGAATCTAGGGA,75,78,3,11,1586,0,0
2418,ACGTCGAATCTAGGGA,75,78,3,11,1624,0,0
2468,ACGTCGAATCTAGGGA,76,78,2,9,740,0,0
2499,ACATCGGATCTAGGGA,76,78,2,9,1024,0,0
2502,ACGTCGACTCTAGGGA,76,78,2,12,1031,0,0
2522,ACGTCGACTCTAGGGA,76,78,2,12,1297,0,0
2534,ACGTCGGATCTAGGGA,76,78,2,9,1319,0,0
2535,ACGTCGAATCAAGGGA,76,78,2,9,1321,0,0
2536,ACGTCGACTCTAGGGA,76,78,2,12,1323,0,0
2542,ACGTCGAATCTAGGGA,76,78,2,12,1343,0,0
2543,ACGTCGAATCTCGGGA,76,78,2,12,1348,0,0
2560,ACGTCGAATCTAGGGA,76,78,2,9,1665,0,0
2563,CCGTCGAATCTAGGGA,76,78,2,9,1670,0,0
2574,ACGTCGAATCAAGGGA,76,78,2,9,1689,0,0
2575,ACGTCGAATCTAGGGA,76,78,2,9,1690,0,0
2592,ACGTCGAATCTAGGGA,76,78,2,9,1714,0,0
2599,ACGTCGAATCTACGGA,76,78,2,12,1721,0,0
2602,ACGTCGACTCTAGGGA,76,78,2,12,1725,0,0
2607,ACGTCGAATCTAAGGA,76,78,2,9,1731,0,0
2621,ACGTCGAATCTAGGGA,76,78,2,12,1757,0,0
2622,ACGTCGAATCTAGGGA,76,78,2,9,1760,0,0
2639,ACGTCGACTCTAGGGA,76,78,2,12,1787,0,0
2656,ACGTCGGATCTAGGGA,76,78,2,12,1812,0,0
2658,ACGTCGACTCTAGGGA,76,78,2,12,1814,0,0
2660,ACGTCGAATCTAGGGA,76,78,2,12,1817,0,0
2679,ACGTCGAATCTAGGGA,77,78,1,7,318,0,0
2680,ACGTCGAATCTAGGGA,77,78,1,10,342,0,0
2681,ACGTCGAATCAAGGGA,77,78,1,7,343,0,0
2688,ACGTCGAATCTAGGGA,77,78,1,10,463,0,0
2735,ACGTCGAATCTAGGGA,77,78,1,10,1088,0,0
2746,ACGTCGAATCTAGGGA,77,78,1,10,1120,0,0
2750,ACGTCGAATCTAGGGA,77,78,1,10,1134,0,0
2755,ACGTCGAATCTAGGGA,77,78,1,10,1381,0,0
2775,ACGTCGACTCTCGGGA,77,78,1,10,1420,0,0
2778,ACGTCGACTCTAGGGA,77,78,1,13,1430,0,0
2780,ACGTCGAATCTAGGGA,77,78,1,10,1432,0,0
2782,ACGTCGAATCTAGGGA,77,78,1,10,1434,0,0
2798,ACGTCGAATCTAGGGA,77,78,1,10,1465,0,0
2806,ACGTCGAATCTAGGGA,77,78,1,10,1490,0,0
2822,ACGTCGACTCTAGGGA,77,78,1,10,1852,0,0
2833,ACGTCGACTCTAGGGA,77,78,1,10,1869,0,0
2835,ACGTCGACTCTAGGGA,77,78,1,13,1871,0,0
2849,ACGTCGAATCAAGGGA,77,78,1,10,1889,0,0
2859,ACGTCGAATCTAGGGA,77,78,1,10,1902,0,0
2862,ACGTCGAATCTAGGGA,77,78,1,10,1905,0,0
2898,ACGTCGAATCTAGGGA,77,78,1,10,1953,0,0
2899,ACGTCGAATCAAGGGA,77,78,1,10,1954,0,0
2901,ACGTCGACTCTAGGGA,77,78,1,10,1956,0,0
2910,ACGTCGACTCTAGGGA,77,78,1,10,1967,0,0
2920,ACGTCGAATCTGGGGA,77,78,1,13,1984,0,0
136,ACGTCGACTCTAGGGA,47,79,32,7,55,10,0
204,ACGTCGGATCTAGGGA,50,79,29,7,132,9,0
224,ACGTCGAATCTAGGGA,51,79,28,8,142,8,0
381,ACGTCGAATCTAGGGA,56,79,23,10,250,7,0
406,ACGTCGAATCTAGGGA,57,79,22,8,201,6,0
418,ACGTCGGATCTAGGGA,57,79,22,8,267,6,0
599,ACGTCGAATCAAGGGA,61,79,18,6,288,5,0
760,ACGTCGAATCAAGGGA,63,79,16,8,494,4,0
804,ACGTCGACTCTAGGGA,64,79,15,9,390,4,0
838,ACGTCGACTCTAGGGA,64,79,15,9,542,4,0
858,ACGTCGAATCTAGGGA,64,79,15,9,571,4,0
1081,ACGTCGAATCTAGGGA,67,79,12,9,553,3,0
1165,ACGTCGACTCTAGGGA,68,79,11,10,466,3,0
1188,TCGTCGAATCTAGGGA,68,79,11,10,612,3,0
1203,ACGTCGAATCTAGGGA,68,79,11,10,643,3,0
1207,ACGTCGAATCTAGGGA,68,79,11,10,781,3,0
1225,ACGTCGAATCTAGGGA,68,79,11,10,807,3,0
1229,ACGTCGACTCTAGGGA,68,79,11,10,812,3,0
1243,ACGTCGGATCTAGGGA,68,79,11,10,837,3,0
1254,ACGTCGAATCTAGGGA,68,79,11,10,854,3,0
1255,ACGTCGAATCTAGGGA,68,79,11,13,857,3,0
1264,ACGTCGAATCTAGGGA,69,79,10,8,186,2,0
1278,ACGTCGAATCTAGGGA,69,79,10,8,362,2,0
1303,ACGTCGACTCTAGGGA,69,79,10,8,674,2,0
1317,ACGTCGAATCTAGGGA,69,79,10,11,702,2,0
1361,ACGTCGAATCTAGGGA,69,79,10,11,925,2,0
1420,ACGTCGACTCTCGGGA,70,79,9,9,707,2,0
1464,ACGTCGGATCTAGGGA,70,79,9,9,960,2,0
1465,ACGTCGAATCTAGGGA,70,79,9,9,963,2,0
1490,ACGTCGAATCTAGGGA,70,79,9,9,1006,2,0
1492,ACGTCGAATCTGGGGA,70,79,9,9,1009,2,0
1507,AGGTCGAATCTAGGGA,70,79,9,12,1028,2,0
1518,ACGTCGAATCTAGGGA,71,79,8,10,243,2,0
1528,ACGTCGAATCTAGGGA,71,79,8,7,438,2,0
1551,ACGTCGAATCTAGGGA,71,79,8,10,608,2,0
1583,ACGTCGAATCTAGGGA,71,79,8,10,825,2,0
1593,ACGTCGACTCTAGGGA,71,79,8,10,850,2,0
1604,ACGTCGAATCTCGGGA,71,79,8,10,1049,2,0
1608,ACGTCGACTCTAGGGA,71,79,8,10,1058,2,0
1611,ACGTCGGATCTAGGGA,71,79,8,10,1061,2,0
1646,ACGTCGAATCTAGGGA,71,79,8,10,1118,2,0
1649,ACGTCGACTCTAGGGA,71,79,8,10,1122,2,0
1659,ACGTCGAATCTAGGGA,71,79,8,10,1138,2,0
1661,ACGTCGAATCAAGGGA,72,79,7,5,102,1,0
1664,ACGTCGACTCTAGGGA,72,79,7,8,136,1,0
1670,CCGTCGAATCTAGGGA,72,79,7,8,264,1,0
1685,ACGTCGACTCTAGGGA,72,79,7,11,496,1,0
1712,ACGTCGACTCTAGGGA,72,79,7,8,876,1,0
1713,ACGTCGAATCTAGGGA,72,79,7,11,878,1,0
1715,ACGTCGAATCTAGGGA,72,79,7,11,880,1,0
1723,ACGTCGAATCTAGGGA,72,79,7,11,897,1,0
1737,ACGTCGAATCAAGGGA,72,79,7,8,922,1,0
1751,ACGTCGACTCTAGGGA,72,79,7,11,1143,1,0
1767,ACGTCGACTCTAGGGA,72,79,7,11,1165,1,0
1779,ACGTCGAATCTAGGGA,72,79,7,11,1179,1,0
1780,ACGTGGACTCTAGGGA,72,79,7,11,1180,1,0
1787,ACGTCGACTCTAGGGA,72,79,7,11,1192,1,0
1789,ACGTCGACTCTAGGGA,72,79,7,11,1195,1,0
1817,ACGTCGAATCTAGGGA,72,79,7,11,1228,1,0
1831,CCATCGAATCTAGGGA,72,79,7,11,1247,1,0
1835,ACGTCGCATCTAGGGA,72,79,7,11,1252,1,0
1858,ACGTCGAATCTAGGGA,73,79,6,9,531,1,0
1920,ACGTCGAATCTAGGGA,73,79,6,9,1005,1,0
2015,ACGTCGAATCTAGGGA,74,79,5,10,328,1,0
2021,ACGTCGCATCTAGGGA,74,79,5,7,437,1,0
2026,ACGTCGAATCTAGGGA,74,79,5,10,456,1,0
2035,ACGTCGAATCAAGGGA,74,79,5,7,599,1,0
2042,ACGTCGACTCTAGGGA,74,79,5,7,778,1,0
2065,ACGTCGAATCTAGGGA,74,79,5,10,854,1,0
2083,ACGTCGGATCTAGGGA,74,79,5,10,1074,1,0
2088,ACGTCGAATCTAGGGA,74,79,5,10,1087,1,0
2105,ACGTCGACTCTAGGGA,74,79,5,10,1122,1,0
2109,ACGTCGAATCTAGGGA,74,79,5,10,1134,1,0
2110,ACGTCGAATCTAGGGA,74,79,5,13,1135,1,0
2136,ACGTCGAATCTAGGGA,74,79,5,10,1413,1,0
2181,ACGTCGAATCTAGGGA,74,79,5,10,1479,1,0
2219,ACGTCGAATCTAGGGA,75,79,4,11,381,0,0
2227,ACGTCGAATCTAGGGA,75,79,4,8,675,0,0
2229,ACGTCGAATCTAGGGA,75,79,4,8,679,0,0
2235,ACGTCGAATCTAGGGA,75,79,4,11,699,0,0
2262,ACGTCGAATCAAGGGA,75,79,4,8,922,0,0
2272,ACGTCGAATCTAGGGA,75,79,4,8,1147,0,0
2273,ACGTCGAATCTAGGGA,75,79,4,8,1148,0,0
2290,ACGTCGAATCAAGGGA,75,79,4,8,1178,0,0
2299,ACGTCGAATCTAGGGA,75,79,4,11,1193,0,0
2303,ACGTCGACTCTAGGGA,75,79,4,11,1199,0,0
2327,ACGTCGACTCTGGGGA,75,79,4,11,1235,0,0
2337,ACGTCGAATCTAGGGA,75,79,4,11,1251,0,0
2368,ACGTCGAATCTAGGGA,75,79,4,11,1546,0,0
2381,ACGTCGAATCTAGGGA,75,79,4,11,1567,0,0
2402,ACGTCGAATCAAGGGA,75,79,4,8,1600,0,0
2404,ACGTCGAATCTAGGGA,75,79,4,11,1603,0,0
2410,ACGTCGAATCTAGGGA,75,79,4,11,1612,0,0
2416,ACGTCGACTCTAGGGA,75,79,4,11,1621,0,0
2458,ACGTCGAATCTAGGGA,76,79,3,9,548,0,0
2470,ACGTCGAATCTAGGGA,76,79,3,9,746,0,0
2479,ACGTCGAATCTAGGGA,76,79,3,9,952,0,0
2484,ACGTCGAATCTAGGGA,76,79,3,9,976,0,0
2509,ACGTCGACTCTAGGGA,76,79,3,9,1274,0,0
2550,ACGTCGAATCTCGGGA,76,79,3,12,1362,0,0
2559,ACGTCGACTCTAGGGA,76,79,3,9,1664,0,0
2562,ACGTCGAATCTAGGGA,76,79,3,9,1668,0,0
2577,ACGTCGAATCTAGGGA,76,79,3,9,1692,0,0
2578,ACGTCGAATCAAGGGA,76,79,3,9,1693,0,0
2581,ACGTCGAATCTAGGGA,76,79,3,9,1696,0,0
2585,ACGTCGGATCTAGGGA,76,79,3,9,1707,0,0
2586,ACGTCGAATCAAGGGA,76,79,3,9,1708,0,0
2588,ACGTCGAATCTAGGGA,76,79,3,12,1710,0,0
2597,ACGTCGAATCTAAGGA,76,79,3,12,1719,0,0
2630,ACGTCGAATCTAGGGA,76,79,3,12,1771,0,0
2649,ACGTCGAATCTAGGGA,76,79,3,12,1801,0,0
2662,ACGTCGAATCTAGGGA,76,79,3,12,1819,0,0
2663,ACGTCGACTCTAGGGA,76,79,3,12,1820,0,0
2670,ACGTCGACTCTAGGGA,76,79,3,12,1830,0,0
2691,AAGTCGGATCTAGGGA,77,79,2,7,583,0,0
2725,ACGTCGACTCTAGGGA,77,79,2,10,1065,0,0
2730,ACGTCGACTCTAGGGA,77,79,2,10,1076,0,0
2790,ACGTCGAATCTAGGGA,77,79,2,13,1452,0,0
2794,ACGTCGAATCTAGGGA,77,79,2,10,1459,0,0
2829,ACGTCGAATCTAGGGA,77,79,2,10,1864,0,0
2863,ACGTCGACTCTAGGGA,77,79,2,10,1907,0,0
2908,ACGTCGAATCAAGGGA,77,79,2,10,1965,0,0
2911,ACATCGGATCTAGGGA,77,79,2,10,1968,0,0
2925,ACGTCGAATCTAGGGA,77,79,2,13,1990,0,0
2929,ACGTCGAATCTCGGGA,77,79,2,13,1995,0,0
2930,ACGTCGAATCTAGGGA,77,79,2,13,1998,0,0
2933,ACGTCGAATCTAGGGA,77,79,2,13,2001,0,0
2940,ACGTCGAATCTAGGGA,78,79,1,8,106,0,0
2965,ACGTCGAATCAAGGGA,78,79,1,8,870,0,0
2971,ACGTCGAATCTAGGGA,78,79,1,11,883,0,0
2978,AAGTCGGATCTAGGGA,78,79,1,8,911,0,0
2979,ACGTCGAATCTAGGGA,78,79,1,11,913,0,0
3000,ACGTCGACTCTAGGGA,78,79,1,8,1173,0,0
3034,ACATCGAATCTAGGGA,78,79,1,11,1247,0,0
3037,ACGTCGAATCTAGGGA,78,79,1,14,1255,0,0
3043,ACGTCGAATCTAGGGA,78,79,1,11,1521,0,0
3050,ACGTCGAATCTAGGGA,78,79,1,11,1530,0,0
3059,AAGTCGGATCTAGGGA,78,79,1,8,1542,0,0
3066,ACGTCGAATCTAGGGA,78,79,1,11,1562,0,0
3074,ACGTCGAATCTAGGGA,78,79,1,11,1583,0,0
3086,ACGTCGAATCTAGGGA,78,79,1,11,1603,0,0
3091,ACGTCGAATCTAGGGA,78,79,1,14,1613,0,0
3099,ACGTCGAATCTAGGGA,78,79,1,11,1631,0,0
3111,ACGTCGAATCTAGGGA,78,79,1,11,1656,0,0
3116,ACGTCGAATCTAGGGA,78,79,1,11,2015,0,0
3134,ACGTCGAATCAAGGGA,78,79,1,8,2045,0,0
3142,ACGTCGACTCTAGGGA,78,79,1,11,2053,0,0
3144,ACGTCGAATCTAGGGA,78,79,1,11,2056,0,0
3146,ACCTCGAATCTAGGGA,78,79,1,11,2058,0,0
3149,ACGTCGAATCTAGGGA,78,79,1,11,2065,0,0
3151,ACGTCGAATCTAGGGA,78,79,1,11,2067,0,0
3162,ACGTCGACTCTAGGGA,78,79,1,14,2087,0,0
3166,ACGTCGAATCTAGTGA,78,79,1,11,2095,0,0
3169,ACGTCGAATCTAGGGA,78,79,1,11,2100,0,0
3175,ACGTCGAATCTAGGGA,78,79,1,11,2109,0,0
3179,ACTTCGAATCTAGGGA,78,79,1,11,2116,0,0
3180,ACGTCGACTCTAGGGA,78,79,1,11,2117,0,0
3184,ACGTCGAATCTAGGGA,78,79,1,11,2126,0,0
3185,ACGTCGAATCTAGGGA,78,79,1,11,2127,0,0
258,ACGTCGAATCTAGGGA,53,80,27,7,72,8,0
437,ACGTCGCATCTAGGGA,58,80,22,6,113,6,0
603,ACGTCGAATCTAGGGA,61,80,19,9,297,5,0
655,ACGTCGAATCTAGGGA,62,80,18,7,239,5,0
699,ACGTCGAATCTAGGGA,62,80,18,10,467,5,0
706,ACGTCGAATCAAGGGA,63,80,17,5,102,5,0
766,ACGTCGAATCTAGGGA,63,80,17,8,503,5,0
820,ACGTCGAATCTAGGGA,64,80,16,9,424,4,0
857,ACGTCGAATCTAGGGA,64,80,16,12,570,4,0
866,ACGTCGGATCTAGGGA,65,80,15,7,132,4,0
920,ACGTCGAATCTAGGGA,65,80,15,10,597,4,0
938,GCGTCGAATCTAGGGA,65,80,15,10,624,4,0
946,ACGTCGACTCTAGGGA,65,80,15,10,642,4,0
970,ACGTCGAATCTAGGGA,66,80,14,8,351,4,0
985,ACGTCGAATCTAGGGA,66,80,14,11,378,4,0
1048,ACGTCGAATCTAGGGA,67,80,13,9,305,3,0
1063,ACGTCGAATCTAGGGA,67,80,13,12,428,3,0
1084,ACGTCGAATCTAGGGA,67,80,13,9,563,3,0
1088,ACGTCGAATCTAGGGA,67,80,13,9,572,3,0
1096,ACGTCGAATCTAGGGA,67,80,13,9,713,3,0
1109,ACGTCGAATCTAGGGA,67,80,13,9,735,3,0
1135,ACGTCGAATCTAGGGA,67,80,13,12,771,3,0
1227,ACGTCGAATCTAGGGA,68,80,12,10,809,3,0
1290,ACGTCGACTCTAGGGA,69,80,11,8,502,3,0
1308,ACATCGGATCTAGGGA,69,80,11,8,683,3,0
1326,ACGTCGACTCTAGGGA,69,80,11,8,876,3,0
1343,ACGTCGAATCTAGGGA,69,80,11,11,900,3,0
1385,ACGTCGAATCTCGGGA,70,80,10,9,313,2,0
1413,ACGTCGAATCTAGGGA,70,80,10,9,564,2,0
1432,ACGTCGAATCTAGGGA,70,80,10,9,735,2,0
1454,ACGTCGAATCTAGGGA,70,80,10,9,774,2,0
1466,ACGTCGAATCAAGGGA,70,80,10,9,965,2,0
1467,ACGTCGAATCTAGGCA,70,80,10,9,967,2,0
1477,ACGTCGACTCTAGGGA,70,80,10,12,984,2,0
1519,ACGTCGAATCTAGGGA,71,80,9,7,246,2,0
1533,ACGTCGAATCTAGGGA,71,80,9,10,456,2,0
1536,ACGTCGAATCTAGGGA,71,80,9,10,467,2,0
1540,ACGTCGGATCTAGGGA,71,80,9,10,475,2,0
1541,ACGTCGAATCTAGGGA,71,80,9,7,579,2,0
1567,ACGTCGAATCTAGGGA,71,80,9,10,789,2,0
1592,ACGTCGAATCTAGGGA,71,80,9,10,848,2,0
1652,ACGTCGAATCAAGGGA,71,80,9,10,1128,2,0
1682,ACGTCGACTCTAGGGA,72,80,8,8,477,2,0
1692,ACGTCGAATCTAGGGA,72,80,8,8,661,2,0
1708,ACGTCGAATCAAGGGA,72,80,8,8,870,2,0
1710,ACGTCGAATCTAGGGA,72,80,8,11,873,2,0
1711,ACGTCGAATCTAGGGA,72,80,8,8,875,2,0
1727,ACGTCGAATCTAGGGA,72,80,8,11,903,2,0
1760,ACGTCGAATCTAGGGA,72,80,8,8,1156,2,0
1788,ACGTCGAATCTAGGGA,72,80,8,11,1193,2,0
1808,ACGTCGAATCAAGCGA,72,80,8,8,1216,2,0
1814,ACGTCGACTCTAGGGA,72,80,8,11,1223,2,0
1871,ACGTCGACTCTAGGGA,73,80,7,12,568,1,0
1878,ACGTCGAATCTAGGGA,73,80,7,9,724,1,0
1891,ACGTCGAATCTAGGGA,73,80,7,9,757,1,0
1902,ACGTCGAATCTAGGGA,73,80,7,9,963,1,0
1913,ACGTCGAATCTAGGGA,73,80,7,9,986,1,0
1924,ACGTCGACTCTAGGGA,73,80,7,9,1017,1,0
1947,ACGTCGACTCTAGGGA,73,80,7,12,1280,1,0
1953,ACGTCGAATCTAGGGA,73,80,7,9,1287,1,0
1964,ACGTCGAATCTAGGGA,73,80,7,9,1300,1,0
2014,ACGTCGAATCTAGGGA,74,80,6,7,318,1,0
2031,AAGTCGGATCTAGGGA,74,80,6,7,583,1,0
2038,TCGTCGAATCTAGGGA,74,80,6,10,612,1,0
2043,ACGTCGGATCTAGGGA,74,80,6,7,780,1,0
2048,ACGTCGAATCTAGGGA,74,80,6,10,791,1,0
2078,ACGTCGAATCTAGGGA,74,80,6,13,1063,1,0
2143,ACGTCGAATCTAGGGA,74,80,6,10,1421,1,0
2159,ACGTCGAATCTAGGGA,74,80,6,10,1443,1,0
2161,ACGTCGAATCAAGGGA,74,80,6,10,1446,1,0
2171,ACGTCGAATCTAGGGA,74,80,6,10,1463,1,0
2180,ACGTCGACTCTAGGGA,74,80,6,13,1477,1,0
2198,AGGTCGAATCTAGGGA,74,80,6,13,1507,1,0
2221,ACGTCGAATCTAGGGA,75,80,5,11,510,1,0
2261,ACGTCGAATCTAGGGA,75,80,5,11,920,1,0
2281,ACGTCGAATCTAGGGA,75,80,5,11,1166,1,0
2291,ACGTCGAATCTAGGGA,75,80,5,11,1179,1,0
2292,ACGTGGACTCTAGGGA,75,80,5,11,1180,1,0
2298,ACGTCGACTCTAGGGA,75,80,5,11,1192,1,0
2308,ACGTCGAATCTAGGGA,75,80,5,11,1207,1,0
2316,ACGTCGACTCTAGGGA,75,80,5,11,1219,1,0
2317,ACGTCGAATCTCGGGA,75,80,5,11,1220,1,0
2333,ACGTCGACTCTAGGGA,75,80,5,11,1245,1,0
2336,ACGTCGAATCAAGGGA,75,80,5,11,1249,1,0
2354,ACGTCGAATCTAGGGA,75,80,5,11,1529,1,0
2364,AAGTCGGATCTAGGGA,75,80,5,8,1542,1,0
2380,ACGTGGACTCTAGGGA,75,80,5,11,1565,1,0
2394,ACGTCGACTCTAGGGA,75,80,5,11,1588,1,0
2411,ACGTCGAATCTAGGGA,75,80,5,14,1613,1,0
2413,ACGTCGACTCTAGGGA,75,80,5,11,1615,1,0
2431,ACGTCGAATCTAGGGA,75,80,5,11,1648,1,0
2437,ACGTCGAATCTAGGGA,75,80,5,11,1656,1,0
2438,TCGTCGAATCTAAGGA,75,80,5,14,1657,1,0
2448,ACGTCGGATCTAGGGA,76,80,4,9,418,0,0
2472,ACGTCGACTCTAGGGA,76,80,4,9,753,0,0
2498,ACGTCGAATCTAGGGA,76,80,4,12,1023,0,0
2504,ACGTCGAATCAAGGGA,76,80,4,6,1260,0,0
2505,ACGTCGAATCTAGGGA,76,80,4,9,1264,0,0
2516,ACGTCGACTCTAGGGA,76,80,4,9,1290,0,0
2551,ACGTCGGATCTAGGGA,76,80,4,12,1363,0,0
2552,ACCTCGACTCTAGGGA,76,80,4,12,1366,0,0
2564,ACGTCGACTCTAGGGA,76,80,4,12,1672,0,0
2567,ACGTCGACTCTAGGGA,76,80,4,12,1677,0,0
2568,CCGTCGAATCTAGGGA,76,80,4,12,1679,0,0
2610,ACGTCGAATCTAGGGA,76,80,4,9,1737,0,0
2616,ACGTCGACTCTAGGGA,76,80,4,12,1751,0,0
2617,ACGTCGAATCAAGGGA,76,80,4,9,1752,0,0
2619,ACGTCGAATCTAGGGA,76,80,4,9,1754,0,0
2629,GCGTCGAATCTAGGGA,76,80,4,12,1770,0,0
2632,ACGTCGGATCTAGGGA,76,80,4,12,1773,0,0
2636,ACGTCGAATCTAGGGA,76,80,4,12,1782,0,0
2638,ACGTCGAATCTAGGGA,76,80,4,12,1784,0,0
2702,ACGTCGACTCTAGGGA,77,80,3,10,790,0,0
2713,ACGTCGACTCTAGGGA,77,80,3,10,850,0,0
2726,ACGTCGAATCTAGGGA,77,80,3,10,1066,0,0
2729,ACGTCGGATCTAGGGA,77,80,3,10,1074,0,0
2738,ACGTCGAATCTAGGGA,77,80,3,10,1105,0,0
2740,ACGTCGAATCTAGTGA,77,80,3,10,1108,0,0
2753,ACGTCGACTCTAGGGA,77,80,3,7,1376,0,0
2760,ACGTCGACTCTAGGGA,77,80,3,10,1389,0,0
2763,ACGTCGAATCTAGGGA,77,80,3,10,1400,0,0
2767,ACGTCGACTCTAGGGA,77,80,3,10,1407,0,0
2769,ACGTCGACTCTAGGGA,77,80,3,10,1411,0,0
2773,ACGTCGACTATAGGGA,77,80,3,13,1417,0,0
2815,ACGTCGACTCTAGGGA,77,80,3,13,1510,0,0
2839,ACGTCGAATCTAGGGA,77,80,3,10,1876,0,0
2841,ACGTCGAATCTAGGGA,77,80,3,10,1878,0,0
2844,ACGTCGAATCTAGGGA,77,80,3,10,1882,0,0
2852,ACGTCGAATCTAGGCA,77,80,3,10,1892,0,0
2886,ACGTCGACTCTAGGGA,77,80,3,10,1937,0,0
2909,ACGTCGAATCTAGGGA,77,80,3,10,1966,0,0
2913,ACGTCGAATCTAGGGA,77,80,3,13,1973,0,0
2924,ACGTCGAATCAAGGGA,77,80,3,10,1989,0,0
2935,ACCTCGACTCTAGGGA,77,80,3,13,2004,0,0
2937,ACGTCGAATCTAGGGA,77,80,3,13,2006,0,0
2955,ACGTCGAATCAAGGGA,78,80,2,8,663,0,0
2961,ACGTCGAGTCTAGGGA,78,80,2,11,693,0,0
2981,ACGTCGAATCTAGGGA,78,80,2,11,920,0,0
3002,ACGTCGAATCTAGGGA,78,80,2,11,1176,0,0
3007,TCGTCGAATCTAGGGA,78,80,2,11,1188,0,0
3018,ACGTCGAATCTAGGGA,78,80,2,11,1209,0,0
3019,ACGTCGAATCAAGGGA,78,80,2,8,1212,0,0
3052,ACGTCGAATCTAGGGA,78,80,2,11,1534,0,0
3054,ACGTCGAATCTAGGGA,78,80,2,11,1536,0,0
3094,ACGTCGAATCTAGGGA,78,80,2,11,1618,0,0
3096,ACGTCGAATCAAGGGA,78,80,2,11,1622,0,0
3098,ACGTCGAATCTAGGGA,78,80,2,11,1629,0,0
3101,ACGTCGAATCTAGTGA,78,80,2,11,1638,0,0
3107,ACGTCGACTCTAGGGA,78,80,2,11,1650,0,0
3117,ACGTCGAATCTAGGGA,78,80,2,11,2016,0,0
3159,ACGTCGACTCTAGGGA,78,80,2,11,2079,0,0
3167,ACGTCGAATCTAGGGA,78,80,2,11,2096,0,0
3183,ACGTCGACTCTAGGGA,78,80,2,11,2125,0,0
3188,ACGTCGCATCTAGGGA,78,80,2,11,2132,0,0
3202,ACGTCGAATCAAGGGA,78,80,2,11,2155,0,0
3214,ACGTCGAATCTAGGGA,78,80,2,11,2178,0,0
3220,ACGTCGAATCTAGGGA,78,80,2,11,2187,0,0
3224,ACGTCGAATCTAGGGA,78,80,2,14,2192,0,0
3226,AGGTCGAATCTAGGGA,78,80,2,14,2198,0,0
3234,ACGTCGACTCTAGGGA,79,80,1,9,390,0,0
3237,ACGTCGACTCTAGGGA,79,80,1,9,522,0,0
3251,ACGTCGAATCTAGGGA,79,80,1,9,738,0,0
3262,ACGTCGAATCTAGGGA,79,80,1,9,967,0,0
3269,ACGTCGAATCTAGGGA,79,80,1,9,986,0,0
3291,ACGTCGAATCTAGGGA,79,80,1,12,1293,0,0
3305,ACGTCGAATCTAGGGA,79,80,1,9,1325,0,0
3315,ACGTCGAATCTCGGGA,79,80,1,12,1362,0,0
3328,ACGTCGAATCAAGGGA,79,80,1,9,1684,0,0
3338,ACGTCGAATCTAGGGA,79,80,1,12,1697,0,0
3341,ACGTCGAATCAAGGGA,79,80,1,9,1708,0,0
3346,ACGTCGAATCTAGGGA,79,80,1,12,1716,0,0
3358,ACGTCGACTCTAGGGA,79,80,1,12,1742,0,0
3362,ACGTTGAATCTAGGGA,79,80,1,12,1757,0,0
3377,ACGTCGACTCTAGGGA,79,80,1,12,1792,0,0
3383,ACGTCGAATCTAGGGA,79,80,1,12,1802,0,0
3390,ACGTCGACTCTAGGGA,79,80,1,12,1814,0,0
3391,ACGTCGAATCTAGGGA,79,80,1,12,1815,0,0
3395,ACGTCGAATCTAGGGA,79,80,1,12,1825,0,0
3397,ACGTCGACTCTAGGGA,79,80,1,12,1830,0,0
3407,ACGTCGAATCTAGGGA,79,80,1,9,2212,0,0
3411,ACGTCGAATCTAGGGA,79,80,1,12,2221,0,0
3453,ACGTCGAACCTAGGGA,79,80,1,12,2283,0,0
3454,ACGTCGGATCTAGGGA,79,80,1,12,2285,0,0
3467,ACGTCGAATCTAGGGA,79,80,1,12,2306,0,0
3483,ACGTCGAATCTAGGGA,79,80,1,12,2331,0,0
3488,ACGTCGAATCTAGGGA,79,80,1,15,2339,0,0
3504,ACGTCGAATCTAGGGA,79,80,1,9,2363,0,0
3506,ACGTCGAATCTAGGGA,79,80,1,12,2365,0,0
3517,ACGTCGACTCTAGGGA,79,80,1,12,2385,0,0
3534,ATGTCGGATCTAGGGA,79,80,1,12,2409,0,0
3547,ACGTCGACTCTAGGGA,79,80,1,12,2427,0,0
3552,ACGTCGACTCTAGGGA,79,80,1,12,2432,0,0
122,ACGTCGAATCTAGGGA,45,81,36,8,83,11,0
378,ACGTCGAATCTAGGGA,56,81,25,10,243,7,0
547,ACGTCGACTCTAGGGA,60,81,21,8,262,6,0
679,ACGTCGAATCTAGGGA,62,81,19,7,438,5,0
680,ACGTCGAATCTAGGGA,62,81,19,10,439,5,0
740,ACGTCGAATCTAGGGA,63,81,18,8,365,5,0
793,ACGTCGAATCTAGGGA,64,81,17,9,297,5,0
881,ACGTCGAATCTAGGGA,65,81,16,10,342,4,0
959,ACGTCGAATCTAGGGA,66,81,15,8,197,4,0
986,ACGTCGAATCTAGGGA,66,81,15,8,379,4,0
999,ACGTCGAATCTAGGGA,66,81,15,8,509,4,0
1005,ACGTCGAATCTAGGGA,66,81,15,8,649,4,0
1114,ACGTCGAATCTAGGGA,67,81,14,9,740,4,0
1133,ACGTCGAATCTAGGGA,67,81,14,9,766,4,0
1172,ACGTCGAATCTAGGGA,68,81,13,7,579,3,0
1174,AAGTCGGATCTAGGGA,68,81,13,7,583,3,0
1189,ACGTCGAATCAAGGGA,68,81,13,10,615,3,0
1239,ACGTCGAATCTAGGGA,68,81,13,10,829,3,0
1293,ACGTCGAATCTAGGGA,69,81,12,11,518,3,0
1316,GCGTCGAATCTAGGGA,69,81,12,11,701,3,0
1350,AAGTCGGATCTAGGGA,69,81,12,8,911,3,0
1362,ACGTCGAATCTCGGGA,69,81,12,11,928,3,0
1451,ACGTCGAATCTAGGGA,70,81,11,9,769,3,0
1453,ACGTCGAATCTAGGGA,70,81,11,12,772,3,0
1463,ACGTCGAATCTAGGGA,70,81,11,9,959,3,0
1500,ACGTCGAATCTAGGGA,70,81,11,9,1020,3,0
1520,ACGTCGAATCTAGGGA,71,81,10,7,318,2,0
1526,ACGTCGAATCTAGGGA,71,81,10,10,347,2,0
1529,ACGTCGAATCTAGGGA,71,81,10,10,440,2,0
1586,ACGTCGAATCTAGGGA,71,81,10,10,833,2,0
1589,ACGTCGACTCTAGGGA,71,81,10,10,841,2,0
1600,ACGTCGAATCAAGGGA,71,81,10,7,1042,2,0
1616,ACGTCGAATCTAGGGA,71,81,10,10,1066,2,0
1666,ACGTCGAATCTAGGGA,72,81,9,8,197,2,0
1686,ACGTCGACTCTAGGGA,72,81,9,8,502,2,0
1716,ACGTCGAATCTAGGGA,72,81,9,11,881,2,0
1742,ACCTCGACTCTAGGGA,72,81,9,11,934,2,0
1746,ACGTCGAATCCAGGGA,72,81,9,11,939,2,0
1771,ACGTCGAATCTAGGGA,72,81,9,11,1169,2,0
1783,ACGTCGAATCTAGGTA,72,81,9,11,1186,2,0
1813,ACGTCGACTCTAGGGA,72,81,9,11,1222,2,0
1842,ACGTCGAATCTAGGGA,73,81,8,9,122,2,0
1844,ACGTCGAATCTAGGGA,73,81,8,9,297,2,0
1852,ACGTCGACTCTAGGGA,73,81,8,9,413,2,0
1857,ACGTCGAATCTAGGGA,73,81,8,9,530,2,0
1905,ACGTCGAATCTAGGGA,73,81,8,9,968,2,0
1938,ACGTCGAATCTAGGGA,73,81,8,9,1264,2,0
1958,ACGTCGAATCTAGGGA,73,81,8,12,1292,2,0
1969,ACGTCGAATCTAGGGA,73,81,8,12,1309,2,0
1979,ACGTCGAATCTAGGGA,73,81,8,9,1322,2,0
2000,ACGTCGAATCTAGGGA,73,81,8,12,1356,2,0
2007,GCGTCGAATCTAGGGA,73,81,8,12,1369,2,0
2011,ACGTCGGATCTAGGGA,74,81,7,7,132,1,0
2046,ACGTCGAATCTAGGGA,74,81,7,10,789,1,0
2082,ACGTCGAATCTAGGGA,74,81,7,10,1070,1,0
2087,ACGTCGACTCTAGGGA,74,81,7,13,1086,1,0
2091,ACGTCGAATCTAGGGA,74,81,7,10,1094,1,0
2147,ACGTCGAATCTAGGGA,74,81,7,10,1428,1,0
2185,ACGTCGAATCTAGGGA,74,81,7,10,1487,1,0
2197,ACGTGGACTCTAGGGA,74,81,7,13,1506,1,0
2203,ACGTCGAATCTAGGGA,74,81,7,13,1513,1,0
2205,ACGTCGAATCTAGGGA,75,81,6,8,106,1,0
2209,ACGTCGAATCTAGGGA,75,81,6,8,259,1,0
2226,ACGTCGAATCAAGGGA,75,81,6,8,663,1,0
2238,ACGTCGGATCTAGGGA,75,81,6,8,866,1,0
2264,ACGTCGAATCTAGGGA,75,81,6,11,925,1,0
2282,ACGTCGAATCTAGGGA,75,81,6,11,1167,1,0
2294,ACGTCGAATCTAGGGA,75,81,6,11,1185,1,0
2297,ACGTCGAATCAAGGGA,75,81,6,11,1189,1,0
2315,ACGTCGAATCTAGGGA,75,81,6,11,1217,1,0
2328,ACGTCGAATCTAGGGA,75,81,6,11,1237,1,0
2331,ACGTCGAATCTAGGGA,75,81,6,11,1242,1,0
2341,ACGTCGAATCTAGGGA,75,81,6,14,1259,1,0
2372,ACGTCGAATCTAGGGA,75,81,6,11,1551,1,0
2374,ACGTCGAATCTAGGGA,75,81,6,11,1555,1,0
2377,ACGTCGACTCTAGGGA,75,81,6,11,1558,1,0
2379,ACGTCGAATCTAGGGA,75,81,6,11,1564,1,0
2395,ACGTCGACTCTAGGGA,75,81,6,11,1589,1,0
2400,ACGTCGAATCTAGGGA,75,81,6,11,1596,1,0
2408,ACGTCGAATCTAGGGA,75,81,6,11,1610,1,0
2433,ACGTCGACTCTAGGGA,75,81,6,11,1650,1,0
2436,ACGTCGAATCTAGGGA,75,81,6,11,1654,1,0
2444,ACGTCGACTCTAGGGA,76,81,5,9,386,1,0
2449,ACGTCGAATCTAGGGA,76,81,5,9,424,1,0
2451,ACGTCGAATCTAGGGA,76,81,5,9,531,1,0
2455,ACGTCGACTCTAGGGA,76,81,5,9,545,1,0
2463,ACGTCGAATCAAGGGA,76,81,5,6,706,1,0
2512,ACGTCGACTCTAGGGA,76,81,5,12,1280,1,0
2547,ACGTCGAATCTAGGGA,76,81,5,12,1353,1,0
2556,ACGTCGAATCTAGGGA,76,81,5,12,1370,1,0
2561,ACGTCGAATCTAGGGA,76,81,5,9,1666,1,0
2570,ACGTCGAATCTAGGGA,76,81,5,9,1683,1,0
2571,ACGTCGAATCAAGGGA,76,81,5,9,1684,1,0
2587,ACGTCGAATCTAGGGA,76,81,5,9,1709,1,0
2608,ACGTCGAATCTAGGGA,76,81,5,12,1734,1,0
2626,ACGTCGACTCTAGGGA,76,81,5,12,1767,1,0
2628,ACGTCGAATCTAGGGA,76,81,5,12,1769,1,0
2676,ACGTCGAGTCAAGGGA,76,81,5,12,1839,1,0
2700,ACGTCGACTCTAGGGA,77,81,4,7,778,0,0
2704,ACGTCGAATCTAGGGA,77,81,4,10,793,0,0
2706,ACGTCGACTCTAGGGA,77,81,4,10,797,0,0
2736,ACGTCGAATCAAGGGA,77,81,4,7,1091,0,0
2741,ACGTCGAATCTAGGGA,77,81,4,10,1109,0,0
2742,ACGTCGACTCTAGGGA,77,81,4,10,1111,0,0
2749,ACGTCGAATCTAGGGA,77,81,4,10,1133,0,0
2754,ACGTCGAATCAAGGGA,77,81,4,7,1379,0,0
2759,ACGTCGACTCTAGGGA,77,81,4,10,1386,0,0
2766,ACGTCGACTCTAGGGA,77,81,4,10,1405,0,0
2772,ACGTCGAATCTAGGGA,77,81,4,10,1416,0,0
2776,ACGTCGAATCTAGGGA,77,81,4,10,1423,0,0
2792,ACGTCGAATCTAGGGA,77,81,4,10,1454,0,0
2812,ACGTGGACTCTAGGGA,77,81,4,13,1506,0,0
2830,ACGTCGACTCTAGGGA,77,81,4,10,1865,0,0
2831,ACGTCGAATCTAGGGA,77,81,4,10,1866,0,0
2855,ACGTCGAATCTAGGGA,77,81,4,10,1897,0,0
2866,ACGTCGAATCTAGGGA,77,81,4,13,1912,0,0
2879,ACGTGGACTCTAGGGA,77,81,4,13,1929,0,0
2885,ACGTCGAATCAAGGGA,77,81,4,7,1936,0,0
2895,ACGTCGAATCTAGGGA,77,81,4,10,1950,0,0
2896,ACGTCGAATCTAGGGA,77,81,4,13,1951,0,0
2907,ACGTCGAATCTAGGGA,77,81,4,10,1964,0,0
2917,ACGTCGACTCTAGGGA,77,81,4,13,1980,0,0
2936,ACGTCGAATCTAGGGA,77,81,4,13,2005,0,0
2941,ACGTCGACTCTAGGGA,78,81,3,8,136,0,0
2962,ACGTCGAATCAAGGGA,78,81,3,8,697,0,0
2982,ACGTCGAATCAAGGGA,78,81,3,8,922,0,0
2995,ACGTCGACTCTAGGGA,78,81,3,11,1165,0,0
3013,ACGTCGAATCTAGGGA,78,81,3,11,1201,0,0
3014,ACGTCGACTCTAGGGA,78,81,3,11,1202,0,0
3024,ACGTCGACTCTAGGGA,78,81,3,11,1229,0,0
3032,ACGTCGGATCTAGGGC,78,81,3,11,1243,0,0
3036,ACGTCGAATCTAGGGA,78,81,3,11,1254,0,0
3046,ACGTCGAATCTAGGGA,78,81,3,11,1526,0,0
3048,ACGTCGAATCTAGGGA,78,81,3,8,1528,0,0
3071,ACGTCGAATCTAGGGA,78,81,3,11,1572,0,0
3075,ACGTCGAATCTAGGGA,78,81,3,11,1585,0,0
3081,ACGTCGAATCTAGGGA,78,81,3,14,1595,0,0
3104,ACGTCGAATCTAGGGA,78,81,3,11,1646,0,0
3112,ACGTCGAATCTAGGGA,78,81,3,11,1659,0,0
3121,ACGTCGAATCTAGGGA,78,81,3,11,2023,0,0
3125,ACGTCGAATCTAGGGA,78,81,3,11,2034,0,0
3136,ACGTCGACTCTAGGGA,78,81,3,11,2047,0,0
3152,ACGTCGACTCTAGGGA,78,81,3,8,2068,0,0
3164,ACGTCGAATCAAGGGA,78,81,3,8,2090,0,0
3197,ACGTCGACTCTAGGGA,78,81,3,11,2146,0,0
3207,ACGTCGAATCTAGGGA,78,81,3,11,2162,0,0
3213,ACGTCGAATCAAGGGA,78,81,3,11,2174,0,0
3218,ACGTCGAATCTAGGGA,78,81,3,11,2185,0,0
3228,ACGTCGAATCTAGGGA,78,81,3,14,2202,0,0
3231,ACGTCGACTCTAGGGA,79,81,2,9,302,0,0
3239,ACGTCGACTCTAGGGA,79,81,2,9,534,0,0
3245,ACGTCGAATCTAGGGA,79,81,2,9,564,0,0
3250,ACGTCGACTCTAGGGA,79,81,2,9,737,0,0
3253,ACGTCGACTCTAGGGA,79,81,2,12,742,0,0
3256,ACGTCGAATCAAGGGA,79,81,2,9,759,0,0
3258,ACGTCGAATCTAGGGA,79,81,2,9,766,0,0
3261,ACGTCGAATCTAGGGA,79,81,2,9,959,0,0
3266,ACGTCGAATCTAGGGA,79,81,2,12,981,0,0
3292,ACGTCGAATCTAGGGA,79,81,2,9,1295,0,0
3313,ACGTCGAATCTAGGGA,79,81,2,12,1352,0,0
3378,ACGTCGAATCTAGGGA,79,81,2,12,1793,0,0
3396,ACGTCGGATCTAGGGA,79,81,2,12,1829,0,0
3401,ACGTCGAATCAAGGGA,79,81,2,12,1839,0,0
3406,ACGTCGACTCTAGGGA,79,81,2,12,2211,0,0
3413,ACGTCGACTCTAGGGA,79,81,2,9,2224,0,0
3417,ACGTCGAATCTAGGGA,79,81,2,12,2230,0,0
3418,ACGTCGAATCTAGGGA,79,81,2,12,2231,0,0
3419,ACGTCGAGTCTAGGGA,79,81,2,12,2232,0,0
3440,ACGTCGAATCTAGGGA,79,81,2,12,2259,0,0
3442,CCGTCGAATCTAGGGA,79,81,2,12,2261,0,0
3445,ACGTCGACTCTAGGGA,79,81,2,12,2265,0,0
3473,ACGTCGAATCAAGCGA,79,81,2,9,2314,0,0
3487,ACGTCGAATCAAGGGA,79,81,2,12,2336,0,0
3490,ACGTCGAATCTAGGGA,79,81,2,9,2346,0,0
3505,AAGTCGGATCTAGGGA,79,81,2,9,2364,0,0
3507,ACGTCGAATCTAGGGA,79,81,2,12,2367,0,0
3514,ACGTCGAATCTAGGGA,79,81,2,12,2379,0,0
3536,ACGTCGACTCTAGGGA,79,81,2,12,2413,0,0
3551,ACGTCGAATCTAGGGA,79,81,2,12,2431,0,0
3554,ACGTCCAATCTAGGCA,79,81,2,12,2434,0,0
3556,ACGTCGAATCTAGGGA,79,81,2,12,2437,0,0
3596,ACGTCGACTCTAGGGA,80,81,1,13,1086,0,0
3634,ACGTCGAATCAAGGGA,80,81,1,10,1438,0,0
3648,ACGTCGAATCTAGGGA,80,81,1,10,1505,0,0
3668,ACGTCGACTCTAGGGA,80,81,1,10,1869,0,0
3682,ACGTCGAATCAAGGGA,80,81,1,10,1893,0,0
3691,ACGTCGACTCTAGGGA,80,81,1,10,1907,0,0
3707,ACGTCGACTCTAGGGA,80,81,1,10,1937,0,0
3714,ACGTCGAATCTAGGGA,80,81,1,13,1949,0,0
3731,ACGTCGAATCTAGGGA,80,81,1,13,1973,0,0
3735,ACGTCGACTCTAGGGA,80,81,1,13,1980,0,0
3739,ACGTCGAATCTAGGGA,80,81,1,10,1985,0,0
3741,ACGTCGAATCTAAGGA,80,81,1,13,1988,0,0
3749,ACGTCGGATCTAGGGA,80,81,1,13,2003,0,0
3751,ACGTCGAATCTAGGGA,80,81,1,13,2005,0,0
3755,ACGTCGAATCTAGGGA,80,81,1,10,2441,0,0
3757,ACGTCGAATCTCGGGA,80,81,1,10,2443,0,0
3758,ACGTCGACTCTAGGGA,80,81,1,10,2444,0,0
3762,ACGTCGAATCTAGGGA,80,81,1,10,2449,0,0
3771,ACGTCGAATCTAGGGA,80,81,1,10,2459,0,0
3809,ACGTCGAATCTAGGGA,80,81,1,13,2514,0,0
3819,ACGTCGAGTCTAGGGA,80,81,1,13,2528,0,0
3834,ACGTCGAATCTAGGGA,80,81,1,13,2549,0,0
3844,ACGTCGACTCTAGGGA,80,81,1,10,2569,0,0
3852,ACGTCGAATCAAGGGA,80,81,1,10,2584,0,0
3864,ACGTCGAATCTCGGGA,80,81,1,13,2606,0,0
3873,ACGTCGAATCTAGGGA,80,81,1,13,2623,0,0
3874,ACGTCGGATCTAGGGA,80,81,1,10,2624,0,0
3887,ACGTCGAATCTAGGGA,80,81,1,13,2647,0,0
3897,ACGTCGACTCTAGGGA,80,81,1,13,2665,0,0
3901,ACGTCGAATCTAGGGA,80,81,1,13,2673,0,0
456,ACGTCGAATCTAGGGA,58,82,24,9,286,7,0
545,ACGTCGACTCTAGGGA,60,82,22,8,260,6,0
697,ACGTCGAATCAAGGGA,62,82,20,7,465,6,0
753,ACGTCGACTCTAGGGA,63,82,19,8,477,5,0
871,ACGTCGAATCTAGGGA,65,82,17,7,239,5,0
888,ACGTCGAATCTAAGGA,65,82,17,10,439,5,0
898,ACGTCGAATCTAGGGA,65,82,17,10,457,5,0
995,ACGTCGAATCAAGGGA,66,82,16,8,494,4,0
1032,ACGTCGAATCTAGGGA,66,82,16,11,699,4,0
1039,ACGTCGAATCTAGGGA,67,82,15,9,122,4,0
1087,ACGTCGAATCTAGGGA,67,82,15,9,571,4,0
1145,ACGTCGAATCAAGGGA,68,82,14,7,236,4,0
1170,ACGTCGAATCTCGGGA,68,82,14,10,474,4,0
1217,ACGTCGAATCTAGGGA,68,82,14,10,793,4,0
1323,ACGTCGACTCTAGGGA,69,82,13,11,872,3,0
1331,ACGTCGAATCTAGGGA,69,82,13,11,883,3,0
1367,ACGTCGAATCTAGGGA,69,82,13,11,935,3,0
1368,ACGTCGAATCTAGGGA,69,82,13,11,936,3,0
1369,GCGTCGAATCTAGGGA,69,82,13,11,938,3,0
1381,ACGTCGAATCTAGGGA,70,82,12,9,224,3,0
1542,AAGTCGGATCTAGGGA,71,82,11,7,583,3,0
1621,ACGTCGACTCTAGGGA,71,82,11,10,1076,3,0
1654,ACGTCGAATCTAGGGA,71,82,11,10,1131,3,0
1665,ACGTCGAATCTAGGGA,72,82,10,8,186,2,0
1714,ACGTCGAATCTAGGGA,72,82,10,8,879,2,0
1820,ACGTCGACTCTAGGGA,72,82,10,11,1232,2,0
1832,ACGTCGAATCTAGGGA,72,82,10,11,1248,2,0
1848,ACGTCGACTCTAGGGA,73,82,9,9,390,2,0
1900,ACGTCGACTCTAGGGA,73,82,9,9,956,2,0
1904,ACGTCGAATCTAGGGA,73,82,9,9,967,2,0
1944,ACGTCGACTCTAGGGA,73,82,9,9,1276,2,0
1954,ACGTCGAATCAAGGGA,73,82,9,9,1288,2,0
1982,ACGTCGAATCTAGGGA,73,82,9,9,1325,2,0
1985,ACGTCGAATCTAGGGA,73,82,9,9,1328,2,0
2044,ACGTCGAATCTAGGGA,74,82,8,10,784,2,0
2075,ACGTCGACTCTAGGGA,74,82,8,10,1055,2,0
2116,ACGTCGAATCTAGGGA,74,82,8,10,1382,2,0
2126,ACGTCGAATCTAGGGA,74,82,8,10,1400,2,0
2131,ACGTCGACTCTAGGGA,74,82,8,10,1407,2,0
2157,ACGTCGACTCTAGGGA,74,82,8,10,1441,2,0
2232,ACGTCGAGTCTAGGGA,75,82,7,11,693,1,0
2233,ACGTCGAATCAAGGGA,75,82,7,8,697,1,0
2241,ACGTCGAATCTAGGGA,75,82,7,11,873,1,0
2242,ACGTCGACTCTAGGGA,75,82,7,8,876,1,0
2249,ACGTCGAATCAAGGGA,75,82,7,8,892,1,0
2251,ACGTCGAATCTAGGGA,75,82,7,8,894,1,0
2278,ACGTCGAATCTAGGGA,75,82,7,11,1160,1,0
2283,ACGTCGAACCTAGGGA,75,82,7,11,1169,1,0
2295,ACGTCGAATCTAGGGA,75,82,7,11,1187,1,0
2322,ACGTCGAATCTAGGGA,75,82,7,11,1228,1,0
2324,ACGTCGAATCTAGGGA,75,82,7,11,1230,1,0
2346,ACGTCGAATCTAGGGA,75,82,7,8,1519,1,0
2398,ACGTCGACTCTAGGGA,75,82,7,11,1593,1,0
2426,ACGTCGAATCTAGGGA,75,82,7,11,1639,1,0
2429,ACGTCGAATCTAGGGA,75,82,7,11,1646,1,0
2462,ACGTCGACTCTAGGGA,76,82,6,12,568,1,0
2464,ACGTCGAATCTAGGGA,76,82,6,9,715,1,0
2465,ACGTCGAATCTAGGGA,76,82,6,9,735,1,0
2478,ACGTCGAATCAAGGGA,76,82,6,6,949,1,0
2480,ACGTCGAATCTAGGGA,76,82,6,9,959,1,0
2483,ACGTCGAATCTAGGGA,76,82,6,9,970,1,0
2519,ACGTCGAATCTAGGGA,76,82,6,12,1293,1,0
2524,ACGTCGAATCTAGGGA,76,82,6,9,1300,1,0
2558,ACGTCGAATCTAGGGA,76,82,6,9,1663,1,0
2579,ACGTCGAATCTAGGGA,76,82,6,9,1694,1,0
2604,ACGTCGAATCTAGGGA,76,82,6,12,1727,1,0
2612,ACCTCGACTCTAGGGA,76,82,6,12,1742,1,0
2613,ACGTCGAATCTAGGGA,76,82,6,12,1743,1,0
2642,ACGTCGAATCTAGGGA,76,82,6,12,1791,1,0
2669,ACGTCGGATCTAGGGA,76,82,6,12,1829,1,0
2673,ACGTCGAATCTAGGGA,76,82,6,12,1834,1,0
2683,ACGTCGCATCTAGGGA,77,82,5,7,437,1,0
2707,ACGTCGACTCTAGGGA,77,82,5,10,804,1,0
2717,ACGTCGAATCTAGGGA,77,82,5,10,1039,1,0
2720,ACGTCGAATCTCGGGA,77,82,5,10,1049,1,0
2733,ACGTCGACTCTAGGGA,77,82,5,13,1086,1,0
2744,ACGTCGAATCTAGGGA,77,82,5,10,1117,1,0
2770,ACGTCGAATCTAGGGA,77,82,5,10,1413,1,0
2784,ACGTCGAATCAAGGGA,77,82,5,10,1438,1,0
2785,ACGTCGAATCTAGGGA,77,82,5,10,1439,1,0
2795,ACGGCGAATCTAGGGA,77,82,5,10,1461,1,0
2803,ACATCGAATCAAGGGA,77,82,5,10,1480,1,0
2819,ACGTCGAATCTCGGGG,77,82,5,10,1846,1,0
2825,ACGTCGAATCTAGGGA,77,82,5,10,1857,1,0
2834,ACGTCGAATCTAGGGA,77,82,5,10,1870,1,0
2847,ACGTCGAATCTAGGGA,77,82,5,10,1886,1,0
2875,ACGTCGAATCTAGGGA,77,82,5,10,1922,1,0
2883,GCGTCGAATCTAGGGA,77,82,5,13,1934,1,0
2902,ACGTCGAATCTAGGGA,77,82,5,13,1957,1,0
2931,ACGTCGAATCTAGGGA,77,82,5,13,1999,1,0
2970,ACGTCGAATCTAGGGA,78,82,4,11,881,0,0
2983,ACGTCGAATCTAGGGA,78,82,4,11,925,0,0
2984,ACATCGACTCTAGGGA,78,82,4,11,932,0,0
2998,ACGTCGAATCTCGGGA,78,82,4,11,1170,0,0
3006,ACGTCGAATCTAGGGA,78,82,4,11,1187,0,0
3027,ACGTCGAATCTAGGGA,78,82,4,14,1234,0,0
3078,ACGTCGAATCTAGGGA,78,82,4,11,1591,0,0
3095,ACGTCGACTCTAGGGA,78,82,4,11,1621,0,0
3109,ACGTCGAATCAAGGGA,78,82,4,11,1652,0,0
3129,TCGTCGAATCTAGGGA,78,82,4,11,2038,0,0
3132,ACGTCGGATCTAGGGA,78,82,4,8,2043,0,0
3137,ACGTCGAATCTAGGGA,78,82,4,11,2048,0,0
3139,ACGTCGAATCTAGGGA,78,82,4,11,2050,0,0
3145,ACGTCGAATCTAGGGA,78,82,4,11,2057,0,0
3150,ACGTCGAATCTAGGGA,78,82,4,14,2066,0,0
3153,ACGTCGACTCTAGGGA,78,82,4,11,2071,0,0
3156,ACGTCGACTCTAGGGA,78,82,4,11,2075,0,0
3161,ACGTCGAATCTAGGGA,78,82,4,11,2083,0,0
3172,ACGTCGACTCTAGGGA,78,82,4,11,2105,0,0
3193,ACGTCGACTATAGGGA,78,82,4,14,2140,0,0
3198,ACGTCGAATCTAGGGA,78,82,4,11,2147,0,0
3221,ACGTCGAATCTGGGGA,78,82,4,11,2189,0,0
3222,ACGTCGAATCAAGGGA,78,82,4,11,2190,0,0
3223,ACGTCGAATCTAGGGA,78,82,4,11,2191,0,0
3235,ACGTCGGATCTAGGGA,79,82,3,9,408,0,0
3247,ACGTCGAATCAAGGGA,79,82,3,6,706,0,0
3248,ACGTCGAATCTAGGGA,79,82,3,9,715,0,0
3295,ACATCGGATCTAGGGA,79,82,3,9,1308,0,0
3306,ACGTCGACTCTAGGGA,79,82,3,9,1326,0,0
3331,ACGTCGAATCTAGGGA,79,82,3,9,1690,0,0
3337,ACGTCGAATCTAGGGA,79,82,3,9,1696,0,0
3355,ACGTCGAATCTAAGGA,79,82,3,9,1731,0,0
3357,ACGTCGAATCTAGGGA,79,82,3,12,1735,0,0
3361,ACGTCGAATCTAGGGA,79,82,3,9,1754,0,0
3364,ACGTCGAATCTAGGGA,79,82,3,12,1761,0,0
3380,ACGTCGAATCTAGGGA,79,82,3,9,1798,0,0
3414,ACGTCGAATCTAGGGA,79,82,3,9,2225,0,0
3423,ACGTCGAATCAAGGGA,79,82,3,12,2237,0,0
3427,ACGTCGAATCTAGGGA,79,82,3,12,2244,0,0
3450,ACGTCGAATCTAGGGA,79,82,3,12,2278,0,0
3457,ACGTCGAATCTAGGGA,79,82,3,12,2291,0,0
3460,ACGTCGAATCTAGGGA,79,82,3,12,2294,0,0
3466,ACGTCGACTCTAGGGA,79,82,3,12,2305,0,0
3475,ACGTCGACTCTAGGGA,79,82,3,12,2316,0,0
3496,ACGTCGGATCTAGGGA,79,82,3,12,2354,0,0
3513,ACGTCGACTCTAGGGA,79,82,3,12,2377,0,0
3550,ACGTCGAATCAAGGGA,79,82,3,12,2430,0,0
3555,ACGTCGAATCTAGGGA,79,82,3,12,2436,0,0
3559,ACGTCGAATCTAGGGA,80,82,2,7,125,0,0
3574,ACGTCGACTCTAGGGA,80,82,2,10,634,0,0
3583,ACGTCGAATCTAGGGA,80,82,2,10,830,0,0
3589,ACGTCGACTCTAGGGA,80,82,2,10,1055,0,0
3590,ACGTCGAATCTAGGGA,80,82,2,10,1059,0,0
3593,ACGTCGAATCTAGGGA,80,82,2,10,1066,0,0
3599,ACGTCGAATCTAGGGA,80,82,2,10,1105,0,0
3611,ACGTCGACTCTAGGGA,80,82,2,7,1376,0,0
3619,ACGTCGACTCTAGGGA,80,82,2,10,1396,0,0
3633,ACGTCGACTCTAGGGA,80,82,2,13,1436,0,0
3639,ACGTCGAATCTAGGGA,80,82,2,13,1453,0,0
3643,ACATCGAATCAAGGGA,80,82,2,10,1480,0,0
3652,ACGTCCAATCTAGGGA,80,82,2,10,1842,0,0
3665,ACGTCGACTCTAGGGA,80,82,2,10,1865,0,0
3686,ACGTCGACTCTAGGGA,80,82,2,10,1900,0,0
3688,ACGTCGAATCAAGGGA,80,82,2,10,1903,0,0
3697,ACGTCGAATCTAGGGA,80,82,2,10,1917,0,0
3710,ACGCCGACTCTAGGGA,80,82,2,10,1942,0,0
3725,ACTTCGACTCTAGGGA,80,82,2,13,1962,0,0
3733,ACGTCGAATCAAGGGA,80,82,2,10,1978,0,0
3743,ACGTCGAATCTAGGGA,80,82,2,13,1993,0,0
3747,ACGTCGAATCTAGGGA,80,82,2,13,2000,0,0
3791,ACGTCGAATCTAGGGA,80,82,2,13,2486,0,0
3799,ACGTGGAATCTAGGGA,80,82,2,13,2496,0,0
3804,ACGCCGACTCTAGGGA,80,82,2,10,2508,0,0
3822,ACGTCGAATCTAGGCA,80,82,2,13,2531,0,0
3830,ACGTCGAATCTAGGGA,80,82,2,10,2545,0,0
3836,ACGTCGAATCTAGGGA,80,82,2,13,2554,0,0
3848,ACGTCGACTCTAGGGA,80,82,2,10,2573,0,0
3856,ACGTCGAATCTAGGGA,80,82,2,13,2594,0,0
3858,ACGTCGACTCTAGGGA,80,82,2,10,2596,0,0
3865,ACGTCGAATCTAGGGA,80,82,2,13,2608,0,0
3866,ACGTCGAATCTAGGGA,80,82,2,13,2609,0,0
3868,ACCTCGACTCTAGGGA,80,82,2,13,2612,0,0
3876,ACGTCGACTCTAGGGA,80,82,2,13,2626,0,0
3877,ACGTCGAATCTAGGGA,80,82,2,13,2627,0,0
3888,ACGTCGAATCAAGGGA,80,82,2,10,2648,0,0
3896,TCGTCGAATCTAGGGA,80,82,2,16,2664,0,0
3900,ACGTCGAATCTAGGGA,80,82,2,13,2672,0,0
3905,ACGTCGACTCTAGGGA,81,82,1,11,281,0,0
3919,ACGTCGAATCTAGGGA,81,82,1,8,871,0,0
3932,ACGTCGAATCTAGGGA,81,82,1,11,914,0,0
3936,ACGTCGACTCTAGGGA,81,82,1,11,1143,0,0
3940,ACGTCGAATCTAGGGA,81,82,1,11,1149,0,0
3943,ACGTCGACTCTAGGGA,81,82,1,11,1162,0,0
3944,ACGTCGAATCTAGGGA,81,82,1,11,1167,0,0
3955,ACGTCGAATCTAGGGA,81,82,1,11,1197,0,0
3982,ACGTCGAATCTAGGGA,81,82,1,11,1537,0,0
3998,ACGTCGAATCTAGGGA,81,82,1,11,1591,0,0
4034,ACGTCGACTCTAGGGA,81,82,1,11,2047,0,0
4039,ACGACGACTCTAGGGA,81,82,1,11,2053,0,0
4040,ACGTCGAATCTAGGGA,81,82,1,11,2055,0,0
4042,ACGTCGAATCTAGGGA,81,82,1,11,2057,0,0
4051,ACGTCGACTCTAGGGA,81,82,1,11,2074,0,0
4056,AAGTCGAATCTAGTGA,81,82,1,11,2095,0,0
4069,ACGTCGAATCTAGGGA,81,82,1,11,2122,0,0
4078,ACGTCGAGTCTAGGGA,81,82,1,11,2138,0,0
4099,ACGTCGAATCTGGGGA,81,82,1,11,2189,0,0
4100,ACGTCGAATCAAGGGA,81,82,1,11,2190,0,0
4115,ACGTCGAATCTAGGGA,81,82,1,11,2693,0,0
4125,ACGTCGACTCTAGGGA,81,82,1,11,2707,0,0
4132,ACGTCGAATCTAGGGA,81,82,1,11,2715,0,0
4135,ACGTCGAATCAAGGGA,81,82,1,8,2718,0,0
4142,ACGTCGAATCTAGGGA,81,82,1,11,2727,0,0
4153,ACGTCGACTCTAGGGA,81,82,1,11,2747,0,0
4169,ACGTCGAATCTAGGGA,81,82,1,11,2779,0,0
4173,ACGTCGAATCTAGGGA,81,82,1,11,2785,0,0
4178,ACGTCGAATCTAGGGA,81,82,1,14,2791,0,0
4202,ACGTCGAATCTAGGGA,81,82,1,11,2821,0,0
4240,ACGTCGAATCTAGGGA,81,82,1,11,2875,0,0
4274,ACGTCGAATCTAGGGA,81,82,1,14,2927,0,0
125,ACGTCGAATCTAGGGA,46,83,37,6,42,11,0
390,ACGTCGACTCTAGGGA,57,83,26,8,137,8,0
512,ACGTCGAATCTAGGGA,59,83,24,10,330,7,0
598,ACGTCGAATCTAGGGA,61,83,22,9,287,6,0
678,ACGTCGCATCTAGGGA,62,83,21,7,437,6,0
742,ACGTCGACTCTAGGGA,63,83,20,11,367,6,0
885,ACGTCGACTCTAGGGA,65,83,18,7,429,5,0
932,ACGTCGACTCTAGGGA,65,83,18,10,618,5,0
1024,ACATCGGATCTAGGGA,66,83,17,8,683,5,0
1074,ACGTCGGATCTAGGGA,67,83,16,9,541,4,0
1134,ACGTCGAATCTAGGGA,67,83,16,9,769,4,0
1146,ACGTCGAATCTAGGGA,68,83,15,10,243,4,0
1148,ACGTCGAATCTAGGGA,68,83,15,7,318,4,0
1179,ACGTCGAATCTAGGGA,68,83,15,10,589,4,0
1197,ACGTCGAATCTAGGGA,68,83,15,10,626,4,0
1201,ACGTCGAATCTAGGGA,68,83,15,10,638,4,0
1202,ACGTCGACTCTAGGGA,68,83,15,10,642,4,0
1241,ACGTCGACTCTAGGGA,68,83,15,10,832,4,0
1370,ACGTCGAATCTAGGGA,69,83,14,11,939,4,0
1405,ACGTCGACTCTAGGGA,70,83,13,9,545,3,0
1411,ACGTCGACTCTAGGGA,70,83,13,9,557,3,0
1510,ACGTCGACTCTAGGGA,70,83,13,12,1031,3,0
1576,ACGTCGAATCTAGGGA,71,83,12,10,807,3,0
1696,ACGTCGAATCTAGGGA,72,83,11,8,679,3,0
1754,ACGTCGAATCTAGGGA,72,83,11,8,1147,3,0
1757,ACGTCGAATCTAGGGA,72,83,11,11,1150,3,0
1770,GCGTCGAATCTAGGGA,72,83,11,11,1168,3,0
1784,ACGTCGAATCTAGGGA,72,83,11,11,1187,3,0
1799,ACGTCGAATCTAGGGA,72,83,11,11,1207,3,0
1804,ACGTCGAATCAAGGGA,72,83,11,8,1212,3,0
1840,ACGTCGAATCTAGGGA,72,83,11,14,1259,3,0
1860,ACGTCGACTCTAGGGA,73,83,10,9,534,2,0
1881,ACGTCGAATCTAGGGA,73,83,10,9,731,2,0
1890,ACGTCGACTCTAGGGA,73,83,10,9,753,2,0
1903,ACGTCGAATCAAGGGA,73,83,10,9,965,2,0
1917,ACGTCGAATCTAGGGA,73,83,10,9,999,2,0
1945,ACGTCGAATCTAGGGA,73,83,10,9,1277,2,0
1952,ACGTCGACTCTAGGGA,73,83,10,9,1286,2,0
1993,ACGTCGAATCTAGGGA,73,83,10,12,1343,2,0
2095,ACGTCGAATCTAGTGA,74,83,9,10,1108,2,0
2125,ACGTCGACTCTAGGGA,74,83,9,10,1397,2,0
2155,ACGTCGAATCAAGGGA,74,83,9,10,1438,2,0
2162,ACGTCGAATCTAGGGA,74,83,9,10,1447,2,0
2191,ACGTCGAATCTAGGGA,74,83,9,10,1496,2,0
2204,ACGTCGAATCAAGGGA,75,83,8,5,102,2,0
2211,ACGTCGACTCTAGGGA,75,83,8,11,281,2,0
2246,ACGTCGAATCTAGGGA,75,83,8,11,883,2,0
2252,ACGTCGAATCTAGGGA,75,83,8,11,898,2,0
2335,ACGTCGAATCTAGGGA,75,83,8,11,1248,2,0
2360,ACGTCGAATCTAGGGA,75,83,8,11,1537,2,0
2363,ACGTCGAATCTAGGGA,75,83,8,8,1541,2,0
2385,ACGTCGACTCTAGGGA,75,83,8,11,1573,2,0
2396,ACGTCGAATCTAGGGA,75,83,8,11,1591,2,0
2399,ACGTCGAATCTAGGGA,75,83,8,14,1595,2,0
2469,ACGTCGACTCTAGGGA,76,83,7,12,742,1,0
2471,ACGTCGAATCAAGGGA,76,83,7,9,752,1,0
2485,ACGTCGACTCTAGGGA,76,83,7,12,979,1,0
2508,ACGCCGACTCTAGGGA,76,83,7,9,1271,1,0
2584,ACGTCGAATCAAGGGA,76,83,7,9,1702,1,0
2614,GCGTCGAATCTAGGGA,76,83,7,12,1745,1,0
2615,ACGTCGAATCCAGGGA,76,83,7,12,1746,1,0
2640,ACGTCGAATCTAGGGA,76,83,7,12,1788,1,0
2641,ACGTCGACTCTAGGGA,76,83,7,12,1789,1,0
2664,ACGTCGAATCTAGGGA,76,83,7,15,1822,1,0
2665,ACGTCGACTCTAGGGA,76,83,7,12,1823,1,0
2715,ACGTCGAATCTAGGGA,77,83,6,10,858,1,0
2718,ACGTCGAATCAAGGGA,77,83,6,7,1042,1,0
2721,ACGTCGACTCTAGGGA,77,83,6,10,1055,1,0
2745,ACGTCGAATCAAGGGA,77,83,6,10,1119,1,0
2783,ACGTCGACTCTAGGGA,77,83,6,13,1436,1,0
2805,ACGTCGAATCTAGGGA,77,83,6,10,1487,1,0
2818,ACGTCGACTCTAGGGA,77,83,6,10,1845,1,0
2840,ACGTCGAATCTAGGGA,77,83,6,10,1877,1,0
2845,ACGTCGAATCTAGGGA,77,83,6,10,1883,1,0
2872,ACGTCGAATCTAGGGA,77,83,6,13,1918,1,0
2880,AGGTCGAATCTAGGGA,77,83,6,13,1930,1,0
2906,ACTTCGACTCTAGGGA,77,83,6,13,1962,1,0
2943,ACGTCGAATCTAGGGA,78,83,5,8,258,1,0
2949,ACGTCGAATCTAGGGA,78,83,5,11,381,1,0
2956,ACGTCGAATCTAGGGA,78,83,5,8,675,1,0
2963,ACGTCGAATCTAGGGA,78,83,5,11,699,1,0
2974,ACGTCGAATCTAGGGA,78,83,5,8,894,1,0
2977,ACGTCGAATCTCGGGA,78,83,5,11,906,1,0
3004,ACGTGGACTCTAGGGA,78,83,5,11,1180,1,0
3022,ACGTCGAATCTAGGGA,78,83,5,11,1225,1,0
3026,ACGTCGAATCTAGGGA,78,83,5,11,1233,1,0
3085,ACGTCGACTCTAGGGA,78,83,5,11,1601,1,0
3090,ACGTCGGATCTAGGGA,78,83,5,11,1611,1,0
3123,ACGTCGAATCTAGGGA,78,83,5,11,2027,1,0
3127,ACGTCGAATCTAGGGA,78,83,5,11,2036,1,0
3154,ACGTCGAATCTCGGGA,78,83,5,11,2073,1,0
3160,ACGTCGAATCTAGGGA,78,83,5,11,2082,1,0
3173,ACGTCGACTCTAGGGA,78,83,5,11,2106,1,0
3191,ACGTCGACTCTAGGGA,78,83,5,14,2137,1,0
3200,ACGTCGAATCTAGGGA,78,83,5,11,2151,1,0
3259,ACGTCGAATCTAGGGA,79,83,4,9,774,0,0
3263,ACGTCGAATCTAGGGA,79,83,4,9,970,0,0
3273,ACGTCGAATCTAGGGA,79,83,4,12,1000,0,0
3277,ACATCGGATCTAGGGA,79,83,4,9,1024,0,0
3280,ACGTCGAATCAAGGGA,79,83,4,6,1260,0,0
3294,ACGTCGACTCTAGGGA,79,83,4,9,1299,0,0
3320,ACGTCGAATCTAGGGA,79,83,4,12,1370,0,0
3335,ACGTCGAATCTAGGGA,79,83,4,9,1694,0,0
3340,ACGTCGAATCAAGGGA,79,83,4,9,1702,0,0
3352,ACGTCGAATCTAGGGA,79,83,4,12,1724,0,0
3354,ACGTCGAATCTAGGGA,79,83,4,12,1727,0,0
3369,ACGTCGAATCTAGGGA,79,83,4,12,1771,0,0
3371,ACGTCGACTCTAGGGA,79,83,4,12,1781,0,0
3373,ACGTCGAATCTAGGTA,79,83,4,12,1783,0,0
3375,ACGTCGAATCTAGGGA,79,83,4,12,1788,0,0
3379,ACGTCGAATCTAGGGA,79,83,4,12,1796,0,0
3389,ACGTCGACTCTAGGGA,79,83,4,12,1813,0,0
3421,ACGTCGACTCTAGGGA,79,83,4,12,2234,0,0
3435,ACGTCGACTCTAGGGA,79,83,4,12,2254,0,0
3436,ACGTCGAATCTCGGGA,79,83,4,12,2255,0,0
3455,ACGTCGAATCTAGGGA,79,83,4,9,2286,0,0
3458,ACGTGGACTCTAGGGA,79,83,4,12,2292,0,0
3468,ACGTCGACTCTAGGGA,79,83,4,9,2307,0,0
3474,ACGTCGAATCTAGGGA,79,83,4,12,2315,0,0
3478,ACGTCGAATCTAGGGA,79,83,4,12,2321,0,0
3515,ACGTGGACTCTAGGGA,79,83,4,12,2380,0,0
3545,ACGTCGAATCTAGTGA,79,83,4,12,2425,0,0
3546,ACGTCGAATCTAGGGA,79,83,4,12,2426,0,0
3577,ACGTCGAATCTAGGGA,80,83,3,10,789,0,0
3579,ACGTCGAATCTAGGTA,80,83,3,10,791,0,0
3613,ACGTCGAATCTAGGGA,80,83,3,10,1381,0,0
3615,ACGTCGACTCTAGGGA,80,83,3,10,1383,0,0
3620,ACGTCGAATCTAGGGA,80,83,3,10,1400,0,0
3631,ACGTCGACTCTAGGGA,80,83,3,13,1430,0,0
3635,ACGTCGAATCTAGGGA,80,83,3,10,1439,0,0
3644,ACGTCGAATCTAGGGA,80,83,3,10,1487,0,0
3658,ACGTCGACTCTAGGGA,80,83,3,10,1852,0,0
3661,ACGTCGAATCTAGGGA,80,83,3,10,1857,0,0
3692,ACGTCGACTCTAGGGA,80,83,3,13,1909,0,0
3703,ACGTCGAATCAAGGGA,80,83,3,10,1931,0,0
3715,ACGTCGAATCTAGGGA,80,83,3,10,1950,0,0
3717,ACGTCGACTCTAGGGA,80,83,3,10,1952,0,0
3720,ACGTCGACTCTAGGGA,80,83,3,10,1956,0,0
3727,ACGTCGAATCTAGGGA,80,83,3,10,1966,0,0
3760,ACGTCGAATCTAGGGA,80,83,3,10,2446,0,0
3770,ACGTCGACTCTAGGGA,80,83,3,10,2457,0,0
3778,ACGTCGACTCTAGGGA,80,83,3,13,2469,0,0
3786,ACGTCGAATCTAGGGA,80,83,3,10,2480,0,0
3787,ACGTCGAATCTAGGGA,80,83,3,10,2481,0,0
3792,ACGTCGAATCTAGGGA,80,83,3,10,2487,0,0
3806,ACGTCGAATCTAGGGA,80,83,3,10,2511,0,0
3811,ACGTCGAATCTAGGGA,80,83,3,13,2518,0,0
3826,ACGTCGACTCTAGGGA,80,83,3,10,2539,0,0
3862,ACGTCGACTCTAGGGA,80,83,3,13,2603,0,0
3867,ACGTCGAATCTAGGGA,80,83,3,13,2611,0,0
3881,ACGTCGACTCTAGGGA,80,83,3,13,2635,0,0
3908,ACGTCGAATCTAGGGA,81,83,2,8,491,0,0
3911,ACGTCGAATCTAGGGA,81,83,2,8,661,0,0
3930,AAGTCGGATCTAGGGA,81,83,2,8,911,0,0
3948,ACGTCGAATCTAGGGA,81,83,2,11,1176,0,0
3961,ACGTCGAATCAAGGGA,81,83,2,8,1212,0,0
3963,ACGTCGACTCTAGGGA,81,83,2,11,1223,0,0
3970,ACGTCGACTCTAGGGA,81,83,2,11,1245,0,0
3984,AAGTCGGATCTAGGGA,81,83,2,8,1542,0,0
4067,ACGTCGACTCTAGGGA,81,83,2,11,2117,0,0
4068,ACGTCGAATCTAGGGA,81,83,2,11,2120,0,0
4073,ACGTCGGATCTAGGGA,81,83,2,11,2129,0,0
4075,ACGTCGCATCTAGGGA,81,83,2,11,2132,0,0
4097,ACGTCGAATCTAGGGA,81,83,2,11,2186,0,0
4116,TCGTCGAATCTAGGGA,81,83,2,11,2694,0,0
4138,ACGTCGACTCTAGGGA,81,83,2,11,2721,0,0
4147,ACGGCGAATCTAGGGA,81,83,2,11,2734,0,0
4151,ACGTCGAATCTAGGGA,81,83,2,11,2744,0,0
4176,ACGTCGAATCTAGGGA,81,83,2,11,2788,0,0
4181,ACGTCGAATCTAGGGA,81,83,2,11,2796,0,0
4191,ACGTCGAATCAAGGGA,81,83,2,11,2808,0,0
4225,ACGTCGAATCTAGGGA,81,83,2,11,2856,0,0
4229,ACGTCGAATCTAGGGA,81,83,2,11,2861,0,0
4236,ACGTCGAATCTAGGGA,81,83,2,11,2871,0,0
4242,ACGTCGAATCTAGGGA,81,83,2,14,2877,0,0
4250,AGGTCGGATCTAGGGA,81,83,2,11,2888,0,0
4269,ACGTCGAATCTAGGGA,81,83,2,11,2919,0,0
4270,ACGTCGAATCTAGGGA,81,83,2,11,2921,0,0
4275,GCGTCGAATCTAGGGA,81,83,2,14,2928,0,0
4278,ACGTCGGATCTAGGGA,81,83,2,14,2934,0,0
4279,GCGTCGAATCTAGGGA,81,83,2,14,2938,0,0
4282,ACGTCGAATCTCGGGA,82,83,1,9,313,0,0
4287,ACGTCGACTCTAGGGA,82,83,1,9,522,0,0
4288,ACGTCGAATCTAGGGA,82,83,1,9,533,0,0
4296,ACGTCGAATCTAGGGA,82,83,1,9,735,0,0
4301,ACGTCGAATCAAGGGA,82,83,1,9,759,0,0
4303,ACGTCGAATCTAGGGA,82,83,1,9,774,0,0
4311,ACGTCGAATCTAGGGA,82,83,1,12,1000,0,0
4315,ACGTCGAATCAAGGGA,82,83,1,9,1030,0,0
4317,ACGTCGAATCTAGGGA,82,83,1,9,1265,0,0
4322,ACGTCGAATCTAGGGA,82,83,1,12,1285,0,0
4329,ACGTCGAATCTAGGGA,82,83,1,12,1309,0,0
4332,ACGTCGACTCTAGGGA,82,83,1,12,1314,0,0
4343,ACGTCGAATCTAGGGA,82,83,1,12,1370,0,0
4358,ACGTCGAATCAAGGGA,82,83,1,9,1702,0,0
4361,ACGTCGACTCTAGGGA,82,83,1,9,1718,0,0
4366,ACGTCGACTCTAGGGA,82,83,1,12,1725,0,0
4419,ACGTCGAATCTAGGGA,82,83,1,12,2244,0,0
4422,ACGTCGAATCTAAGGA,82,83,1,12,2248,0,0
4427,AAGTCGGATCTAGGGA,82,83,1,9,2256,0,0
4428,ACGTCGAATCTAGGGA,82,83,1,12,2257,0,0
4429,ACGTCGAATCTAGGGA,82,83,1,12,2258,0,0
4447,ACGTCGAATCTAGGGA,82,83,1,12,2310,0,0
4462,ACGTCGAATCTAGGGA,82,83,1,12,2355,0,0
4468,ACGTCGGATCTAGGGA,82,83,1,12,2362,0,0
4532,ACGTCGACCCTAGGGA,82,83,1,12,2976,0,0
4536,ACGTCGACTCTAGGGA,82,83,1,12,2986,0,0
4547,TCGTCGAATCTAGGGA,82,83,1,9,2999,0,0
4550,ACGTGGACTCTAGGGA,82,83,1,12,3004,0,0
4551,ACGTCGACTCTAGGGA,82,83,1,12,3005,0,0
4555,ACGTCGAATCTAGGGA,82,83,1,12,3011,0,0
4560,ACGTCGAATCTAGGGA,82,83,1,12,3020,0,0
4562,ACGTCGAATCTAGGGA,82,83,1,12,3022,0,0
4564,ACGTCGAATCTAGGGA,82,83,1,12,3025,0,0
4577,ACGTCGAATCAAGGGA,82,83,1,9,3044,0,0
4603,ACGTCGAATCTAGGGA,82,83,1,12,3082,0,0
4615,ACGTCGAATCTAGGGA,82,83,1,12,3102,0,0
4639,ACGTCGGATCTAGGGA,82,83,1,12,3141,0,0
4642,ACGTCGAATCTAGGGA,82,83,1,12,3148,0,0
4672,ACGTCGAATCTAGGGA,82,83,1,12,3203,0,0
313,ACGTCGAATCTCGGGA,54,84,30,8,201,9,0
693,ACGTCGAGTCTAGGGA,62,84,22,10,456,6,0
738,ACGTCGAATCTAGGGA,63,84,21,8,361,6,0
774,ACGTCGAATCTAGGGA,63,84,21,8,516,6,0
791,ACGTCGAATCTAGGGA,64,84,20,9,287,6,0
901,ACGTCGACTCTAGGGA,65,84,19,10,466,5,0
979,ACGTCGACTCTAGGGA,66,84,18,11,367,5,0
1016,ACGTCGAATCTAGGGA,66,84,18,11,673,5,0
1162,ACGTCGACTCTAGGGA,68,84,16,10,455,4,0
1212,ACGTCGAATCAAGGGA,68,84,16,7,787,4,0
1234,ACGTCGAATCTAGGGA,68,84,16,13,821,4,0
1295,ACGTCGAATCTAGGGA,69,84,15,8,649,4,0
1313,ACGTCGAATCAAGGGA,69,84,15,8,697,4,0
1401,ACGTCGAATCTAGGGA,70,84,14,9,533,4,0
1407,ACGTCGACTCTAGGGA,70,84,14,9,547,4,0
1436,ACGTCGACTCTAGGGA,70,84,14,12,742,4,0
1505,ACGTCGAATCTAGGGA,70,84,14,9,1026,4,0
1638,ACGTCGAATCTAGTGA,71,84,13,10,1108,3,0
1651,ACGTCGAATCTAGGCA,71,84,13,10,1127,3,0
1743,ACGTCGAATCTAGGGA,72,84,12,11,935,3,0
1782,ACGTCGAATCTAGGGA,72,84,12,11,1185,3,0
1801,ACGTCGAATCTAGGGA,72,84,12,11,1209,3,0
1824,ACGTCGAATCTAGGGA,72,84,12,11,1237,3,0
1874,ACGTCGACTCTAGGGA,73,84,11,9,707,2,0
1884,ACGTCGACTCTAGGGA,73,84,11,9,737,2,0
1887,ACGTCGACTCTAGGGA,73,84,11,12,742,2,0
1912,ACGTCGAATCTAGGGA,73,84,11,12,985,2,0
1925,ACGTCGAATCTAGGGA,73,84,11,12,1021,2,0
1931,ACGTCGAATCAAGGGA,73,84,11,9,1030,2,0
1946,ACGTCGAATCTAGGGA,73,84,11,9,1278,2,0
1955,ACGTCGACTCTAGGGA,73,84,11,12,1289,2,0
1968,ACATCGGATCTAGGGA,73,84,11,9,1308,2,0
1994,GCGTCGAATCTAGGGA,73,84,11,12,1346,2,0
2063,ACGTCGAATCTAGGGA,74,84,10,10,847,2,0
2079,ACGTCGACTCTAGGGA,74,84,10,10,1065,2,0
2214,ACGTCGAATCTAGGGA,75,84,9,8,361,2,0
2216,ACGTCGAATCTAGGGA,75,84,9,11,369,2,0
2234,ACGTCGACTCTAGGGA,75,84,9,11,698,2,0
2236,ACGTCGAATCCAGGGA,75,84,9,11,702,2,0
2247,ACGTCGACTCTAGGGA,75,84,9,8,885,2,0
2260,ACGTCGAATCTAGGGA,75,84,9,11,918,2,0
2305,ACGTCGACTCTAGGGA,75,84,9,11,1202,2,0
2321,ACGTCGAATCTAGGGA,75,84,9,11,1227,2,0
2384,ACGTCGAATCTAGGGA,75,84,9,11,1572,2,0
2405,ACGTCGAATCTCGGGA,75,84,9,11,1604,2,0
2420,ACGTCGAATCTAGGGA,75,84,9,11,1629,2,0
2442,ACGTCGACTCTAGGGA,76,84,8,9,302,1,0
2507,ACGTCGAATCTAGGGA,76,84,8,9,1269,1,0
2528,ACGTCGAGTCTAGGGA,76,84,8,12,1312,1,0
2530,ACGTCGACTCTAGGGA,76,84,8,12,1314,1,0
2549,ACGTCGAATCTAGGGA,76,84,8,12,1361,1,0
2573,ACGTCGACTCTAGGGA,76,84,8,9,1686,1,0
2582,ACGTCGAATCTAGGGA,76,84,8,12,1697,1,0
2620,ACGTCGAATCTAGGGA,76,84,8,12,1756,1,0
2655,ACGTCGAATCTCGGGA,76,84,8,12,1811,1,0
2699,ACGTCGAATCTAGGGA,77,84,7,10,637,1,0
2701,ACGTCGAATCTAGGGA,77,84,7,10,789,1,0
2716,ACGTCGACTCTAGGGA,77,84,7,7,1037,1,0
2722,ACGTCGAATCTAGGGA,77,84,7,10,1059,1,0
2724,ACGTCGAATCTAGGGA,77,84,7,13,1063,1,0
2732,ACGTCGAATCTAGGGA,77,84,7,10,1084,1,0
2757,ACGTCGACTCTAGGGA,77,84,7,10,1383,1,0
2764,ACGTCGAATCTAGGGA,77,84,7,10,1401,1,0
2808,ACGTCGAATCAAGGGA,77,84,7,10,1495,1,0
2826,ACGTCGAATCTAGGGA,77,84,7,10,1858,1,0
2837,ACGTCGACTCTAGGGA,77,84,7,10,1874,1,0
2861,ACGTCGAATCTAGGGA,77,84,7,10,1904,1,0
2868,ACATCGAATCAAGGGA,77,84,7,10,1914,1,0
2869,ACGTCGAATCAAGGGA,77,84,7,10,1915,1,0
2891,ACGTCGAATCTAGGGA,77,84,7,10,1945,1,0
2892,ACGTCGAATCTAGGGA,77,84,7,10,1946,1,0
2912,ACGTCGAATCTAGGGA,77,84,7,13,1969,1,0
2914,ACGTCGGATCTAGGGA,77,84,7,10,1977,1,0
2919,ACGTCGAATCTAGGGA,77,84,7,10,1982,1,0
2928,GCGTCGAATCTAGGGA,77,84,7,13,1994,1,0
2968,ACGTCGAATCTAGGGA,78,84,6,8,879,1,0
2992,ACGTCGAATCTAGGGA,78,84,6,11,1157,1,0
3020,ACGTCGAATCTAGGGA,78,84,6,11,1217,1,0
3029,ACGTCGAATCTAGGGA,78,84,6,11,1239,1,0
3045,ACGTCGAATCTAGGGA,78,84,6,11,1525,1,0
3076,ACGTCGAATCTAGGGA,78,84,6,11,1586,1,0
3088,ACGTAGGATCTAGGGA,78,84,6,11,1605,1,0
3097,ACGTCGAATCTAGGGA,78,84,6,11,1624,1,0
3100,ACGTCGAATCTAGGGA,78,84,6,11,1634,1,0
3113,ACGTCGGATCTAGGGA,78,84,6,8,2011,1,0
3158,ACGTCGAATCTAGGGA,78,84,6,14,2078,1,0
3170,ACGGCGAATCTAGGGA,78,84,6,11,2101,1,0
3182,ACGTCGAATCTAGGGA,78,84,6,11,2122,1,0
3206,ACGTCGAATCAAGGGA,78,84,6,11,2161,1,0
3210,ACGGCGAATCTAGGGA,78,84,6,11,2170,1,0
3212,ACGTCGAATCTAGGGA,78,84,6,11,2173,1,0
3219,ACGTCGAATCTAGGGA,78,84,6,11,2186,1,0
3242,ACGTCGAATCTAGGGA,79,84,5,9,546,0,0
3243,ACGTCGACTCTAGGGA,79,84,5,9,547,0,0
3246,ACGTCGACTCTAGGGA,79,84,5,12,568,0,0
3264,ACGTCGAATCTAGGGA,79,84,5,9,976,0,0
3281,ACGTCGAATCTAGGGA,79,84,5,9,1265,0,0
3290,ACGTCGAATCTAGGGA,79,84,5,12,1292,0,0
3317,ACGTCGAATCTAGGGA,79,84,5,12,1367,0,0
3326,ACGTCGACTCTAGGGA,79,84,5,9,1682,0,0
3327,ACGTCGAATCTAGGGA,79,84,5,9,1683,0,0
3330,ACGTCGAATCAAGGGA,79,84,5,9,1689,0,0
3349,ACGTCAAATCTAAGGA,79,84,5,12,1719,0,0
3370,ACGTCGAATCTCGGGA,79,84,5,12,1772,0,0
3374,ACGTCGAATCTAGGGA,79,84,5,12,1784,0,0
3432,ACGTCGAATCTAGGGA,79,84,5,12,2250,0,0
3462,TCGTCGAATCTAGGGA,79,84,5,12,2296,0,0
3465,ACGTCGAATCTAGGGA,79,84,5,12,2302,0,0
3481,ACGTCGAATCTAGGGA,79,84,5,15,2326,0,0
3493,ACGTCGAATCTAGGGA,79,84,5,12,2350,0,0
3503,ACGTCGGATCTAGGGA,79,84,5,12,2362,0,0
3518,ACGTCGGATCTAGGGA,79,84,5,12,2386,0,0
3523,ACGTCGACTCTAGGGA,79,84,5,12,2394,0,0
3528,ACGTCGAATCTAGGGA,79,84,5,15,2399,0,0
3539,ACGTCGAATCAAGGGA,79,84,5,12,2417,0,0
3540,ACGTCGACTCTAGGGA,79,84,5,15,2419,0,0
3561,ACGTCGAATCTAGGGA,80,84,4,10,342,0,0
3567,ACGTCGAATCTAGGGA,80,84,4,10,463,0,0
3587,ACGTCGAATCTAGGGA,80,84,4,10,1039,0,0
3597,ACGTCGAATCTAGGGA,80,84,4,10,1087,0,0
3612,ACGTCGAATCAAGGGA,80,84,4,7,1379,0,0
3629,ACGTCGAATCTAGGGA,80,84,4,13,1418,0,0
3642,ACGTCGAATCTAGGGA,80,84,4,10,1463,0,0
3647,ACGTCGAATCTAGGGA,80,84,4,13,1504,0,0
3670,ACGTCGACTCTAGGGA,80,84,4,10,1874,0,0
3676,ACGTCGACTCTAGGGA,80,84,4,10,1884,0,0
3694,ACGTCGAATCTAGGGA,80,84,4,13,1912,0,0
3706,ACGTCGAATCAAGGGA,80,84,4,7,1936,0,0
3708,ACGTCGAATCTAGGGA,80,84,4,10,1938,0,0
3716,ACGTCGAATCTAGGGA,80,84,4,13,1951,0,0
3723,ACGTCGAATCTAGGGA,80,84,4,13,1959,0,0
3729,ACATCGGATCTAGGGA,80,84,4,10,1968,0,0
3737,ACGTCGAATCTAGGGA,80,84,4,10,1982,0,0
3763,ACGTCGACTCTAGGGA,80,84,4,10,2450,0,0
3779,ACGTCGAATCAAGGGA,80,84,4,10,2471,0,0
3796,ACGTCGAATCTAGGGA,80,84,4,10,2492,0,0
3803,ACGTCGAATCTAGGGA,80,84,4,10,2507,0,0
3820,ACGTCGAATCAAGGGA,80,84,4,10,2529,0,0
3843,ACGTCGACTCTAGGGA,80,84,4,10,2566,0,0
3847,ACGTCGACTCTAGGGA,80,84,4,13,2572,0,0
3872,ACGTCGAATCTAGGGA,80,84,4,13,2620,0,0
3882,ACGTCGAATCTAGGGA,80,84,4,13,2640,0,0
3913,ACGTCGAATCTAGGGA,81,84,3,8,675,0,0
3917,ACGTCGAATCAAGGGA,81,84,3,8,697,0,0
3918,ACGTCGAATCAAGGGA,81,84,3,8,870,0,0
3935,ACGTCGACTCTAGGGA,81,84,3,11,932,0,0
3958,ACGTCGACTCTAGGGA,81,84,3,11,1202,0,0
3972,ACGTCGAATCAAGGGA,81,84,3,11,1249,0,0
3985,ACGTCGAATCTAGGGA,81,84,3,11,1543,0,0
4001,ACGTCGACTCTAGGGA,81,84,3,8,1598,0,0
4002,ACGTCGACTCTAGGGA,81,84,3,11,1601,0,0
4015,ACGTCGAATCTAGGGA,81,84,3,11,1639,0,0
4057,ACGTCGAATCTAGGGA,81,84,3,11,2096,0,0
4063,ACGTCGAATCTAGGCA,81,84,3,11,2107,0,0
4070,ACGTCGACTCTAGGGA,81,84,3,11,2125,0,0
4098,ACGTCAAATCTAGGGA,81,84,3,11,2187,0,0
4122,ACGTCGAATCTAGGGA,81,84,3,11,2701,0,0
4126,ACGTCGAATCTAGGGA,81,84,3,11,2708,0,0
4144,ACGTCGAATCTAGGGA,81,84,3,11,2731,0,0
4146,ACGTCGACTCTAGGGA,81,84,3,14,2733,0,0
4158,ACGTCGACTCTAGGGA,81,84,3,11,2757,0,0
4162,ACGTCGAATCTAGGGA,81,84,3,11,2764,0,0
4183,ACGTCGAATTAAGGGA,81,84,3,11,2799,0,0
4194,ACGTCGAATCTAGGGA,81,84,3,11,2811,0,0
4243,ACATCGGATGTAGGGA,81,84,3,11,2878,0,0
4283,ACGTCGACTCTAGGGA,82,84,2,9,386,0,0
4313,ACGTCGAATCTAGGGA,82,84,2,12,1023,0,0
4319,ACGTCGACTCTAGGGA,82,84,2,9,1274,0,0
4320,ACGTCGAATCTAGGGA,82,84,2,9,1277,0,0
4327,ACGTCGAATCTAGGGA,82,84,2,9,1296,0,0
4347,ACGTCGAATCTAGGGA,82,84,2,9,1683,0,0
4370,ACGTCGAATCTAGGGA,82,84,2,12,1743,0,0
4371,ACGTCGAATCTAGGGA,82,84,2,9,1754,0,0
4396,ACGTCGAATCTAGGGA,82,84,2,12,1824,0,0
4397,ACGTCGAATCTAGGGA,82,84,2,12,1825,0,0
4423,ACGTCGAATCTAGGGA,82,84,2,12,2250,0,0
4425,ACGTCGACTCTAGGGA,82,84,2,12,2254,0,0
4433,ACGTCGACTCTAGGGA,82,84,2,12,2265,0,0
4442,TCGTCGAATCTAGGGA,82,84,2,12,2296,0,0
4443,ACGACGAATCTAGGGA,82,84,2,12,2302,0,0
4455,ACGTCGAATCTAGGGA,82,84,2,12,2335,0,0
4456,ACGTCGAATCTAGGGA,82,84,2,15,2339,0,0
4472,ACGTCGACTCTAGGGA,82,84,2,12,2370,0,0
4479,ACGTCGACTCTAGGGA,82,84,2,12,2389,0,0
4530,ACGTCGAATCTAGGGA,82,84,2,9,2974,0,0
4541,ATGTCGAATCTAGGGA,82,84,2,12,2991,0,0
4552,ACGTCGAATCAAGGGA,82,84,2,12,3008,0,0
4554,GCGTCGAATCTAGGGA,82,84,2,12,3010,0,0
4556,ACGTCGACTCTAGGGA,82,84,2,12,3012,0,0
4558,ACGTCGAATCTGGGGA,82,84,2,12,3016,0,0
4567,ACGTCGAATCTAGGGA,82,84,2,12,3029,0,0
4578,ACGTCGAATCTAGGGA,82,84,2,12,3045,0,0
4580,ACGTCGAATCTAGGGA,82,84,2,12,3049,0,0
4585,ACGTCGGATCTAGGGA,82,84,2,12,3057,0,0
4586,ACGTCGAATCTAGGGA,82,84,2,9,3058,0,0
4590,ACGTCGAATCTAGGGA,82,84,2,12,3063,0,0
4595,ACGTCGAATCTAGGGA,82,84,2,12,3069,0,0
4602,ACGTCGACTCTAGGGA,82,84,2,12,3080,0,0
4640,ACGTCGAATCTAGGGA,82,84,2,12,3143,0,0
4649,ACGTCGAATCTAGGGA,82,84,2,12,3165,0,0
4658,ACGTCGAATCTAGGGA,82,84,2,12,3181,0,0
4661,ACGTCGACTCTAGGGA,82,84,2,12,3187,0,0
4708,ACGTCGAATCTAGGGA,83,84,1,10,830,0,0
4709,ACATCGAATCTAGGGA,83,84,1,10,842,0,0
4711,ACGTCGACTCTAGGGA,83,84,1,7,1037,0,0
4715,ACGTCGAATCTAGGGA,83,84,1,10,1062,0,0
4721,ACGTCGAATCTAGGGA,83,84,1,10,1105,0,0
4727,ACGTCGAATCTAGGGA,83,84,1,10,1120,0,0
4733,ACGTCGACTCTAGGGA,83,84,1,10,1383,0,0
4737,ACGTCGACTCTAGGGA,83,84,1,10,1396,0,0
4748,ACGTCGAATCTAGGGA,83,84,1,10,1431,0,0
302,ACGTCGACTCTAGGGA,54,85,31,8,187,9,0
491,ACGTCGAATCTAGGGA,59,85,26,7,231,8,0
586,ACGTCGAATCTAGGGA,61,85,24,9,121,7,0
789,ACGTCGAATCTAGGGA,64,85,21,9,224,6,0
981,ACGTCGAATCTAGGGA,66,85,19,11,369,5,0
1123,ACGTCGACTCTAGGGA,67,85,18,9,754,5,0
1149,ACGTCGAATCTAGGGA,68,85,17,10,328,5,0
1176,ACGTCGAATCTAGGGA,68,85,17,10,586,5,0
1209,ACGTCGAATCTAGGGA,68,85,17,10,784,5,0
1223,ACGTCGACTCTAGGGA,68,85,17,10,804,5,0
1242,ACGTCGAATCTAGGGA,68,85,17,10,833,5,0
1351,ACGTCGAATCTAGGGA,69,85,16,8,912,4,0
1366,ACCTCGACTCTAGGGA,69,85,16,11,934,4,0
1389,ACGTCGACTCTAGGGA,70,85,15,9,402,4,0
1459,ACGTCGAATCTAGGGA,70,85,15,9,951,4,0
1535,ACGTCGACTCTAGGGA,71,85,14,10,466,4,0
1537,ACGTCGAATCTAGGGA,71,85,14,10,469,4,0
1546,ACGTCGAATCTAGGGA,71,85,14,10,598,4,0
1572,ACGTCGAATCTAGGGA,71,85,14,10,796,4,0
1618,ACGTCGAATCTAGGGA,71,85,14,10,1070,4,0
1690,ACGTCGAATCTAGGGA,72,85,13,8,655,3,0
1734,ACGTCGAATCTAGGGA,72,85,13,11,916,3,0
1812,ACGTCGGATCTAGGGA,72,85,13,11,1221,3,0
1838,ACGTCGAATCTAGGGA,72,85,13,11,1257,3,0
1907,ACGTCGACTCTAGGGA,73,85,12,9,971,2,0
1942,ACGCCGACTCTAGGGA,73,85,12,9,1271,2,0
1959,ACGTCGAATCTAGGGA,73,85,12,12,1293,2,0
2005,ACGTCGAATCTAGGGA,73,85,12,12,1367,2,0
2012,ACGTCGAATCAAGGGA,74,85,11,7,236,2,0
2062,ACATCGAATCTAGGGA,74,85,11,10,842,2,0
2076,ACGTCGAATCTAGGGA,74,85,11,10,1059,2,0
2129,ACGTCGGATCTAGGGA,74,85,11,10,1404,2,0
2132,ACGTCGCATCTAGGGA,74,85,11,10,1408,2,0
2174,ACGTCGAATCAAGGGA,74,85,11,10,1466,2,0
2190,ACGTCGAATCAAGGGA,74,85,11,10,1495,2,0
2237,ACGTCGAATCAAGGGA,75,85,10,11,705,2,0
2258,ACGTCGAATCTAGGGA,75,85,10,11,914,2,0
2259,ACGTCGAATCTAGGGA,75,85,10,11,916,2,0
2339,ACGTCGAATCTAGGGA,75,85,10,14,1255,2,0
2355,ACGTCGAATCTAGGGA,75,85,10,11,1530,2,0
2357,ACGTCGAATCTAGGGA,75,85,10,11,1534,2,0
2362,ACGTCGGATCTAGGGA,75,85,10,11,1540,2,0
2391,ACGTCGAATCTAGGGA,75,85,10,11,1584,2,0
2453,ACGTCGACTCTAGGGA,76,85,9,9,534,1,0
2457,ACGTCGACTCTAGGGA,76,85,9,9,547,1,0
2459,ACGTCGAATCTAGGGA,76,85,9,9,553,1,0
2486,ACGTCGAATCTAGGGA,76,85,9,12,981,1,0
2489,ACGTCGAATCTAGGGA,76,85,9,9,986,1,0
2511,ACGTCGAATCTAGGGA,76,85,9,9,1278,1,0
2520,ACGTCGAATCTAGGGA,76,85,9,9,1295,1,0
2540,ACGTCGAATCTAGGGA,76,85,9,9,1328,1,0
2593,ACGTCGAATCTAGGGA,76,85,9,12,1715,1,0
2606,ACGTCGAATCTCGGGA,76,85,9,12,1729,1,0
2678,ACGTCGAATCTAGGGA,77,85,8,7,125,1,0
2693,ACGTCGAATCTAGGGA,77,85,8,10,597,1,0
2710,ACGTCGAATCTAGGGA,77,85,8,10,830,1,0
2737,ACGTCGAATCTAGGGA,77,85,8,10,1096,1,0
2781,ACGTCGACTCTAGGGA,77,85,8,10,1433,1,0
2791,ACGTCGAATCTAGGGA,77,85,8,13,1453,1,0
2800,ACGTCGAATCTAGGCA,77,85,8,10,1467,1,0
2802,ACGTCGACTCTAGGGA,77,85,8,13,1477,1,0
2813,AGGTCGAATCTAGGGA,77,85,8,13,1507,1,0
2836,ACGTCGAATCAAGGGA,77,85,8,7,1873,1,0
2848,ACGTCGACTCTAGGGA,77,85,8,13,1887,1,0
2890,ACGTCGACTCTAGGGA,77,85,8,10,1944,1,0
2900,ACGTCGACTCTAGGGA,77,85,8,13,1955,1,0
2915,ACGTCGAATCAAGGGA,77,85,8,10,1978,1,0
2921,ACGTCGAATCTAGGGA,77,85,8,10,1985,1,0
2946,ACGTCGAATCTAGGGA,78,85,7,8,361,1,0
2948,ACGTCGAATCTAGGGA,78,85,7,8,379,1,0
2960,ACTTCGAATCTAGGGA,78,85,7,11,685,1,0
2964,ACGTCGGACCTAGGGA,78,85,7,8,866,1,0
2980,ACGTCGAATCTAGGGA,78,85,7,11,914,1,0
3016,ACGTCGAATCTAGGGA,78,85,7,11,1207,1,0
3017,ACGTCGAATCAAGGGA,78,85,7,8,1208,1,0
3031,ACGTCGAATCTAGGGA,78,85,7,11,1242,1,0
3044,ACGTCGAATCAAGGGA,78,85,7,8,1524,1,0
3047,ACGTCGCATCTAGGGA,78,85,7,8,1527,1,0
3049,ACGTCGAATCTAGGGA,78,85,7,11,1529,1,0
3068,ACGTGGACTCTAGGGA,78,85,7,11,1565,1,0
3072,ACGTCGGATCTAGGGA,78,85,7,11,1574,1,0
3130,ACGTCGAATCTAGGGA,78,85,7,11,2039,1,0
3133,ACGTCGAATCTAGGGA,78,85,7,11,2044,1,0
3177,ACGTCGACTCTAGGGA,78,85,7,8,2113,1,0
3189,ACGTCGACTCTAGGGA,78,85,7,11,2134,1,0
3201,ACGTCGAATCTAGGGA,78,85,7,11,2153,1,0
3208,ACGTCGACTCTAGGGA,78,85,7,11,2168,1,0
3209,ACGTCGAATCTAGGGA,78,85,7,11,2169,1,0
3236,ACGTCGAATCTAGGGA,79,85,6,9,424,0,0
3252,ACGTCGAATCTAGGGA,79,85,6,9,740,0,0
3260,ACGTCGAATCAAGGGA,79,85,6,6,949,0,0
3301,ACGTCGGATCTAGGGA,79,85,6,9,1319,0,0
3308,ACGTCGAATCTAGGGA,79,85,6,12,1331,0,0
3318,ACGTCGAATCTAGGGA,79,85,6,12,1368,0,0
3333,ACGTCGAATCTAGGGA,79,85,6,9,1692,0,0
3359,ACGTCGAATCTAGGGA,79,85,6,12,1743,0,0
3367,ACGTCGAATCTAGGGA,79,85,6,12,1769,0,0
3387,ACGTCGAATCAAGCGA,79,85,6,9,1808,0,0
3439,ACGTCGAATCTAGGGA,79,85,6,12,2258,0,0
3476,ACGTCGAATCTCGGGA,79,85,6,12,2317,0,0
3499,ACGTCGACTCTAGGGA,79,85,6,12,2358,0,0
3519,ACGTCGAATCTAGGGA,79,85,6,12,2387,0,0
3524,ACGTCGACTCTAGGGA,79,85,6,12,2395,0,0
3563,ACGTCGAATCTAGGGA,80,85,5,10,347,0,0
3578,ACGTCGACTCTAGGGA,80,85,5,10,790,0,0
3594,ACGTCGGATCTAGGGA,80,85,5,10,1074,0,0
3606,ACGTCGAATCTAGGGA,80,85,5,10,1120,0,0
3616,ACGTCGACTCTAGGGA,80,85,5,10,1386,0,0
3656,ACGTCGACTCTAGGGA,80,85,5,10,1848,0,0
3659,ACGTCGAATCTAGGGA,80,85,5,10,1854,0,0
3678,ACGTCGACTCTAGGGA,80,85,5,13,1887,0,0
3712,ACGTCGAATCTAGGGA,80,85,5,10,1945,0,0
3764,ACGTCGAATCTAGGGA,80,85,5,10,2451,0,0
3765,ACGTCGAATCTAGGGA,80,85,5,10,2452,0,0
3775,ACGTCGAATCTAGGGA,80,85,5,10,2464,0,0
3783,ACGTCGAATCTAGGGA,80,85,5,10,2476,0,0
3795,ACGTCGAATCAAGGGA,80,85,5,10,2491,0,0
3802,ACGTCGAATCTAGGGA,80,85,5,10,2506,0,0
3823,ACGTCGAATCTAGGGA,80,85,5,13,2533,0,0
3827,ACGTCGAATCTAGGGA,80,85,5,10,2540,0,0
3835,ACGTCGAATCTAGGGA,80,85,5,13,2553,0,0
3840,ACGTCGAATCTAGGGA,80,85,5,10,2558,0,0
3854,ACGTCGACTCTAGGGA,80,85,5,10,2590,0,0
3871,ACGTCGAATTCAGGGA,80,85,5,13,2615,0,0
3916,ACGTCGAGTCTAGGGA,81,85,4,11,693,0,0
3920,ACGTCGAATCTAGGGA,81,85,4,11,873,0,0
3921,ACGTCGAATCTAGGGA,81,85,4,8,879,0,0
3922,ACGTCGAATATAGGGA,81,85,4,11,880,0,0
3923,ACGTCGAATCTAGGGA,81,85,4,11,883,0,0
3924,ACGTCGACTCTAGGGA,81,85,4,8,885,0,0
3925,ACGTCGAATCTAAGGA,81,85,4,11,888,0,0
3926,ACGTCGAATCTAGGGA,81,85,4,8,894,0,0
3927,ACGTCGAATCTAGGGA,81,85,4,11,898,0,0
3928,ACGTCGACTCTAGGGA,81,85,4,11,901,0,0
3929,ACGTCGAATCTCGGGA,81,85,4,11,906,0,0
3931,ACGTCGAATCTAGGGA,81,85,4,11,913,0,0
3933,ACGTCGAATCAAGGGA,81,85,4,8,922,0,0
3934,ACGTCGAATCTAGGGA,81,85,4,11,925,0,0
3937,ACGTCGAATCAAGGGA,81,85,4,8,1145,0,0
3938,ACGTCGAATCTAGGGA,81,85,4,11,1146,0,0
3939,ACGTCGAAGCTAGGGA,81,85,4,8,1148,0,0
3941,ACGTCGAATCTAGGGA,81,85,4,11,1157,0,0
3942,ACGTCGAATCTAGGGA,81,85,4,11,1158,0,0
3945,ACGTCGAATCTCGGGA,81,85,4,11,1169,0,0
3946,ACGTCGAATCTCGGGA,81,85,4,11,1170,0,0
3947,ACGTCGACTCTAGGGA,81,85,4,8,1173,0,0
3949,ACGTCGAATCTAGGGA,81,85,4,11,1179,0,0
3950,ACGTGGACTCTAGGGA,81,85,4,11,1180,0,0
3951,ACGTCGACTCTAGGGA,81,85,4,11,1184,0,0
3952,ACGTCGAATCTAGGGA,81,85,4,11,1187,0,0
3953,ACGTCGACTCTAGGGA,81,85,4,11,1195,0,0
3954,GCGTCGAATCTAGGGA,81,85,4,11,1196,0,0
3956,ACGTCGTCTCTAGGGA,81,85,4,11,1199,0,0
3957,ACGTCGAATCTAGGGA,81,85,4,11,1201,0,0
3959,ACGTCGAATCAAGGGA,81,85,4,8,1208,0,0
3960,ACGTCGAATCTAGGGA,81,85,4,11,1209,0,0
3962,ACGTCGAATCTAGGGA,81,85,4,11,1217,0,0
3964,ACGTCGAATCTAGGGA,81,85,4,11,1230,0,0
3965,ACGTCGAATCTAGGGA,81,85,4,11,1233,0,0
3966,ACGTCGAATCTAGGGA,81,85,4,14,1234,0,0
3967,ACGTCGAATCTAGGGA,81,85,4,11,1237,0,0
3968,ACGTCGACTCTAGGGA,81,85,4,11,1241,0,0
3969,ACGTCGAATCTAGGGA,81,85,4,11,1242,0,0
3971,ACATCGAATCTAGGGA,81,85,4,11,1247,0,0
3973,ACGTCGAATCAAGGGA,81,85,4,11,1258,0,0
3974,ACGTCGAATCTAGGGA,81,85,4,8,1514,0,0
3975,ACGTCGAATCTAGGGA,81,85,4,11,1521,0,0
3976,ACGTCGAATCAAGGGA,81,85,4,8,1524,0,0
3977,ACGTCGAATCTAGGGA,81,85,4,11,1525,0,0
3978,ACGTCGCATCTAGGGA,81,85,4,8,1527,0,0
3979,ACGTCGAATCTAGGGA,81,85,4,11,1530,0,0
3980,ACGTCGAATCTAGGGA,81,85,4,11,1534,0,0
3981,ACGTCGACTCTAGGGA,81,85,4,11,1535,0,0
3983,GCGTCGAATCTAGGGA,81,85,4,11,1538,0,0
3986,ACGTCGAATCTAGGGA,81,85,4,11,1546,0,0
3987,ACGTCGAATCAAGGGA,81,85,4,8,1547,0,0
3988,ACGTCGAATCTAGGGA,81,85,4,11,1550,0,0
3989,TCGTCGAATCTAGGGA,81,85,4,11,1552,0,0
3990,ACGTCGAATCTAGGGA,81,85,4,11,1562,0,0
3991,ACGTCGAATCTAGGGA,81,85,4,11,1564,0,0
3992,ACGTGGACTCTAGGGA,81,85,4,11,1565,0,0
3993,ACGTCGAATCTAGGGA,81,85,4,11,1571,0,0
3994,ACGTCGAATCTAGGGA,81,85,4,11,1572,0,0
3995,ACGTCGGATCTAGGGA,81,85,4,11,1574,0,0
3996,ACGTCGAATCTAGGGA,81,85,4,11,1576,0,0
3997,ACGTCGAATCTAGGGA,81,85,4,11,1585,0,0
3999,ACGTCGAATCTAGGGA,81,85,4,14,1595,0,0
4000,ACGTCGAATCTAGGGA,81,85,4,11,1596,0,0
4003,ACGTCGAATCTAGGGA,81,85,4,11,1603,0,0
4004,ACGTAGGATCTAGGGA,81,85,4,11,1605,0,0
4005,ACGTCGAATCTAGGGA,81,85,4,14,1613,0,0
4006,ACGTCGACTCTAGGGA,81,85,4,11,1614,0,0
4007,ACGTCGAATCTAGGGA,81,85,4,11,1618,0,0
4008,ACGTCGACTCTAGGGA,81,85,4,11,1621,0,0
4009,ACGTCGAATCAAGGGA,81,85,4,11,1622,0,0
4010,ACGTCGAATCTAGGGA,81,85,4,11,1624,0,0
4011,ACGTCGAATCTAGGGA,81,85,4,11,1629,0,0
4012,ACGTCGAATCTAGGGA,81,85,4,11,1631,0,0
4013,ACGTCGAATCTAGGGA,81,85,4,11,1634,0,0
4014,ACGTCGAATCTAGTGA,81,85,4,11,1638,0,0
4016,ACGTCGAATCTAGGGA,81,85,4,11,1643,0,0
4017,ACGTCGAATCAAGGGA,81,85,4,11,1647,0,0
4018,ACGTCGACTCTAGGGA,81,85,4,11,1650,0,0
4019,ACGTCGAATCTAGGCA,81,85,4,11,1651,0,0
4020,ACGTCGAATCTAGGGA,81,85,4,11,1654,0,0
4021,ACGTCGAATCTAGGGA,81,85,4,11,1656,0,0
4022,ACGTCGAATCAAGGGA,81,85,4,8,2012,0,0
4023,ACGTCGAATCTAGGGA,81,85,4,11,2016,0,0
4024,ACGTCGAATCAAGGGA,81,85,4,8,2018,0,0
4025,ACGTCGAATCTAGGGA,81,85,4,11,2019,0,0
4026,ACGTCGAATCTAGGGA,81,85,4,11,2023,0,0
4027,ACGTCGAATCTAGGGA,81,85,4,11,2027,0,0
4028,ACGTCGAATCTAGGGA,81,85,4,11,2034,0,0
4029,ACGTCGAATCTAGGGA,81,85,4,11,2036,0,0
4030,ACGTCGAATCTAGGGA,81,85,4,11,2037,0,0
4031,ACGTCGAATCTAGGGA,81,85,4,11,2039,0,0
4032,ACGTCGAATCTAGGGA,81,85,4,11,2044,0,0
4033,ACGTCGAATCAAGGGA,81,85,4,8,2045,0,0
4035,ACGTCGAATCTAGGGA,81,85,4,11,2049,0,0
4036,ACGTCGAATTTAGGGA,81,85,4,11,2050,0,0
4037,ACGTCGACTCTAGGGA,81,85,4,11,2051,0,0
4038,ACGTCGGATCTAGGGA,81,85,4,11,2052,0,0
4041,ACGTCGAATCTAGGGA,81,85,4,11,2056,0,0
4043,ACGTCGAATCTAGGGA,81,85,4,11,2058,0,0
4044,ACATCGAATCTAGGGA,81,85,4,11,2062,0,0
4045,ACGTCGAATCTAGGGA,81,85,4,11,2063,0,0
4046,ACGTCGAATCTAGGGA,81,85,4,14,2066,0,0
4047,ACGTCGAATCTAGGGA,81,85,4,11,2067,0,0
4048,ACGTCGACTCTAGGGA,81,85,4,8,2068,0,0
4049,ACGTCGACTCTAGGGA,81,85,4,11,2071,0,0
4050,ACGTCGAATCTCGGGA,81,85,4,11,2073,0,0
4052,ACGTCGACTCTAGGGA,81,85,4,11,2075,0,0
4053,ACGTCGAATCTAGGGA,81,85,4,11,2076,0,0
4054,ACGTCGACTCTAGGGA,81,85,4,11,2079,0,0
4055,ACGTCGAATCAAGGGA,81,85,4,8,2090,0,0
4058,AGGTCGGATCTAGGGA,81,85,4,11,2097,0,0
4059,ACGTCGAATCTAGGGA,81,85,4,11,2100,0,0
4060,ACGTCGAATCTAGGGA,81,85,4,11,2101,0,0
4061,ACGTCGAATCAGGGGA,81,85,4,11,2103,0,0
4062,ACGTCGACTCTAGGGA,81,85,4,11,2106,0,0
4064,ACGTCGACTCTAGGGA,81,85,4,8,2113,0,0
4065,ACGTCGAATCTAGGGA,81,85,4,11,2115,0,0
4066,ACGTCGAATCTAGGGA,81,85,4,11,2116,0,0
4071,ACGTCGAATCTAGGGA,81,85,4,11,2126,0,0
4072,ACGTCGAATCTAGGGA,81,85,4,11,2127,0,0
4074,ACGTCGACTCTAGGGA,81,85,4,11,2131,0,0
4076,ACGTCGACTCTAGGGA,81,85,4,11,2134,0,0
4077,ACGTCGACTCTAGGGA,81,85,4,14,2137,0,0
4079,ACGTCGACTATAGGGA,81,85,4,14,2140,0,0
4080,ACGTCGAATCTAGGGA,81,85,4,11,2144,0,0
4081,ACGTCGAATCTAGGGA,81,85,4,11,2145,0,0
4082,ACGTCGACTCTAGGGA,81,85,4,11,2146,0,0
4083,ACGTCGAATCTAGGGA,81,85,4,11,2150,0,0
4084,ACGTCGAATCTAGGGA,81,85,4,11,2151,0,0
4085,ACGTCGAATGTAGGGA,81,85,4,11,2153,0,0
4086,ACGTCGAATCAAGGGA,81,85,4,11,2155,0,0
4087,ACGTCGAATCTAGGGA,81,85,4,11,2156,0,0
4088,ACGTCGACTCTAGGGA,81,85,4,11,2157,0,0
4089,ACGTCGAATCTAGGGA,81,85,4,11,2162,0,0
4090,ACGTCGACTCTAGGGA,81,85,4,11,2168,0,0
4091,ACGTCGAATCTAGGGA,81,85,4,11,2169,0,0
4092,ACGGCGAATCTAGGGA,81,85,4,11,2170,0,0
4093,ACGTCGAATCTAGGGA,81,85,4,11,2173,0,0
4094,ACGTCGAACCAAGGGA,81,85,4,11,2174,0,0
4095,ACGTCGAATCTAGGGA,81,85,4,11,2178,0,0
4096,ACGTCGAATCAAGGGA,81,85,4,11,2183,0,0
4101,ACGTCGAATCTAGGGA,81,85,4,11,2191,0,0
4102,ACGTCGAATCTAGGGA,81,85,4,14,2192,0,0
4103,ACGTCGAATCAAGGGA,81,85,4,11,2200,0,0
4104,ACGTCGAATCTAGGGA,81,85,4,14,2202,0,0
4105,ACGTCGAATCTAGGGA,81,85,4,8,2678,0,0
4106,ACGTCGAATCTAGGGA,81,85,4,11,2682,0,0
4107,ACGTCGCATCTAGGGA,81,85,4,8,2683,0,0
4108,ACGTCGAATCTAGGGA,81,85,4,8,2684,0,0
4109,ACGTCGAATCTAGGGA,81,85,4,11,2685,0,0
4110,ACGTCGAATCTAGGGA,81,85,4,11,2686,0,0
4111,ACGTCGAATCTAGGGA,81,85,4,11,2687,0,0
4112,ACGTCGACTCTAGGGA,81,85,4,11,2689,0,0
4113,ACGTCGGATCTAGGGA,81,85,4,11,2690,0,0
4114,ACGTCGAATCTAGGGA,81,85,4,11,2692,0,0
4117,ACGTCGAATCAAGGGA,81,85,4,8,2695,0,0
4118,ACGTCGAATCTTGGGA,81,85,4,11,2696,0,0
4119,ACGTCGAATCTAGGGA,81,85,4,11,2697,0,0
4120,ACGTCGACTCTAGGGA,81,85,4,11,2698,0,0
4121,ACGTCGAATCTAGGGA,81,85,4,11,2699,0,0
4123,ACGTCGAATCTAGGGA,81,85,4,11,2703,0,0
4124,ACGTCGAATCTAGGGA,81,85,4,11,2705,0,0
4127,ACGTCGAATCTAGGGA,81,85,4,11,2709,0,0
4128,ACGTCGAATCTAGGGA,81,85,4,11,2710,0,0
4129,ACGTCGACTCTAGGGA,81,85,4,11,2711,0,0
4130,ACATCGAATCTAGGGA,81,85,4,11,2712,0,0
4131,ACGTCGAATCTAGGGA,81,85,4,14,2714,0,0
4133,ACGTCGACTCTAGGGA,81,85,4,8,2716,0,0
4134,ACGTCGAATCTAGGGA,81,85,4,11,2717,0,0
4136,ACGTCGAATCTTGGGA,81,85,4,11,2719,0,0
4137,ACGTCGAATCTCGGGA,81,85,4,11,2720,0,0
4139,ACGTCGAATCTAGGGA,81,85,4,11,2722,0,0
4140,ACGTCGAATCTAGGGA,81,85,4,11,2723,0,0
4141,ACGTCGAATCTAGGGA,81,85,4,14,2724,0,0
4143,ACGTCGAATCTAGGGA,81,85,4,11,2728,0,0
4145,ACGTCGAATCTAGGGA,81,85,4,11,2732,0,0
4148,ACGTCGAATCTAGGGA,81,85,4,11,2737,0,0
4149,ACGTCGAATCTAGGGA,81,85,4,11,2739,0,0
4150,ACGTCGAATCTAGGGA,81,85,4,11,2743,0,0
4152,ACGTCGAATCAAGGGA,81,85,4,11,2745,0,0
4154,ACGTCGAATCTAGGCA,81,85,4,11,2748,0,0
4155,ACGTCGAATCTAGGGA,81,85,4,14,2751,0,0
4156,ACGTCGAATCTAGGGA,81,85,4,14,2752,0,0
4157,ACGTCGAATCTAGGGA,81,85,4,11,2756,0,0
4159,ACGTCGAATCTCGGGA,81,85,4,11,2758,0,0
4160,ACGTCGAATCTAGGGA,81,85,4,11,2761,0,0
4161,ACGTCGACTCTAGGGA,81,85,4,11,2762,0,0
4163,ACGTCGAATCTAGGGA,81,85,4,11,2765,0,0
4164,ACGTCGAATCTAGGGA,81,85,4,11,2768,0,0
4165,ACGTCGAATCTAGGGA,81,85,4,11,2770,0,0
4166,ACGTCGAATCTAGGGA,81,85,4,11,2771,0,0
4167,ACGTCGAATCTAGGGA,81,85,4,14,2774,0,0
4168,ACGTCGACTCTAGGGA,81,85,4,11,2777,0,0
4170,ACGTCGACTCTAGGGA,81,85,4,11,2781,0,0
4171,ACGTCGACTCTAGGGA,81,85,4,14,2783,0,0
4172,ACGTCGAATCAAGGGA,81,85,4,11,2784,0,0
4174,ACGTCGACTCTAGGGA,81,85,4,11,2786,0,0
4175,ACGTCGAATCAAGGGA,81,85,4,11,2787,0,0
4177,ACGTCGAATCTAGGGA,81,85,4,11,2789,0,0
4179,ACGTCGACTCTAGGGA,81,85,4,11,2793,0,0
4180,ACGGCGAATCTAGGGA,81,85,4,11,2795,0,0
4182,ACGTCGGATCTAGGGA,81,85,4,11,2797,0,0
4184,ACGTCGAATCTAGGCA,81,85,4,11,2800,0,0
4185,ACGTCGAATCTAGGGA,81,85,4,11,2801,0,0
4186,ACGTCGACTCTAGGGA,81,85,4,14,2802,0,0
4187,ACATCGAATCAAGGGA,81,85,4,11,2803,0,0
4188,ACGTCGGATCTAGGGA,81,85,4,11,2804,0,0
4189,ACGTCGAATCTAGGGA,81,85,4,11,2805,0,0
4190,ACGTCGAATCTGGGGA,81,85,4,11,2807,0,0
4192,ACGTCGAATCTAGGGA,81,85,4,11,2809,0,0
4193,ACGTCGAATCTAGGGA,81,85,4,14,2810,0,0
4195,AGGTCGAATCTAGGGA,81,85,4,14,2813,0,0
4196,ACGTCGAGTCTAGGGA,81,85,4,14,2814,0,0
4197,ACGTCGAATCTAGGGA,81,85,4,11,2816,0,0
4198,ACGTCGAATCTAGGGA,81,85,4,11,2817,0,0
4199,ACGTCGACTCTAGGGA,81,85,4,11,2818,0,0
4200,ACGTCGAATCTCGGGG,81,85,4,11,2819,0,0
4201,ACGTCGACTCTAGGGA,81,85,4,11,2820,0,0
4203,ACGTCGAATCTAGGGA,81,85,4,11,2823,0,0
4204,ACGTCGAATCTAGGGA,81,85,4,11,2824,0,0
4205,ACGTCGAATCTAGGGA,81,85,4,11,2825,0,0
4206,ACGTCGAATCTAGGGA,81,85,4,11,2826,0,0
4207,ACGTCGACTCTAGGGA,81,85,4,11,2827,0,0
4208,ACGTCGGATCTAGGGA,81,85,4,11,2828,0,0
4209,ACGTCGAATCTAGGGA,81,85,4,11,2832,0,0
4210,ACGTCGAATCTAGGGA,81,85,4,11,2834,0,0
4211,ACGTCGAATCAAGGGA,81,85,4,8,2836,0,0
4212,ACGTCGACTCTAGGAA,81,85,4,11,2837,0,0
4213,ACGTCGAATCTAGGGA,81,85,4,11,2838,0,0
4214,ACGTCGAATCTAGGGA,81,85,4,11,2840,0,0
4215,ACGTCGACTCTAGGGA,81,85,4,11,2842,0,0
4216,ACGTCGAATCTAGGGA,81,85,4,11,2843,0,0
4217,ACGTCGAATCTAGGGA,81,85,4,11,2845,0,0
4218,ACGTCGACTCTAGGGA,81,85,4,11,2846,0,0
4219,ACGTCGAAACTAGGGA,81,85,4,11,2847,0,0
4220,ACGTCGACTCTAGGGA,81,85,4,14,2848,0,0
4221,ACGTCGACTCTAGGGA,81,85,4,11,2850,0,0
4222,ACGTCGAATCTAGGGG,81,85,4,11,2851,0,0
4223,ACGTCGAATCAAGGGA,81,85,4,11,2853,0,0
4224,ACGTCGAATCTAGGGA,81,85,4,14,2854,0,0
4226,ACGTCGACTCTAGGGA,81,85,4,11,2857,0,0
4227,ACGTCGAATCTAGGGA,81,85,4,11,2858,0,0
4228,ACGTCGAATCAAGGGA,81,85,4,11,2860,0,0
4230,ACGTCGACTCTAGGGA,81,85,4,14,2864,0,0
4231,ACGTCGAATCTAGGGA,81,85,4,11,2865,0,0
4232,ACGTCGAATCTAGGGA,81,85,4,11,2867,0,0
4233,ACATCGAATCAAGGGA,81,85,4,11,2868,0,0
4234,ACGTCGAATCAAGGGA,81,85,4,11,2869,0,0
4235,ACGTCGACTCTAGGGA,81,85,4,11,2870,0,0
4237,ACGTCGATTCTAGGGA,81,85,4,14,2872,0,0
4238,ACGTCGAATCTAGGGA,81,85,4,11,2873,0,0
4239,ACGTCGAATCTAGGGA,81,85,4,11,2874,0,0
4241,ACGTCGACTCTAGGGA,81,85,4,11,2876,0,0
4244,AGGTCGAATCTAGGGA,81,85,4,14,2880,0,0
4245,ACGTCGAATCTAGGGA,81,85,4,11,2881,0,0
4246,ACGTCGAATCTAGGGA,81,85,4,14,2882,0,0
4247,GCGTCGAATCTAGGGA,81,85,4,14,2883,0,0
4248,ACGTCGAATCTAGGGA,81,85,4,14,2884,0,0
4249,ACGTCGAATCTAGGGA,81,85,4,11,2887,0,0
4251,ACGCCAACTCTAGGGA,81,85,4,11,2889,0,0
4252,ACGTCGACTCTAGGGA,81,85,4,11,2890,0,0
4253,ACGTCGAATCTAGGGA,81,85,4,11,2891,0,0
4254,ACGTCGAATCTAGGGA,81,85,4,11,2892,0,0
4255,ACGTCGACTCTAGGGA,81,85,4,14,2893,0,0
4256,ACGTCGAATCTAGGGA,81,85,4,14,2894,0,0
4257,ACATCGACTCTAGGGA,81,85,4,11,2897,0,0
4258,ACGTCGACTCTAGGGA,81,85,4,14,2900,0,0
4259,ACGTCGAATCTAGGGA,81,85,4,14,2902,0,0
4260,ACGTCGAATCTAGGGA,81,85,4,14,2903,0,0
4261,ACGTCGAATCTAGGGA,81,85,4,14,2904,0,0
4262,ACGTCTAATCTAGGGA,81,85,4,11,2905,0,0
4263,ACTTCGACTCTAGGGA,81,85,4,14,2906,0,0
4264,ACGTCGAATCTAGGGA,81,85,4,14,2912,0,0
4265,ACGTCGGATCTAGGGA,81,85,4,11,2914,0,0
4266,ACGTCGAATCAAGGGA,81,85,4,11,2915,0,0
4267,ACGTCGAATCTAGGGA,81,85,4,11,2916,0,0
4268,ACGTCGAATCTAGGGA,81,85,4,14,2918,0,0
4271,ACGTCGAATCTAGGGA,81,85,4,14,2922,0,0
4272,ACGTCGAATCTAAGGA,81,85,4,14,2923,0,0
4273,ACGTCGAATCTAGGGA,81,85,4,14,2926,0,0
4276,ACGTCGAATCTAGGGA,81,85,4,14,2931,0,0
4277,ACGTCGAATCTAGGGA,81,85,4,14,2932,0,0
4280,ACGTCGAACCTAGGGA,81,85,4,14,2939,0,0
4289,ACGTCGACTCTAGGGA,82,85,3,9,534,0,0
4318,ACGCCGACTCTAGGGA,82,85,3,9,1271,0,0
4323,ACGTCGACTCTAGGGA,82,85,3,9,1286,0,0
4339,ACGTCGAATCTAGGGA,82,85,3,9,1351,0,0
4340,ACGTCGAATCTAGGGA,82,85,3,12,1352,0,0
4351,ACGTCGACTCTAGGGA,82,85,3,9,1691,0,0
4353,ACGTCGAATCTAGGGA,82,85,3,9,1694,0,0
4365,ACGTCGAATCTAGGGA,82,85,3,12,1724,0,0
4369,ACGTCGAATCTAGGGA,82,85,3,12,1735,0,0
4376,AAGTCGAATCTAGGGA,82,85,3,12,1769,0,0
4395,ACGTCGAATCTAGGGA,82,85,3,12,1819,0,0
4413,ACGTCGCATCTAGGGA,82,85,3,9,2228,0,0
4421,ACGTCGACTCTAGGGA,82,85,3,9,2247,0,0
4464,ACGTCGACTCTAGGGA,82,85,3,12,2358,0,0
4474,ACGTCGACTCTAGGGA,82,85,3,12,2375,0,0
4480,ACGTCGAATCTAGGGA,82,85,3,12,2390,0,0
4508,ACGTCGAATCTAGGGA,82,85,3,9,2946,0,0
4515,ACGTCGACTCTAGGGA,82,85,3,9,2953,0,0
4519,ACGTCGAATCTAGGGA,82,85,3,9,2958,0,0
4521,ACTTCGAATCTAGGGA,82,85,3,12,2960,0,0
4528,ACGTCGACTCTAGGGA,82,85,3,9,2972,0,0
4534,ACGTCGAATCTAGGGA,82,85,3,12,2980,0,0
4543,ACGTCGAATCTAGGGA,82,85,3,12,2993,0,0
4553,ACGTCGACTCTAGGGA,82,85,3,12,3009,0,0
4557,ACGTCGAATCTAGGGA,82,85,3,12,3015,0,0
4627,ACGTCGAATCTAGGGA,82,85,3,12,3122,0,0
4650,AGGTCGGATCTAGGGA,82,85,3,12,3168,0,0
4716,ACGTCGACTCTAGGGA,83,85,2,10,1065,0,0
4723,ACGTCGAATCTAGTGA,83,85,2,10,1108,0,0
4730,ACGTCGACTCTAGGGA,83,85,2,7,1376,0,0
4749,ACGTCGACTCTAGGGA,83,85,2,13,1436,0,0
4786,ACGTCGACTCTAGGGA,84,85,1,11,1143,0,0
4788,ACGTCGAATCTAGGGA,84,85,1,11,1157,0,0
4797,ACGTCGACTCTAGGGA,84,85,1,11,1195,0,0
4835,ACGTCGAATCTAGGGA,84,85,1,11,1596,0,0
4836,ACGTCGACTCTAGGGA,84,85,1,8,1598,0,0
440,ACGTCGAATCTAGGGA,58,86,28,9,121,8,0
553,ACGTCGAATCTAGGGA,60,86,26,8,274,8,0
796,ACGTCGAATCTAGGGA,64,86,22,9,305,6,0
914,ACGTCGAATCTAGGGA,65,86,21,10,587,6,0
967,ACGTCGAATCTAGGGA,66,86,20,8,274,6,0
1066,ACGTCGAATCTAGGGA,67,86,19,9,525,5,0
1086,ACGTCGACTCTAGGGA,67,86,19,12,568,5,0
1195,ACGTCGACTCTAGGGA,68,86,18,10,623,5,0
1286,ACGTCGACTCTAGGGA,69,86,17,8,477,5,0
1383,ACGTCGACTCTAGGGA,70,86,16,9,302,4,0
1418,ACGTCGAATCTAGGGA,70,86,16,12,577,4,0
1430,ACGTCGACTCTAGGGA,70,86,16,12,732,4,0
1452,ACGTCGAATCTAGGGA,70,86,16,12,771,4,0
1521,ACGTCGAATCTAGGGA,71,86,15,10,328,4,0
1524,ACGTCGAATCAAGGGA,71,86,15,7,343,4,0
1530,ACGTCGAATCTAGGGA,71,86,15,10,441,4,0
1552,TCGTCGAATCTAGGGA,71,86,15,10,612,4,0
1564,ACGTCGAATCTAGGGA,71,86,15,10,784,4,0
1598,ACGTCGACTCTAGGGA,71,86,15,7,1037,4,0
1614,ACGTCGACTCTAGGGA,71,86,15,10,1064,4,0
1697,ACGTCGAATCTAGGGA,72,86,14,11,680,4,0
1698,ACATCGGATCTAGGGA,72,86,14,8,683,4,0
1709,ACGTCGAATCTAGGGA,72,86,14,8,871,4,0
1719,ACGTCGAATCTAAGGA,72,86,14,11,888,4,0
1725,ACGTCGACTCTAGGGA,72,86,14,11,899,3,0
1769,ACGTCGAATCTAGGGA,72,86,14,11,1167,3,0
1772,ACGTCGAATCTCGGGA,72,86,14,11,1170,3,0
1819,ACGTCGAATCTAGGGA,72,86,14,11,1230,3,0
1830,ACGTCGACTCTAGGGA,72,86,14,11,1245,3,0
1856,ACGTCGAATCTAGGGA,73,86,13,9,525,2,0
1909,ACGTCGACTCTAGGGA,73,86,13,12,979,2,0
1922,ACGTCGAATCTAGGGA,73,86,13,9,1011,2,0
1936,ACGTCGAATCAAGGGA,73,86,13,6,1260,2,0
1949,ACGTCGAATCTAGGGA,73,86,13,12,1283,2,0
1977,ACGTCGGATCTAGGGA,73,86,13,9,1319,2,0
1978,ACGTCGAATCAAGGGA,73,86,13,9,1321,2,0
1981,ACGTCGAATCTAGGGA,73,86,13,12,1324,2,0
1988,ACGTCGAATCTAAGGA,73,86,13,12,1333,2,0
2003,ACGTCGGATCTAGGGA,73,86,13,12,1363,2,0
2051,ACGTCGACTCTAGGGA,74,86,12,10,797,2,0
2138,ACGTCGAGTCTAGGGA,74,86,12,10,1415,2,0
2225,ACGTCGAATCTAGGGA,75,86,11,8,661,2,0
2286,ACGTCGAATCTAGGGA,75,86,11,8,1172,2,0
2306,ACGTCGAATCTAGGGA,75,86,11,11,1203,2,0
2353,ACGTCGAATCTAGGGA,75,86,11,8,1528,2,0
2358,ACGTCGACTCTAGGGA,75,86,11,11,1535,2,0
2397,ACGTCGAATCTAGGGA,75,86,11,11,1592,2,0
2414,ACGTCGAATCTAGGGA,75,86,11,11,1616,2,0
2443,ACGTCGAATCTCGGGA,76,86,10,9,313,1,0
2450,ACGTCGACTCTAGGGA,76,86,10,9,522,1,0
2456,ACGTCGAATCTAGGGA,76,86,10,9,546,1,0
2487,ACGTCGAATCTAGGGA,76,86,10,9,982,1,0
2490,ACATCGAATCAAGGGA,76,86,10,9,988,1,0
2494,ACGTCGAATCTAGGGA,76,86,10,9,1005,1,0
2521,ACGTCGAATCTAGGGA,76,86,10,9,1296,1,0
2647,ACGTCGAATCTAGGGA,76,86,10,12,1799,1,0
2653,ACGTCGAATCTAGGGA,76,86,10,12,1805,1,0
2684,ACGTCGAATCTAGGGA,77,86,9,7,438,1,0
2705,ACGTCGAATCTAGGGA,77,86,9,10,796,1,0
2743,ACGTCGAATCTAGGGA,77,86,9,10,1114,1,0
2761,ACGTCGAATCTAGGGA,77,86,9,10,1390,1,0
2771,ACGTCGAATCTAGGGA,77,86,9,10,1415,1,0
2777,ACGTCGACTCTAGGGA,77,86,9,10,1427,1,0
2797,ACGTCGGATCTAGGGA,77,86,9,10,1464,1,0
2853,ACGTCGAATCAAGGGA,77,86,9,10,1893,1,0
2858,ACGTCGAATCTAGGGA,77,86,9,10,1901,1,0
2860,ACGTCGAATCAAGGGA,77,86,9,10,1903,1,0
2878,ACATCGGATCTAGGGA,77,86,9,10,1927,1,0
2916,ACGTCGAATCTAGGGA,77,86,9,10,1979,1,0
2927,ACGTCGAATCTAGGGA,77,86,9,13,1993,1,0
2945,ACGTCGACTCTAGGGA,78,86,8,11,281,1,0
2947,ACGTCGAATCTAGGGA,78,86,8,11,378,1,0
2967,ACGTCGAATCTAGGGA,78,86,8,11,873,1,0
2972,ACGTCGACTCTAGGGA,78,86,8,8,885,1,0
2975,ACGTCGAATCTAGGGA,78,86,8,11,898,1,0
2989,ACGTCGAATCTAGGGA,78,86,8,11,1146,1,0
3073,ACGTCGAATCTAGGGA,78,86,8,11,1576,1,0
3079,ACGTCGAATCTAGGGA,78,86,8,11,1592,1,0
3080,ACGTCGACTCTAGGGA,78,86,8,11,1593,1,0
3128,ACGTCGAATCTAGGGA,78,86,8,11,2037,1,0
3163,ACGTCGAATCTAGGGA,78,86,8,11,2088,1,0
3205,ACGTCGAATCTAGGGA,78,86,8,11,2159,1,0
3211,ACGTCGAATCTAGGGA,78,86,8,11,2171,1,0
3225,ACGTGGACTCTAGGGA,78,86,8,14,2197,1,0
3241,ACGTCGACTCTAGGGA,79,86,7,9,545,0,0
3279,ACGTCGAATCTAGGGA,79,86,7,12,1032,0,0
3283,ACGTCGACTCTAGGGA,79,86,7,9,1274,0,0
3286,ACGTCGAATCTAGGGA,79,86,7,12,1285,0,0
3322,ACGTCGAATCTAGGGA,79,86,7,9,1665,0,0
3356,ACGTCGAATCTAGGGA,79,86,7,12,1734,0,0
3360,ACGTCGAATCCAGGGA,79,86,7,12,1746,0,0
3363,ACGTCGAATCTAGGGA,79,86,7,9,1760,0,0
3368,GCGTCGAATCTAGGGA,79,86,7,12,1770,0,0
3385,ACGTCGAATCAAGGGA,79,86,7,9,1804,0,0
3398,ACGTCGAATCTAGGGA,79,86,7,12,1832,0,0
3400,ACGTCGAATCTAGGGA,79,86,7,12,1838,0,0
3409,ACGTCGAATCTAGGGA,79,86,7,12,2216,0,0
3410,ACGTCGAATCTAGGGA,79,86,7,9,2218,0,0
3429,ACGTCGACTCTAGGGA,79,86,7,9,2247,0,0
3448,ACGTCGAATCAAGGGA,79,86,7,9,2275,0,0
3471,ACGTCGACTCTAGGGA,79,86,7,12,2312,0,0
3482,ACGTCGAATCTAGGGA,79,86,7,12,2328,0,0
3485,ACGTCGACTCTAGGGA,79,86,7,12,2333,0,0
3509,ACGTCGAATCTAGGGA,79,86,7,12,2372,0,0
3516,ACGTCGAATCTAGGGA,79,86,7,12,2384,0,0
3530,ACGTCGAATCTCGGGA,79,86,7,12,2405,0,0
3533,ACGTCGAATCTAGGGA,79,86,7,12,2408,0,0
3543,ACGTCGAATCTAGGGA,79,86,7,12,2423,0,0
3553,ACGTCGACTCTAGGGA,79,86,7,12,2433,0,0
3564,ACGTCGAATCTAGGGA,80,86,6,7,438,0,0
3572,ACGTCGAATCTAGGGA,80,86,6,10,597,0,0
3610,ACGTCGAATCTAGGGA,80,86,6,13,1139,0,0
3645,ACGTCGAATCAAGGGA,80,86,6,10,1495,0,0
3667,ACGTCGAATCTAGGGA,80,86,6,10,1867,0,0
3684,ACGTCGAATCTAGGGA,80,86,6,10,1897,0,0
3713,ACGTCGAATCTAGGGA,80,86,6,10,1946,0,0
3721,ACGTCGAATCTAGGGA,80,86,6,13,1957,0,0
3724,ACGTCGAATCTAGGGA,80,86,6,10,1961,0,0
3736,ACGTCGAATCTAGGGA,80,86,6,13,1981,0,0
3774,ACGTCGAATCAAGGGA,80,86,6,7,2463,0,0
3793,ACGTCGAATCTAGGGA,80,86,6,10,2489,0,0
3816,ACGTCGACTCTAGGGA,80,86,6,10,2525,0,0
3818,ACGTCGAATCTAGGGA,80,86,6,13,2527,0,0
3829,AAGACGGATCTAGGGA,80,86,6,10,2544,0,0
3855,ACGTCGAATCTAGGGA,80,86,6,13,2593,0,0
3870,GCGTCGAATCTAGGGA,80,86,6,13,2614,0,0
4291,ACGTCGAATCTAGGGA,82,86,4,9,546,0,0
4293,ACGTCGAATCTAGGGA,82,86,4,9,564,0,0
4299,ACGTCGACTCTAGGGA,82,86,4,12,742,0,0
4333,ACGTCGGATCTAGGGA,82,86,4,9,1319,0,0
4337,ACGTCGAATCTAGGGA,82,86,4,9,1328,0,0
4348,ACGTCGAATCAAGGGA,82,86,4,9,1684,0,0
4359,ACGTCGAATCTAGGGA,82,86,4,9,1709,0,0
4386,ACGTCGAATCTAGGGA,82,86,4,9,1798,0,0
4418,ACGTCGAATCAAGGGA,82,86,4,12,2237,0,0
4424,ACGTCGAATCTAGGGA,82,86,4,12,2252,0,0
4439,ACGTCGAATCTAGGGA,82,86,4,9,2286,0,0
4476,ACGTCGACTCTAGGGA,82,86,4,12,2385,0,0
4483,ACGTCGAATCTAGGGA,82,86,4,12,2397,0,0
4485,ACGTCGAATCTCGGGA,82,86,4,12,2405,0,0
4486,ACGTAGGATCTAGGGA,82,86,4,12,2406,0,0
4490,ACGTCGAATCTAGGGA,82,86,4,12,2415,0,0
4492,ACGTCGACTCTAGGGA,82,86,4,15,2419,0,0
4512,ACGTCTAATCTAGGGA,82,86,4,9,2950,0,0
4514,ACGTCGAATCTAGGGA,82,86,4,9,2952,0,0
4525,ACGTCGAATCTAGGGA,82,86,4,12,2967,0,0
4540,ACGTCGAATCTAGGGA,82,86,4,9,2990,0,0
4566,ACGTCGAATCTAGGGA,82,86,4,12,3028,0,0
4576,ACGTCGAATCTAGGGA,82,86,4,9,3042,0,0
4588,ACGGCGAATCTAGGGA,82,86,4,12,3061,0,0
4589,ACGTCGAATCAAGGGA,82,86,4,9,3062,0,0
4596,ACGTCGAATCTAGGGA,82,86,4,12,3070,0,0
4623,ACGTCGAATCTAGGGA,82,86,4,9,3115,0,0
4628,ACGTCGAATCTAGGGA,82,86,4,12,3123,0,0
4631,ACGTCGAATCTAGGGA,82,86,4,12,3127,0,0
4636,ACGTCGAATCTAGGGA,82,86,4,12,3135,0,0
4644,ACGTCGACTCTAGGGA,82,86,4,12,3155,0,0
4652,ACGTCGAATCAGGGGA,82,86,4,12,3171,0,0
4659,ACGTCGAATCTAGGGA,82,86,4,12,3182,0,0
4679,ACGTCGAATCTAGGGA,82,86,4,12,3211,0,0
4681,ACGTCGACTCTAGGGA,82,86,4,15,3215,0,0
4694,ACGTCGAATCTAGGGA,83,86,3,10,463,0,0
4703,ACGTCGAATCTAGGGA,83,86,3,10,789,0,0
4718,ACGTCGACTCTAGGGA,83,86,3,10,1076,0,0
4744,ACGTCGACTATAGGGA,83,86,3,13,1417,0,0
4784,ACGTCGAATCAAGGGA,84,86,2,8,922,0,0
4798,GCGTCGAATCTAGGGA,84,86,2,11,1196,0,0
4802,ACGTCGACTCTAGGGA,84,86,2,11,1223,0,0
4810,ACGTCGAATCAAGGGA,84,86,2,11,1258,0,0
4839,ACGTAGGATCTAGGAA,84,86,2,11,1605,0,0
4851,ACGTCGACTCTAGGGA,84,86,2,11,1650,0,0
4862,ACGTCGAATCTAGGGA,85,86,1,9,564,0,0
4871,ACGTCGAATCTAGGGA,85,86,1,9,967,0,0
4889,ACGTCGACTCTAGGGA,85,86,1,9,1299,0,0
4896,ACGTCGAATCTAGGGA,85,86,1,9,1325,0,0
4897,ACGTCGAATCTAGGGA,85,86,1,9,1328,0,0
4911,ACGTCGAATCTAGGGA,85,86,1,12,1697,0,0
4912,ACATCGGATCTAGGGA,85,86,1,9,1698,0,0
4916,ACGTCGACTCTAGGGA,85,86,1,9,1718,0,0
347,ACGTCGAATCTAGGGA,55,87,32,9,224,10,0
463,ACGTCGAATCTAGGGA,58,87,29,9,297,9,0
540,ACGTCGAATCTAGGGA,60,87,27,8,201,8,0
715,ACGTCGAATCTAGGGA,63,87,24,8,192,7,0
842,ACATCGAATCTAGGGA,64,87,23,9,548,7,0
1030,ACGTCGAATCAAGGGA,66,87,21,8,697,6,0
1108,ACGTCGAATCTAGTGA,67,87,20,9,733,6,0
1117,ACGTCGAATCTAGGGA,67,87,20,9,745,6,0
1247,ACATCGAATCTAGGGA,68,87,19,10,842,5,0
1271,ACGCCGACTCTAGGGA,69,87,18,8,269,5,0
1508,ACGTCGAGTCTAGGGA,70,87,17,12,1029,5,0
1514,ACGTCGAATCTAGGGA,71,87,16,7,125,4,0
1534,ACGTCGAATCTAGGGA,71,87,16,10,463,4,0
1702,ACGTCGAATCAAGGGA,72,87,15,8,697,4,0
1805,ACGTCGAATCTAGGGA,72,87,15,11,1213,3,0
1915,ACGTCGAATCAAGGGA,73,87,14,9,995,2,0
1929,ACGTGGACTCTAGGGA,73,87,14,12,1027,2,0
2001,ACGTCGAATCTAGGGA,73,87,14,12,1361,2,0
2023,ACGTCGAATCTAGGGA,74,87,13,10,440,2,0
2106,ACGTCGACTCTAGGGA,74,87,13,10,1123,2,0
2127,ACGTCGAATCTAGGGA,74,87,13,10,1401,2,0
2137,ACGTCGACTCTAGGGA,74,87,13,13,1414,2,0
2187,ACGTCGAATCTAGGGA,74,87,13,10,1490,2,0
2212,ACGTCGAATCTAGGGA,75,87,12,8,351,2,0
2218,ACGTCGAATCTAGGGA,75,87,12,8,379,2,0
2222,ACGTCGAATCTAGGGA,75,87,12,11,512,2,0
2224,ACGTCGACTCTAGGGA,75,87,12,8,660,2,0
2228,ACGTCGCATCTAGGGA,75,87,12,8,678,2,0
2230,ACGTCGAATCTAGGGA,75,87,12,11,680,2,0
2231,ACGTCGAATCTAGGGA,75,87,12,11,685,2,0
2244,ACGTCGAATCTAGGGA,75,87,12,11,880,2,0
2248,ACGTCGAATCTAAGGA,75,87,12,11,888,2,0
2250,ACGTCGAATCTAGGGA,75,87,12,11,893,2,0
2254,ACGTCGACTCTAGGGA,75,87,12,11,901,2,0
2255,ACGTCGAATCTCGGGA,75,87,12,11,906,2,0
2256,AAGTCGGATCTAGGGA,75,87,12,8,911,2,0
2257,ACGTCGAATCTAGGGA,75,87,12,11,913,2,0
2263,ACGTCGAATCTAGGGA,75,87,12,11,924,2,0
2265,ACGTCGACTCTAGGGA,75,87,12,11,932,2,0
2269,ACGTCGACTCTAGGGA,75,87,12,11,1143,2,0
2270,ACGTCGAATCAAGTGA,75,87,12,8,1145,2,0
2275,ACGTCGAATCAAGGGA,75,87,12,8,1152,2,0
2276,ACGTCGACTCTAGGGA,75,87,12,11,1157,2,0
2285,ACGTCGGATCTAGGGA,75,87,12,11,1171,2,0
2289,ACGTCGAATCTAGGGA,75,87,12,11,1176,2,0
2293,ACGTCGACTCTAGGGA,75,87,12,11,1184,2,0
2296,TCGTCGAATCTAGGGA,75,87,12,11,1188,2,0
2302,ACGTCGAATCTAGGGA,75,87,12,11,1197,2,0
2307,ACGTCGACTCTAGGGA,75,87,12,8,1204,2,0
2310,ACGTCGAATCTAGGGA,75,87,12,11,1209,2,0
2312,ACGTCGACTCTAGGGA,75,87,12,11,1214,2,0
2313,ACGTCGAATCTAGGGA,75,87,12,11,1215,2,0
2314,ACGTCGAATCAAGCGA,75,87,12,8,1216,2,0
2319,ACGTCGACTCTAGGGA,75,87,12,11,1223,2,0
2326,ACGTCGAATCTAGGGA,75,87,12,14,1234,2,0
2332,ACGTCGGATCTAGGGA,75,87,12,11,1243,2,0
2347,ACGTCGAATCTAGGGA,75,87,12,8,1520,2,0
2348,ACGTCGAATCTAGGGA,75,87,12,11,1521,2,0
2350,ACGTCGAATCTAGGGA,75,87,12,11,1525,2,0
2352,ACGTCGCATCTAGGGA,75,87,12,8,1527,2,0
2359,ACGTCGAATCTAGGGA,75,87,12,11,1536,2,0
2361,GCGTCGAATCTAGGGA,75,87,12,11,1538,2,0
2365,ACGTCGAATCTAGGGA,75,87,12,11,1543,2,0
2367,ACGTCGAATCTAGGGA,75,87,12,11,1545,2,0
2370,ACGTCGACTCTAGGGA,75,87,12,11,1548,2,0
2373,TCGTCGAATCTAGGGA,75,87,12,11,1552,2,0
2375,ACGTCGACTCTAGGGA,75,87,12,11,1556,2,0
2386,ACGTCGGATCTAGGGA,75,87,12,11,1574,2,0
2387,ACGTCGAATCTAGGGA,75,87,12,11,1576,2,0
2389,ACGTCGACTCTAGGGA,75,87,12,11,1579,2,0
2390,ACGTCGAATCTAGGGA,75,87,12,11,1583,2,0
2406,ACGTAGGATCTAGGGA,75,87,12,11,1605,2,0
2407,ACGTCGACTCTAGGGA,75,87,12,11,1608,2,0
2409,ATGTCGGATCTAGGGA,75,87,12,11,1611,2,0
2415,ACGTCGAATCTAGGGA,75,87,12,11,1618,2,0
2417,ACGTCGAATCAAGGGA,75,87,12,11,1622,2,0
2419,ACGTCGACTCTAGGGA,75,87,12,14,1627,2,0
2422,ACGTCGAATCTAGGGA,75,87,12,11,1632,2,0
2423,ACGTCGAATCTAGGGA,75,87,12,11,1634,2,0
2424,ACGTCGAATCTAGGGA,75,87,12,11,1636,2,0
2425,ACGTCGAATCTAGTGA,75,87,12,11,1638,2,0
2427,ACGTCGACTCTAGGGA,75,87,12,11,1641,2,0
2428,ACGTCGAATCTAGGGA,75,87,12,11,1643,2,0
2430,ACGTCGAATCAAGGGA,75,87,12,11,1647,2,0
2432,ACGTCGACTCTAGGGA,75,87,12,11,1649,2,0
2434,ACGTCGAATCTAGGCA,75,87,12,11,1651,2,0
2439,ACGTCGAATCTAGGGA,75,87,12,11,1659,2,0
2447,ACGTCGGATCTAGGGA,76,87,11,9,408,1,0
2452,ACGTCGAATCTAGGGA,76,87,11,9,533,1,0
2475,ACGTCGAATCTAGGGA,76,87,11,12,764,1,0
2496,ACGTGGAATCTAGGGA,76,87,11,12,1016,1,0
2545,ACGTCGAATCTAGGGA,76,87,11,9,1351,1,0
2546,ACGTCGAATCTAGGGA,76,87,11,12,1352,1,0
2555,GCGTCGAATCTAGGGA,76,87,11,12,1369,1,0
2557,ACGTCGAATCAAGGGA,76,87,11,6,1661,1,0
2572,ACGTCGACTCTAGGGA,76,87,11,12,1685,1,0
2590,ACGTCGACTCTAGGGA,76,87,11,9,1712,1,0
2595,ACGTCGAAACTAGGGA,76,87,11,12,1717,1,0
2627,ACGTCGAATCTAGGGA,76,87,11,12,1768,1,0
2685,ACGTCGAATCTAGGGA,77,87,10,10,440,1,0
2695,ACGTCGAATCAAGGGA,77,87,10,7,599,1,0
2752,ACGTCGAATCTAGGGA,77,87,10,13,1139,1,0
2765,ACGTCGAATCTAGGGA,77,87,10,10,1403,1,0
2786,ACGTCGACTCTAGGGA,77,87,10,10,1441,1,0
2788,ACGTCGAATCTAGGGA,77,87,10,10,1448,1,0
2811,ACGTCGAATCTAGGGA,77,87,10,10,1505,1,0
2850,ACGTCGACTCTAGGGA,77,87,10,10,1890,1,0
2939,ACGTCGAACCTAGGGA,77,87,10,13,2009,1,0
2942,ACGTCGGATCTAGGGA,78,87,9,8,204,1,0
2944,ACGTCGAATCTAGGGA,78,87,9,8,259,1,0
2950,ACGTCGAATCTAGGGA,78,87,9,8,491,1,0
2951,ACGTCGAATCTAGGGA,78,87,9,11,512,1,0
2952,ACGTCGAATCTAGGGA,78,87,9,8,655,1,0
2953,ACGTCGACTCTAGGGA,78,87,9,8,660,1,0
2954,ACGTCGAATCTAGGGA,78,87,9,8,661,1,0
2957,ACGTCGCATCTAGGGA,78,87,9,8,678,1,0
2958,ACGTCGAATCTAGGGA,78,87,9,8,679,1,0
2959,ACGTCGAATCTAGGGA,78,87,9,11,680,1,0
2966,ACGTCGAATCTAGGGA,78,87,9,8,871,1,0
2969,ACGTCGAATCTAGGGA,78,87,9,11,880,1,0
2973,ACGTCGAATCTAAGGA,78,87,9,11,888,1,0
2976,ACGTCGACTCTAGGGA,78,87,9,11,901,1,0
2985,GCGTCGAATCTAGGGA,78,87,9,11,938,1,0
2986,ACGTCGACTCTAGGGA,78,87,9,11,946,1,0
2987,ACGTCGACTCTAGGGA,78,87,9,11,1143,1,0
2988,ACGTCGAATCAAGGGA,78,87,9,8,1145,1,0
2990,ACGTCGAATCTAGGGA,78,87,9,8,1148,1,0
2991,ACGTCGAATCTAGGGA,78,87,9,11,1149,1,0
2993,ACGTCGAATCTAGGGA,78,87,9,11,1158,1,0
2994,ACGTCGACTCTAGGGA,78,87,9,11,1162,1,0
2996,ACGTCGAATCTAGGGA,78,87,9,11,1167,1,0
2997,ACGTCGAATCTAGGGA,78,87,9,11,1169,1,0
2999,TCGTCGAATCTAGGGA,78,87,9,8,1172,1,0
3001,AAGTCGGATCTAGGGA,78,87,9,8,1174,1,0
3003,ACGTCGAATCTAGGGA,78,87,9,11,1179,1,0
3005,ACGTCGACTCTAGGGA,78,87,9,11,1184,1,0
3008,ACGTCGAATCAAGGGA,78,87,9,11,1189,1,0
3009,ACGTCGACTCTAGGGA,78,87,9,11,1195,1,0
3010,GCGTCGAATCTAGGGA,78,87,9,11,1196,1,0
3011,ACGTCGAATCTAGGGA,78,87,9,11,1197,1,0
3012,ACGTCGACTCTAGGGA,78,87,9,11,1199,1,0
3015,ACGTCGAATCTAGGGA,78,87,9,11,1203,1,0
3021,ACGTCGACTCTAGGGA,78,87,9,11,1223,1,0
3023,ACGTCGAATCTAGGGA,78,87,9,11,1227,1,0
3025,ACGTCGAATCTAGGGA,78,87,9,11,1230,1,0
3028,ACGTCGAATCTAGGGA,78,87,9,11,1237,1,0
3030,ACGTCGACTCTAGGGA,78,87,9,11,1241,1,0
3033,ACGTCGACTCTAGGGA,78,87,9,11,1245,1,0
3035,ACGTCGAATCAAGGGA,78,87,9,11,1249,1,0
3038,ACGTCGAATCAAGGGA,78,87,9,11,1258,1,0
3039,ACGTCGAATCTAGGGA,78,87,9,8,1514,1,0
3040,ACGTCGAATCTAGGGA,78,87,9,11,1518,1,0
3041,ACGTCGAATCTAGGGA,78,87,9,8,1519,1,0
3042,ACGTCGAATCTAGGGA,78,87,9,8,1520,1,0
3051,ACGTCGAATCTAGGGA,78,87,9,11,1533,1,0
3053,ACGTCGACTCTAGGGA,78,87,9,11,1535,1,0
3055,ACGTCGAATCTAGGGA,78,87,9,11,1537,1,0
3056,GCGTCGAATCTAGGGA,78,87,9,11,1538,1,0
3057,ACGTCGGATCTAGGGA,78,87,9,11,1540,1,0
3058,ACGTCGAATCTAGGGA,78,87,9,8,1541,1,0
3060,ACGTCGAATCTAGGGA,78,87,9,11,1543,1,0
3061,ACGTCGAATCTAGGGA,78,87,9,11,1546,1,0
3062,ACGTCGAATCAAGGGA,78,87,9,8,1547,1,0
3063,ACGTCGAATCTAGGGA,78,87,9,11,1550,1,0
3064,ACGTCGAATCTAGGGA,78,87,9,11,1551,1,0
3065,TCGTCGAATCTAGGGA,78,87,9,11,1552,1,0
3067,ACGTCGAATCTAGGGA,78,87,9,11,1564,1,0
3069,ACGTCGAATCTAGGGA,78,87,9,11,1567,1,0
3070,ACGTCGAATCTAGGGA,78,87,9,11,1571,1,0
3077,ACGTCGACTCTAGGGA,78,87,9,11,1589,1,0
3082,ACGTCGAATCTAGGGA,78,87,9,11,1596,1,0
3083,ACGTCGACTCTAGGGA,78,87,9,8,1598,1,0
3084,ACGTCGAATCAAGGGA,78,87,9,8,1600,1,0
3087,ACGTCGAATCTCGGGA,78,87,9,11,1604,1,0
3089,ACGTCGACTCTAGGGA,78,87,9,11,1608,1,0
3092,ACGTCGACTCTAGGGA,78,87,9,11,1614,1,0
3093,ACGACGAATCTAGGGA,78,87,9,11,1616,1,0
3102,ACGTCGAATCTAGGGA,78,87,9,11,1639,1,0
3103,ACGTCGAATCTAGGGA,78,87,9,11,1643,1,0
3105,ACGTCGAATCAAGGGA,78,87,9,11,1647,1,0
3106,ACGTCGACTCTAGGGA,78,87,9,11,1649,1,0
3108,ACGTCGAATCTAGGCA,78,87,9,11,1651,1,0
3110,ACGTCGAATCTAGGGA,78,87,9,11,1654,1,0
3114,ACGTCGAATCAAGGGA,78,87,9,8,2012,1,0
3115,ACGTCGAATCTAGGGA,78,87,9,8,2014,1,0
3118,ACGTCGAATCAAAGGA,78,87,9,8,2018,1,0
3119,ACGTCGAATCTAGGGA,78,87,9,11,2019,1,0
3120,ACGTCGCATCTAGGGA,78,87,9,8,2021,1,0
3122,ACGTCGAATCTAGGGA,78,87,9,11,2026,1,0
3124,AAGTCGGATCTAGGGA,78,87,9,8,2031,1,0
3126,ACGTCGAATCAAGGGA,78,87,9,8,2035,1,0
3131,ACGTCGACTCTAGGGA,78,87,9,8,2042,1,0
3135,ACGTCGAATCTAGGGA,78,87,9,11,2046,1,0
3138,ACGTCGAATCTAGGGA,78,87,9,11,2049,1,0
3140,ACGTCGACTCTAGGGA,78,87,9,11,2051,1,0
3141,ACGTCGGATCTAGGGA,78,87,9,11,2052,1,0
3143,ACGTCGAATCTAGGGA,78,87,9,11,2055,1,0
3147,ACATCGAATCTAGGGA,78,87,9,11,2062,1,0
3148,ACGTCGAATCTAGGGA,78,87,9,11,2063,1,0
3155,ACGTCGACTCTAGGGA,78,87,9,11,2074,1,0
3157,ACGTCGAATCTAGGGA,78,87,9,11,2076,1,0
3165,ACGTCGAATCTAGGGA,78,87,9,11,2091,1,0
3168,AGGTCGGATCTAGGGA,78,87,9,11,2097,1,0
3171,ACGTCGAATCAGGGGA,78,87,9,11,2103,1,0
3174,ACGTCGAATCTAGGCA,78,87,9,11,2107,1,0
3176,ACGTCGAATCTAGGGA,78,87,9,14,2110,1,0
3178,ACGTCGAATCTAGGGA,78,87,9,11,2115,1,0
3181,ACGTCGAATCTAGGGA,78,87,9,11,2120,1,0
3186,ACGTCGGATCTAGGGA,78,87,9,11,2129,1,0
3187,ACGTCGACTCTAGGGA,78,87,9,11,2131,1,0
3190,ACGTCGAATCTAGGGA,78,87,9,11,2136,1,0
3192,ACGTCGAGTCTAGGGA,78,87,9,11,2138,1,0
3194,ACGTCGAATCTAGGGA,78,87,9,11,2143,1,0
3195,ACGTCGAATCTAGGGA,78,87,9,11,2144,1,0
3196,ACGTCGAATCTAGGGA,78,87,9,11,2145,1,0
3199,ACGTCGAATCTAGGGA,78,87,9,11,2150,1,0
3203,ACGTCGAATCTAGGGA,78,87,9,11,2156,1,0
3204,ACGTCGACTCTAGGGA,78,87,9,11,2157,1,0
3215,ACGTCGACTCTAGGGA,78,87,9,14,2180,1,0
3216,ACGTCGAATCTAGGGA,78,87,9,11,2181,1,0
3217,ACGTCGAATCAAGGGA,78,87,9,11,2183,1,0
3227,ACGTCGAATCAAGGGA,78,87,9,11,2200,1,0
3229,ACGTCGAATCTAGGGA,78,87,9,14,2203,1,0
3267,ACGTCGAATCTAGGGA,79,87,8,9,982,0,0
3285,ACGTCGACTCTAGGGA,79,87,8,12,1280,0,0
3289,ACGTCGAATCTAGGGA,79,87,8,12,1291,0,0
3316,ACCTCGACTCTAGGGA,79,87,8,12,1366,0,0
3323,ACGTCGAATCTAGGGA,79,87,8,9,1666,0,0
3325,ACGTCGACTCTAGGGA,79,87,8,9,1674,0,0
3351,ACGTCGAATCTACGGA,79,87,8,12,1721,0,0
3428,ACGTCGAATCTAGGGA,79,87,8,12,2246,0,0
3451,ACGTCGAATCTAGGGA,79,87,8,12,2281,0,0
3470,ACGTCGAATCTAGGGA,79,87,8,12,2310,0,0
3477,ACGTCGACTCTAGGGA,79,87,8,12,2319,0,0
3498,ACGTCGAATCTAGGGA,79,87,8,12,2357,0,0
3508,ACGTCGACTCTAGGGA,79,87,8,12,2370,0,0
3511,ACGTCGAATCTAGGGA,79,87,8,12,2374,0,0
3512,ACGTCGACTCTAGGGA,79,87,8,12,2375,0,0
3525,ACGTCGAATCTAGGGA,79,87,8,12,2396,0,0
3526,ACGTCGAATCTAGGGA,79,87,8,12,2397,0,0
3580,ACGTCGAATCTAGGGA,80,87,7,10,793,0,0
3588,ACGTCGAATCTCGGGA,80,87,7,10,1049,0,0
3608,ACGTCGAATCTAGGGG,80,87,7,10,1133,0,0
3614,ACGTCGAATCTAGGGA,80,87,7,10,1382,0,0
3640,ACGTCGACTCTAGGGA,80,87,7,10,1458,0,0
3674,ACGTCGAATCTAGGGA,80,87,7,10,1881,0,0
3677,ACGTCGAATCTAGGGA,80,87,7,10,1886,0,0
3695,ACGTCGAATCAAGGGA,80,87,7,10,1915,0,0
3711,ACGTCGACTCTAGGGA,80,87,7,10,1944,0,0
3745,ACGTCGAATCTCGGGA,80,87,7,13,1995,0,0
3781,ACGTCGAATCAAGGGA,80,87,7,10,2474,0,0
3789,ACGTCGAATCTAGGGA,80,87,7,10,2483,0,0
3801,ACGTCGAATCTAGGGA,80,87,7,13,2503,0,0
3805,ACGTCGAATCTAGGGA,80,87,7,10,2510,0,0
3810,ACGTCGAATCTAGGGA,80,87,7,13,2517,0,0
3812,ACGTCGAATCTAGGGA,80,87,7,13,2519,0,0
3842,ACGTCGAATCTAGGGA,80,87,7,10,2565,0,0
3860,ACGTCGAATCTAGGGA,80,87,7,13,2600,0,0
3861,ACGTCGAATCTAGGGA,80,87,7,13,2601,0,0
3869,ACGTCGAATCTAGGGA,80,87,7,13,2613,0,0
3892,ACGTCGAATCTCGGGA,80,87,7,13,2655,0,0
3893,ACGTCGACGCTAGGGA,80,87,7,13,2657,0,0
3898,ACGTCGAATCTAGGGA,80,87,7,13,2666,0,0
3903,ACGTCGAATCTAGGGA,81,87,6,8,106,0,0
3904,ACGTCGAATCTAGGGA,81,87,6,8,259,0,0
3906,ACGTCGAATCTAGGGA,81,87,6,8,361,0,0
3907,ACGTCGAATCTAGGGA,81,87,6,8,379,0,0
3909,ACGTCGAATCTAGGGA,81,87,6,11,512,0,0
3910,ACGTCGACTCTAGGGA,81,87,6,8,660,0,0
3912,ACGTCGAATCAAGGGA,81,87,6,8,663,0,0
3914,ACGTCGCATCTAGGGA,81,87,6,8,678,0,0
3915,ACGTCGAATCTAGGGA,81,87,6,11,685,0,0
4290,ACGTCGAATCTAGGGA,82,87,5,9,540,0,0
4292,ACGTCGAATCTAGGGA,82,87,5,9,553,0,0
4307,ACGTCGACTCTAGGGA,82,87,5,12,979,0,0
4308,ACGTCGAATCTAGGGA,82,87,5,12,981,0,0
4325,ACGTCGAATCTAGGGA,82,87,5,12,1292,0,0
4362,ACGTCGAATCTAAGGA,82,87,5,12,1719,0,0
4373,ACGTCGAATCTAGGGA,82,87,5,12,1761,0,0
4374,ACGTCGGATCTAGGGT,82,87,5,9,1763,0,0
4382,ACGTCGAATCTAGGGA,82,87,5,12,1791,0,0
4404,ACGTCGAATCAAGGGA,82,87,5,6,2204,0,0
4405,ACGTCGACTCTAGGGA,82,87,5,12,2211,0,0
4453,ACGTCGAATCTAGGGA,82,87,5,15,2326,0,0
4470,ACGTCGAATCTAGGGA,82,87,5,12,2365,0,0
4487,ACGTCGACTCTAGGGA,82,87,5,12,2407,0,0
4489,ACGTCGAATCTAGGGA,82,87,5,12,2414,0,0
4518,ACGTCGCATCTAGGGA,82,87,5,9,2957,0,0
4526,ACGTCGAATCTAGGGA,82,87,5,9,2968,0,0
4573,ACGTCGAATCTAGGGA,82,87,5,9,3039,0,0
4599,ACGTCGAATCTAGGGA,82,87,5,12,3076,0,0
4607,ACGTCGAATCTCGGGA,82,87,5,12,3087,0,0
4620,ACGTCGAATCTAGGGA,82,87,5,12,3110,0,0
4630,ACGTCGAATCAAGGGA,82,87,5,9,3126,0,0
4638,ACGTCGACTCTAGGGA,82,87,5,12,3140,0,0
4646,ACGTCGAATCTAGGGA,82,87,5,15,3158,0,0
4648,ACGTCGAATCTAGGGA,82,87,5,12,3163,0,0
4660,ACGTCGGATCTAGGGA,82,87,5,12,3186,0,0
4663,ACGTCGAATCTAGGGA,82,87,5,12,3190,0,0
4664,ACGTCGACTCTAGGGA,82,87,5,15,3191,0,0
4678,ACGGCGAATCTAGGGA,82,87,5,12,3210,0,0
4683,ACTTCGAATCAAGGGA,82,87,5,12,3217,0,0
4684,ACGTCGAATCAAGGGA,82,87,5,12,3219,0,0
4689,ACGTCGAATCTAGGGA,83,87,4,10,342,0,0
4712,ACGTCGAATCTCGGGA,83,87,4,10,1049,0,0
4714,ACGTCGAATCTAGGGA,83,87,4,10,1059,0,0
4719,ACGTCGACTCTAGGGA,83,87,4,13,1086,0,0
4724,ACGTCGACTCTAGGGA,83,87,4,10,1111,0,0
4731,ACGTCGAATCAAGGGA,83,87,4,7,1379,0,0
4752,ACGTCGAATCTAGGGA,83,87,4,10,1448,0,0
4787,ACGTCGAATCTAGGGA,84,87,3,11,1149,0,0
4794,ACGTGGACTCTAGGGA,84,87,3,11,1180,0,0
4795,ACGTCGACTCTAGGGA,84,87,3,11,1184,0,0
4809,ACGTCGAATCAAGGGA,84,87,3,11,1249,0,0
4814,ACGTCGAATCTAGGGA,84,87,3,11,1525,0,0
4819,ACGTCGAATCTAGGGA,84,87,3,11,1537,0,0
4822,ACGTCGAATCTAGGGA,84,87,3,11,1546,0,0
4837,ACGTCGACTCTAGGGA,84,87,3,11,1601,0,0
4841,ACGTCGACTCTAGGGA,84,87,3,11,1614,0,0
4858,ACGTCGACTCTAGGGA,85,87,2,9,534,0,0
4867,ACGTCGAATCAAGGGA,85,87,2,9,752,0,0
4888,ACGTCGAATCTAGGGA,85,87,2,9,1296,0,0
4898,ACGTCGAATCTCGGGA,85,87,2,12,1348,0,0
4905,ACGTCGAATCAAGGGA,85,87,2,9,1684,0,0
4920,ACGTCGAATCTAGGGA,86,87,1,10,342,0,0
4930,ACGTCGAATCTAGGGA,86,87,1,10,637,0,0
4946,ACGTCGAATCTAGGGA,86,87,1,10,1106,0,0
4949,ACGTCGAATCTAGGGA,86,87,1,10,1117,0,0
4951,ACGTCGAATCTAGGGA,86,87,1,10,1120,0,0
408,ACGTCGGATCTAGGGA,57,88,31,8,204,9,0
894,ACGTCGAATCTAGGGA,65,88,23,7,446,7,0
1037,ACGTCGACTCTAGGGA,67,88,21,6,50,6,0
1055,ACGTCGACTCTAGGGA,67,88,21,9,402,6,0
1111,ACGTCGACTCTAGGGA,67,88,21,9,737,6,0
1120,ACGTCGAATCTAGGGA,67,88,21,9,750,6,0
1237,ACGTCGAATCTAGGGA,68,88,20,10,825,6,0
1285,ACGTCGAATCTAGGGA,69,88,19,11,381,5,0
1296,ACGTCGAATCTAGGGA,69,88,19,8,655,5,0
1312,ACGTCGAGTCTAGGGA,69,88,19,11,693,5,0
1319,ACGTCGGATCTAGGGA,69,88,19,8,866,5,0
1386,ACGTCGACTCTAGGGA,70,88,18,9,386,5,0
1390,ACGTCGAATCTAGGGA,70,88,18,9,406,5,0
1495,ACGTCGAATCAAGGGA,70,88,18,9,1012,5,0
1562,ACGTCGAATCTAGGGA,71,88,17,10,781,5,0
1574,ACGTCGGATCTAGGGA,71,88,17,10,800,5,0
1605,ACGTAGGATCTAGGGA,71,88,17,10,1050,5,0
1613,ACGTCGAATCTAGGGA,71,88,17,13,1063,5,0
1694,ACGTCGAATCTAGGGA,72,88,16,8,675,4,0
1793,ACGTCGAATCTAGGGA,72,88,16,11,1200,4,0
1862,ACGTCGGATCTAGGGA,73,88,15,9,541,3,0
1883,ACGTCGAATCTAGGGA,73,88,15,9,735,2,0
1886,ACGTCGAATCTAGGGA,73,88,15,9,740,2,0
1940,ACGTCGGATCTAGGGA,73,88,15,9,1267,2,0
2047,ACGTCGACTCTAGGGA,74,88,14,10,790,2,0
2049,ACGTCGAATCTAGGGA,74,88,14,10,793,2,0
2050,ACGTCGAATCTAGGGA,74,88,14,10,796,2,0
2052,ACGTCGGATCTAGGGA,74,88,14,10,800,2,0
2053,ACGTCGACTCTAGGGA,74,88,14,10,804,2,0
2055,ACGTCGAATCTAGGGA,74,88,14,10,817,2,0
2056,ACGTCGAATCTAGGGA,74,88,14,10,820,2,0
2057,ACGTCGAATCTAGGGA,74,88,14,10,825,2,0
2058,ACGTCGAATCTAGGGA,74,88,14,10,826,2,0
2066,ACGTCGAATCTAGGGA,74,88,14,13,857,2,0
2067,ACGTCGAATCTAGGGA,74,88,14,10,858,2,0
2068,ACGTCGACTCTAGGGA,74,88,14,7,1037,2,0
2071,ACGTCGACTCTAGGGA,74,88,14,10,1046,2,0
2073,ACGTCGAATCTCGGGA,74,88,14,10,1049,2,0
2074,ACGTCGACTCTAGGGA,74,88,14,10,1051,2,0
2090,ACGTCGAATCAAGGGA,74,88,14,7,1091,2,0
2096,ACGTCGAATCTAGGGA,74,88,14,10,1109,2,0
2097,AGGTCGGATCTAGGGA,74,88,14,10,1110,2,0
2100,ACGTCGAATCTAGGGA,74,88,14,10,1114,2,0
2101,ACGTCGAATCTAGGGA,74,88,14,10,1117,2,0
2103,ACGTCGAATCAGGGGA,74,88,14,10,1119,2,0
2107,ACGTCGAATCTAGGCA,74,88,14,10,1127,2,0
2113,ACGTCGACTCTAGGGA,74,88,14,7,1376,2,0
2115,ACGTCGAATCTAGGGA,74,88,14,10,1381,2,0
2117,ACGTCGACTCTAGGGA,74,88,14,10,1383,2,0
2120,ACGTCGAATCTAGGGA,74,88,14,10,1388,2,0
2122,ACGTCGAATCTAGGGA,74,88,14,10,1390,2,0
2134,ACGTCGACTCTAGGGA,74,88,14,10,1411,2,0
2140,ACGTCGACTATAGGGA,74,88,14,13,1417,2,0
2144,ACGTCGAATCTAGGGA,74,88,14,10,1422,2,0
2145,ACGTCGAATCTAGGGA,74,88,14,10,1423,2,0
2146,ACGTCGACTCTAGGGA,74,88,14,10,1427,2,0
2150,ACGTCGAATCTAGGGA,74,88,14,10,1431,2,0
2151,ACGTCGAATCTAGGGA,74,88,14,10,1432,2,0
2153,ACGTCGAATCTAGGGA,74,88,14,10,1434,2,0
2156,ACGTCGAATCTAGGGA,74,88,14,10,1439,2,0
2168,ACGTCGACTCTAGGGA,74,88,14,10,1458,2,0
2169,ACGTCGAATCTAGGGA,74,88,14,10,1459,2,0
2170,ACGGCGAATCTAGGGA,74,88,14,10,1461,2,0
2173,ACGTCGAATCTAGGGA,74,88,14,10,1465,2,0
2178,ACGTCGAATCTAGGGA,74,88,14,10,1475,2,0
2183,ACGTCGAATCAAGGGA,74,88,14,10,1482,2,0
2186,ACGTCGAATCTAGGGA,74,88,14,10,1489,2,0
2189,ACGTCGAATCTGGGGA,74,88,14,10,1492,2,0
2192,ACGTCGAATCTAGGGA,74,88,14,13,1497,2,0
2200,ACGTCGAATCAAGGGA,74,88,14,10,1509,2,0
2202,ACGTCGAATCTAGGGA,74,88,14,13,1511,2,0
2527,ACGTCGAATCTAGGGA,76,88,12,12,1309,1,0
2541,ACGTCGAATCTAGGGA,76,88,12,12,1331,1,0
2631,ACGTCGAATCTCGGGA,76,88,12,12,1772,1,0
2690,ACGTCGGATCTAGGGA,77,88,11,10,475,1,0
2694,ACGTCGAATCTAGGGA,77,88,11,10,598,1,0
2711,ACGTCGACTCTAGGGA,77,88,11,10,838,1,0
2734,ACGTCGAATCTAGGGA,77,88,11,10,1087,1,0
2739,ACGTCGAATCTAGGGA,77,88,11,10,1106,1,0
2747,ACGTCGACTCTAGGGA,77,88,11,10,1123,1,0
2748,ACGTCGAATCTAGGCA,77,88,11,10,1127,1,0
2751,ACGTCGAATCTAGGGA,77,88,11,13,1135,1,0
2756,ACGTCGAATCTAGGGA,77,88,11,10,1382,1,0
2758,ACGTCGAATCTCGGGA,77,88,11,10,1385,1,0
2762,ACGTCGACTCTAGGGA,77,88,11,10,1396,1,0
2768,ACGTCGAATCTAGGGA,77,88,11,10,1409,1,0
2774,ACGTCGAATCTAGGGA,77,88,11,13,1418,1,0
2779,ACGTCGAATCTAGGGA,77,88,11,10,1431,1,0
2787,ACGTCGAATCAAGGGA,77,88,11,10,1446,1,0
2789,ACGTCGAATCTAGGGA,77,88,11,10,1451,1,0
2793,ACGTCGACTCTAGGGA,77,88,11,10,1458,1,0
2796,ACGTCGAATCTAGGGA,77,88,11,10,1463,1,0
2799,ACGTCGAATCAAGGGA,77,88,11,10,1466,1,0
2801,ACGTCGAATCTAGGGA,77,88,11,10,1476,1,0
2804,ACGTCGGATCTAGGGA,77,88,11,10,1484,1,0
2807,ACGTCGAATCTGGGGA,77,88,11,10,1492,1,0
2809,ACGTCGAATCTAGGGA,77,88,11,10,1500,1,0
2810,ACGTCGAATCTAGGGA,77,88,11,13,1504,1,0
2814,ACGTCGAGTCTAGGGA,77,88,11,13,1508,1,0
2816,ACGTCGAATCTAGGGA,77,88,11,10,1842,1,0
2817,ACGTCGAATCTAGGGA,77,88,11,10,1844,1,0
2820,ACGTCGACTCTAGGGA,77,88,11,10,1848,1,0
2821,ACGTCGAATCTAGGGA,77,88,11,10,1849,1,0
2823,ACGTCGAATCTAGGGA,77,88,11,10,1854,1,0
2824,ACGTCGAATCTAGGGA,77,88,11,10,1856,1,0
2827,ACGTCGACTCTAGGGA,77,88,11,10,1860,1,0
2828,ACGTCGGATCTAGGGA,77,88,11,10,1862,1,0
2832,ACGTCGAATCTAGGGA,77,88,11,10,1867,1,0
2838,ACGTCGAATCTAGGGA,77,88,11,10,1875,1,0
2842,ACGTCGACTCTAGGGA,77,88,11,10,1879,1,0
2843,ACGTCGAATCTAGGGA,77,88,11,10,1881,1,0
2846,ACGTCGACTCTAGGGA,77,88,11,10,1884,1,0
2851,ACGTCGAATCTAGGGA,77,88,11,10,1891,1,0
2854,ACGTCGAATCTAGGGA,77,88,11,13,1895,1,0
2856,ACGTCGAATCTAGGGA,77,88,11,10,1899,1,0
2857,ACGTCGACTCTAGGGA,77,88,11,10,1900,1,0
2864,ACGTCGACTCTAGGGA,77,88,11,13,1909,1,0
2865,ACGTCGAATCTAGGGA,77,88,11,10,1911,1,0
2867,ACGTCGAATCTAGGGA,77,88,11,10,1913,1,0
2870,ACGTCGACTCTAGGGA,77,88,11,10,1916,1,0
2871,ACGTCGAATCTAGGGA,77,88,11,10,1917,1,0
2873,ACGTCGAATCTAGGGA,77,88,11,10,1919,1,0
2874,ACGTCGAATCTAGGGA,77,88,11,10,1920,1,0
2876,ACGTCGACTCTAGGGA,77,88,11,10,1924,1,0
2877,ACGTCGAATCTAGGGA,77,88,11,13,1925,1,0
2881,ACGTCGAATCTAGGGA,77,88,11,10,1931,1,0
2882,ACGTCGAATCTAGGGA,77,88,11,13,1933,1,0
2884,ACGTCGAATCTAGGGA,77,88,11,13,1935,1,0
2887,ACGTCGAATCTAGGGA,77,88,11,10,1938,1,0
2888,AGGTCGGATCTAGGGA,77,88,11,10,1940,1,0
2889,ACGCCGACTCTAGGGA,77,88,11,10,1942,1,0
2893,ACGTCGACTCTAGGGA,77,88,11,13,1947,1,0
2894,ACGTCGAATCTAGGGA,77,88,11,13,1949,1,0
2897,ACATCGACTCTAGGGA,77,88,11,10,1952,1,0
2903,ACGTCGAATCTAGGGA,77,88,11,13,1958,1,0
2904,ACGTCGAATCTAGGGA,77,88,11,13,1959,1,0
2905,ACGTCGAATCTAGGGA,77,88,11,10,1961,1,0
2918,ACGTCGAATCTAGGGA,77,88,11,13,1981,1,0
2922,ACGTCGAATCTAGGGA,77,88,11,13,1987,1,0
2923,ACGTCGAATCTAAGGA,77,88,11,13,1988,1,0
2926,ACGTCGAATCTAGGGA,77,88,11,13,1991,1,0
2932,ACGTCGAATCTAGGGA,77,88,11,13,2000,1,0
2934,ACGTCGGATCTAGGGA,77,88,11,13,2003,1,0
2938,GCGTCGAATCTAGGGA,77,88,11,13,2007,1,0
3254,ACGTCGAATCAAGGGA,79,88,9,9,752,0,0
3287,ACGTCGACTCTAGGGA,79,88,9,9,1286,0,0
3336,ACGTCGCATCTAGGGA,79,88,9,9,1695,0,0
3381,ACGTCGAATCTAGGGA,79,88,9,12,1799,0,0
3386,ACGTCGAATCTAGGGA,79,88,9,12,1805,0,0
3394,ACGTCGAATCTAGGGA,79,88,9,12,1824,0,0
3420,ACGTCGAATCAAGGGA,79,88,9,9,2233,0,0
3463,ACGTCGAATCAAGGGA,79,88,9,12,2297,0,0
3480,ACGTGGAATCTAGGGA,79,88,9,12,2324,0,0
3548,ACGTCGAATCTAGGGA,79,88,9,12,2428,0,0
3581,ACGTCGAATCTAGGGA,80,88,8,10,796,0,0
3601,ACGTCGAATCTAGTGA,80,88,8,10,1108,0,0
3602,ACGTCGACTCTAGGGA,80,88,8,10,1111,0,0
3603,ACGTCGAATCTAGGGA,80,88,8,10,1114,0,0
3604,ACGTCGAATCTAGGGA,80,88,8,10,1117,0,0
3605,ACGTCGAATCAAGGGA,80,88,8,10,1119,0,0
3607,ACGTCGACTCTAGGGA,80,88,8,10,1123,0,0
3609,ACGTCGAATCTAGGGA,80,88,8,10,1134,0,0
3617,ACGTCGACTCTAGGGA,80,88,8,10,1389,0,0
3618,ACGTCGAATCTAGGGA,80,88,8,10,1390,0,0
3621,ACGTCGAATCTAGGGA,80,88,8,10,1401,0,0
3622,ACGTCGACTCTAGGGA,80,88,8,10,1405,0,0
3623,ACGTCGACTCTAGGGA,80,88,8,10,1407,0,0
3624,ACGTCGAATCTAGGGA,80,88,8,10,1409,0,0
3625,ACGTCGACTCTAGGGA,80,88,8,10,1411,0,0
3626,ACGTCGAATCTAGGGA,80,88,8,10,1415,0,0
3627,ACGTCGAATCTAGGGA,80,88,8,10,1416,0,0
3628,ACGTCGACTATAGGGA,80,88,8,13,1417,0,0
3630,ACGTCGAATCTAGGGA,80,88,8,10,1423,0,0
3632,ACGTCGAATCTAGGGA,80,88,8,10,1431,0,0
3636,ACGTCGAATCTAGGGA,80,88,8,10,1448,0,0
3637,ACGTCGAATCTAGGGA,80,88,8,10,1451,0,0
3638,ACGTCGAATCTAGGGA,80,88,8,13,1452,0,0
3641,ACGTCGAATCTAGGGA,80,88,8,10,1459,0,0
3646,ACGTCGAATCTAGGGA,80,88,8,10,1500,0,0
3649,ACGTGGACTCTAGGGA,80,88,8,13,1506,0,0
3650,ACGTCGAGTCTAGGGA,80,88,8,13,1508,0,0
3651,ACGTCGACTCTAGGGA,80,88,8,13,1510,0,0
3653,ACGTCGAATCTAGGGA,80,88,8,10,1844,0,0
3654,ACGTCGACTCTAGGGA,80,88,8,10,1845,0,0
3655,ACGTCGAATCTCGGGG,80,88,8,10,1846,0,0
3657,ACGTCGAATCTAGGGA,80,88,8,10,1849,0,0
3660,ACGTCGAATCTAGGGA,80,88,8,10,1856,0,0
3662,ACGTCGACTCTAGGGA,80,88,8,10,1860,0,0
3663,ACGTCGGATCTAGGGA,80,88,8,10,1862,0,0
3664,ACGTCGAATCTAGGGA,80,88,8,10,1864,0,0
3666,ACGTCGAATCTAGGGA,80,88,8,10,1866,0,0
3669,ACGTCGAATCTAGGGA,80,88,8,10,1870,0,0
3671,ACGTCGAATCTAGGGA,80,88,8,10,1875,0,0
3672,ACGTCGAATCTAGGGA,80,88,8,10,1876,0,0
3673,ACGTCGACTCTAGGGA,80,88,8,10,1879,0,0
3675,ACGTCGAATCTAGGGA,80,88,8,10,1883,0,0
3679,ACGTCGAATCAAGGGA,80,88,8,10,1889,0,0
3680,ACGTCGACTCTAGGGA,80,88,8,10,1890,0,0
3681,ACGTCGAATCTAGGCA,80,88,8,10,1892,0,0
3683,ACGTCGAATCTAGGGA,80,88,8,13,1895,0,0
3685,ACGTCGAATCTAGGGA,80,88,8,10,1899,0,0
3687,ACGTCGAATCTAGGGA,80,88,8,10,1901,0,0
3689,ACGTCGAATCTAGGGA,80,88,8,10,1904,0,0
3690,ACGTCGAATCTAGGGA,80,88,8,10,1905,0,0
3693,ACGTCGAATCTAGGGA,80,88,8,10,1911,0,0
3696,ACGTCGACTCTAGGGA,80,88,8,10,1916,0,0
3698,ACGTCGAATCTAGGGA,80,88,8,13,1918,0,0
3699,ACGTCGAATCTAGGGA,80,88,8,10,1922,0,0
3700,ACGTCGAATCTAGGGA,80,88,8,13,1925,0,0
3701,ACGTGGACTCTAGGGA,80,88,8,13,1929,0,0
3702,AGGTCGAATCTAGGGA,80,88,8,13,1930,0,0
3704,GCGTCGAATCTAGGGA,80,88,8,13,1934,0,0
3705,ACGTCGAATCTAGGGA,80,88,8,13,1935,0,0
3709,ACGTCGGATCTAGGGA,80,88,8,10,1940,0,0
3718,ACGTCGAATCAAGGGA,80,88,8,10,1954,0,0
3719,ACGTCGACTCTAGGGA,80,88,8,13,1955,0,0
3722,ACGTCGAATCTAGGGA,80,88,8,13,1958,0,0
3726,ACGTCGAATCAAGGGA,80,88,8,10,1965,0,0
3728,ACGTCGACTCTAGGGA,80,88,8,10,1967,0,0
3730,ACGTCGAATCTAGGGA,80,88,8,13,1969,0,0
3732,ACGTCGGATCTAGGGA,80,88,8,10,1977,0,0
3734,ACGTCGAATCTAGGGG,80,88,8,10,1979,0,0
3738,ACGTCGAATCTGGGGA,80,88,8,13,1984,0,0
3740,ACGTCGAATCTAGGGA,80,88,8,13,1987,0,0
3742,ACGTCGAATCTAGGGA,80,88,8,13,1990,0,0
3744,GCGTCGAATCTAGGGA,80,88,8,13,1994,0,0
3746,ACGTCGAATCTAGGGA,80,88,8,13,1998,0,0
3748,ACGTCGAATCTAGGGA,80,88,8,13,2001,0,0
3750,ACCTCGACTCTAGGGA,80,88,8,13,2004,0,0
3752,GCGTCGAATCTAGGGA,80,88,8,13,2007,0,0
3753,ACGTCGAATCTAGGGA,80,88,8,13,2009,0,0
3754,ACGTCGAATCTAGGGA,80,88,8,10,2440,0,0
3756,ACGTCGACTCTAGGGA,80,88,8,10,2442,0,0
3759,ACGTCGACTCTAGGGA,80,88,8,10,2445,0,0
3761,ACGTCGGATCTAGGGA,80,88,8,10,2447,0,0
3766,ACGTCGACTCTAGGGA,80,88,8,10,2453,0,0
3767,ACGTCGAATCTAGGGA,80,88,8,10,2454,0,0
3768,ACGTCGACTCTAGGGA,80,88,8,10,2455,0,0
3769,ACGTCGAATCTAGGGA,80,88,8,10,2456,0,0
3772,ACGTCGAATCTAGGGA,80,88,8,10,2460,0,0
3773,ACGTCGACTCTAGGGA,80,88,8,13,2462,0,0
3776,ACGTCGAATCTAGGGA,80,88,8,10,2465,0,0
3777,ACGTCGACTCTAGGGA,80,88,8,10,2466,0,0
3780,ACGTCGAATCAAGGGA,80,88,8,10,2473,0,0
3782,ACGTCGAATCTAGGGA,80,88,8,13,2475,0,0
3784,ACGTCGAATCTAGGGA,80,88,8,10,2477,0,0
3785,ACGTCGAATCAAGGGA,80,88,8,7,2478,0,0
3788,ACGTCGAATCTAGGGA,80,88,8,10,2482,0,0
3790,ACGTCGACTCTAGGGA,80,88,8,13,2485,0,0
3794,ACATCGAATCAAGGGA,80,88,8,10,2490,0,0
3797,ACGTCGAATCTAGGGA,80,88,8,10,2494,0,0
3798,ACGTCGACTCTAGGGA,80,88,8,10,2495,0,0
3800,ACGTCGAATCAAGGGA,80,88,8,10,2501,0,0
3807,ACGTCGACTCTAGGGA,80,88,8,13,2512,0,0
3808,ACGTCGAATCTAGGGA,80,88,8,10,2513,0,0
3813,ACGTCGAATCTAGGGA,80,88,8,10,2520,0,0
3814,ACGTCGAATCTAGGGA,80,88,8,10,2521,0,0
3815,ACGTCGAATCTAGGGA,80,88,8,10,2524,0,0
3817,ACATCGGATCTAGGGA,80,88,8,10,2526,0,0
3821,ACGTCGACTCTAGGGA,80,88,8,13,2530,0,0
3824,ACGTCGAATCTAGGGA,80,88,8,13,2537,0,0
3825,ACGTCGAATCTAGGGA,80,88,8,10,2538,0,0
3828,ACGTCGAATCTAGGGA,80,88,8,13,2541,0,0
3831,ACGTCGAATCTAGGGA,80,88,8,13,2546,0,0
3832,ACGTCGAATCTAGGGA,80,88,8,13,2547,0,0
3833,ACGTCGAATCTAGGGA,80,88,8,13,2548,0,0
3837,GCGTCGAATCTAGGGA,80,88,8,13,2555,0,0
3838,ACGTCGAATCTAGGGA,80,88,8,13,2556,0,0
3839,ACGTCGAATCAAGGGA,80,88,8,7,2557,0,0
3841,ACGTCGAATCTAGGGA,80,88,8,10,2561,0,0
3845,ACGTCGAATCTAGGGA,80,88,8,10,2570,0,0
3846,ACGTCGAATCAAGGGA,80,88,8,10,2571,0,0
3849,ACGTCGAATCTAGGGA,80,88,8,10,2579,0,0
3850,ACGTCGCATCTAGGGA,80,88,8,10,2580,0,0
3851,ACGTCGAATCTAGGGA,80,88,8,13,2582,0,0
3853,ACGTCGAATCTAGGGA,80,88,8,10,2587,0,0
3857,ACGTCGAAACTAGGGA,80,88,8,13,2595,0,0
3859,ACGTCGAATCAAGGGA,80,88,8,10,2598,0,0
3863,ACGTCGAATCTAGGGA,80,88,8,13,2604,0,0
3875,ACGTCGAATCTAGGGA,80,88,8,13,2625,0,0
3878,ACGTCGTATCTAGGGA,80,88,8,13,2628,0,0
3879,ACGTCGAATCTCGGGA,80,88,8,13,2631,0,0
3880,ACGTGGACTCTAGGGA,80,88,8,13,2634,0,0
3883,ACGTCGACTCTAGGGA,80,88,8,13,2641,0,0
3884,ACGTCGAATCTAGGGA,80,88,8,13,2642,0,0
3885,ACGTCGACTCTAGGGA,80,88,8,13,2643,0,0
3886,ACGTCGAATCTAGGGA,80,88,8,13,2644,0,0
3889,ACGTCGAATCAAGGGA,80,88,8,10,2652,0,0
3890,ACGTCGAATCTAGGGA,80,88,8,13,2653,0,0
3891,ACGTCGAATCAAGCGA,80,88,8,10,2654,0,0
3894,ACGTCGAATCTAGGGA,80,88,8,13,2659,0,0
3895,ACGTCGACTCTAGGGA,80,88,8,13,2661,0,0
3899,ACGTCGGATCTAGGGA,80,88,8,13,2669,0,0
3902,ACGTCGAGTCAAGGGA,80,88,8,13,2676,0,0
4306,ACGTCGAATCTAGGGA,82,88,6,9,976,0,0
4309,ACGTCGAATCTAGGGA,82,88,6,9,982,0,0
4310,ACATCGAATCAAGGGA,82,88,6,9,988,0,0
4312,ACGTCGAATCTAGGGA,82,88,6,12,1016,0,0
4314,ACATCGGATCTAGGGA,82,88,6,9,1024,0,0
4316,ACGTCGAATCAAGGGA,82,88,6,6,1260,0,0
4321,ACGTCGACTCTAGGGA,82,88,6,12,1280,0,0
4324,ACGTCGAATCTAGGGA,82,88,6,12,1291,0,0
4326,ACGTCGAATCTAGGGA,82,88,6,9,1295,0,0
4328,ACGTCGACTCTAGGGA,82,88,6,9,1299,0,0
4330,ACGTCGAGTCTAGGGA,82,88,6,12,1312,0,0
4331,ACGTCGAATCAAGGGA,82,88,6,9,1313,0,0
4334,ACGTCGAATCAAGGGA,82,88,6,9,1321,0,0
4335,ACGTCGAATCTAGGGA,82,88,6,12,1324,0,0
4336,ACGTCGAATCTAGGGA,82,88,6,9,1325,0,0
4338,ACGTCGAATCTCGGGA,82,88,6,12,1348,0,0
4341,ACGTCGAATCTAGGGA,82,88,6,12,1353,0,0
4342,ACCTCGACTCTAGGGA,82,88,6,12,1366,0,0
4344,ACGTCGAATCTAGGGA,82,88,6,9,1663,0,0
4345,ACGTCGAATCTAGGGA,82,88,6,9,1673,0,0
4346,ACGTCGACTCTAGGGA,82,88,6,9,1674,0,0
4349,ACGTCGAATCAAGGGA,82,88,6,9,1689,0,0
4350,ACGTCGAATCTAGGGA,82,88,6,9,1690,0,0
4352,ACGTCGAATCAAGGGA,82,88,6,9,1693,0,0
4354,ACGTCGCATCTAGGGA,82,88,6,9,1695,0,0
4355,ACATCGAATCTAGGGA,82,88,6,9,1696,0,0
4356,ACGTCGAATCTAGGGA,82,88,6,12,1697,0,0
4357,ACATCGGATCTAGGGA,82,88,6,9,1698,0,0
4360,ACGTCGAAACTAGGGA,82,88,6,12,1717,0,0
4363,ACGTCGAATCAAGGGA,82,88,6,9,1720,0,0
4364,ACGTCGAATCTACGGA,82,88,6,12,1721,0,0
4367,ACGTCGAATCTAAGGA,82,88,6,9,1731,0,0
4368,ACGTCGAATCTAGGGA,82,88,6,12,1734,0,0
4372,ACGTCGAATCTAGGGA,82,88,6,12,1757,0,0
4375,ACGTCGAATCTAGGGA,82,88,6,12,1766,0,0
4377,GCGTCGAATCTAGGGA,82,88,6,12,1770,0,0
4378,ACGTCGAATCTCGGGA,82,88,6,12,1772,0,0
4379,ACGTCGACTCTAGGGA,82,88,6,12,1781,0,0
4380,ACGTCGAATCTAGGGA,82,88,6,12,1782,0,0
4381,ACGTCGAATCTAGGGA,82,88,6,12,1784,0,0
4383,ACGTCGACTCTAGGGA,82,88,6,12,1792,0,0
4384,ACGTCGAATCTAGGGA,82,88,6,12,1793,0,0
4385,ACGTCGAATCTAGGGA,82,88,6,12,1796,0,0
4387,ACGTCGAATCTAGGGA,82,88,6,12,1799,0,0
4388,ACGTCGAATCTAGGGA,82,88,6,12,1801,0,0
4389,ACGTCGAATCTAGGGA,82,88,6,12,1802,0,0
4390,ACGTGGACTCTAGGGA,82,88,6,12,1803,0,0
4391,ACGTCGAATCAAGGGA,82,88,6,9,1804,0,0
4392,ACGTCGAATCTAGGGA,82,88,6,12,1805,0,0
4393,ACGTCGGATCTAGGGA,82,88,6,12,1812,0,0
4394,ACGTCGAATCTAGGGA,82,88,6,12,1815,0,0
4398,ACGTCGGATCTAGGGA,82,88,6,12,1829,0,0
4399,ACGTCGACTCTAGGGA,82,88,6,12,1830,0,0
4400,ACGTCGAATCTAGGGA,82,88,6,12,1834,0,0
4401,ACGTCGAATCTAGGGA,82,88,6,12,1838,0,0
4402,ACGTCGAATCAAGGGA,82,88,6,12,1839,0,0
4403,ACGTCGAATCTAGGGA,82,88,6,15,1840,0,0
4406,ACGTCGAATCTAGGGA,82,88,6,9,2212,0,0
4407,ACGTCGAATCTAGGGA,82,88,6,9,2214,0,0
4408,ACGTCGAATCTAGGGA,82,88,6,12,2216,0,0
4409,ACGTCGAATCTAGGGA,82,88,6,9,2218,0,0
4410,ACGTCGAATCTAGGGA,82,88,6,12,2222,0,0
4411,ACGTCGACTCTAGGGA,82,88,6,9,2224,0,0
4412,ACGTCGAATCTAGGGA,82,88,6,9,2225,0,0
4414,ACGTCGAATCTAGGGA,82,88,6,12,2230,0,0
4415,ACGTCGAATCTAGGGA,82,88,6,12,2231,0,0
4416,ACGTCGACTCTAGGGA,82,88,6,12,2234,0,0
4417,ACGTCGAATCCAGGGA,82,88,6,12,2236,0,0
4420,ACGTCGAATCTAGGGA,82,88,6,12,2246,0,0
4426,ACGTCGAATCTCGGGA,82,88,6,12,2255,0,0
4430,ACGTCGAATCTAGGGA,82,88,6,12,2259,0,0
4431,ACGTCGAATCTAGGGA,82,88,6,12,2260,0,0
4432,ACGTCGAATCTAGGGA,82,88,6,12,2263,0,0
4434,ACGTCGACTCTAGGGA,82,88,6,12,2269,0,0
4435,ACGTCGAATCAAGTGA,82,88,6,9,2270,0,0
4436,ACGTCGAATCAAGGGA,82,88,6,9,2275,0,0
4437,ACGTCGACTCTAGGGA,82,88,6,12,2276,0,0
4438,TCGTCGGATCTAGGGA,82,88,6,12,2285,0,0
4440,ACGTCGAATCTAGGGA,82,88,6,12,2289,0,0
4441,ACGTCGACTCTAGGGA,82,88,6,12,2293,0,0
4444,ACGTCGACTCTAGGGA,82,88,6,12,2305,0,0
4445,ACGTCGAATCTAGGGA,82,88,6,12,2306,0,0
4446,ACGTCGACTCTAGGGA,82,88,6,9,2307,0,0
4448,ACGTCGACTCTAGGGA,82,88,6,12,2312,0,0
4449,ACGTCGAATCTAGGGA,82,88,6,12,2313,0,0
4450,ACGTCGAATCAAGCGA,82,88,6,9,2314,0,0
4451,ACGTCGACTCTAGGGA,82,88,6,12,2319,0,0
4452,ACGTCGAATCTAGGGA,82,88,6,12,2321,0,0
4454,ACGTCGGATCTAGGGA,82,88,6,12,2332,0,0
4457,ACGTCGAATCTAGGGA,82,88,6,9,2347,0,0
4458,ACGTCGAATCTTGGGA,82,88,6,12,2348,0,0
4459,ACGTCGAATCTAGGGA,82,88,6,12,2350,0,0
4460,ACGTCGCATCTAGGGA,82,88,6,9,2352,0,0
4461,ACGTCGAATCTAGGGA,82,88,6,9,2353,0,0
4463,ACGTCGAATCTAGGGA,82,88,6,12,2357,0,0
4465,ACGTCGAATCTAGGGA,82,88,6,12,2359,0,0
4466,ACGTCGAATCTAGGGA,82,88,6,12,2360,0,0
4467,GCGTCGAATCTAGGGA,82,88,6,12,2361,0,0
4469,ACGTCGAATCTAGGGA,82,88,6,9,2363,0,0
4471,ACGTCGAATCTAGGGA,82,88,6,12,2367,0,0
4473,TCGTCGAATCTAGGGA,82,88,6,12,2373,0,0
4475,ACGTCGAATCTAGGGA,82,88,6,12,2384,0,0
4477,ACGTCGGATCTAGGGA,82,88,6,12,2386,0,0
4478,ACGTCGAATCTAGGGA,82,88,6,12,2387,0,0
4481,ACGTCGAATCTAGGGA,82,88,6,12,2391,0,0
4482,ACGTCGAATCTAGGGA,82,88,6,12,2396,0,0
4484,ACGTCGAATCTAGGGA,82,88,6,15,2399,0,0
4488,ATGTCGGATCTAGGGA,82,88,6,12,2409,0,0
4491,ACGTCGAATCAAGGGA,82,88,6,12,2417,0,0
4493,ACGTCGAATCTAGGGA,82,88,6,12,2420,0,0
4494,ACGTCGAATCTAGGGA,82,88,6,12,2422,0,0
4495,ACGTCGAATCTAGGGA,82,88,6,12,2423,0,0
4496,ACGTCGAATCTAGGGA,82,88,6,12,2424,0,0
4497,ACGTCGAATCTAGTGA,82,88,6,12,2425,0,0
4498,ACGTCGACTCTAGGGA,82,88,6,12,2427,0,0
4499,ACGTCGAATCTAGGGA,82,88,6,12,2428,0,0
4500,ACGTCGAATCAAGGGA,82,88,6,12,2430,0,0
4501,ACGTCGACTCTAGGGA,82,88,6,12,2432,0,0
4502,ACGTCGAATCTAGGCA,82,88,6,12,2434,0,0
4503,ACGTCGAATCTAGGGA,82,88,6,12,2439,0,0
4504,ACGTCGGATCTAGGGA,82,88,6,9,2942,0,0
4505,ACGTCGAATCTAGGGA,82,88,6,9,2943,0,0
4506,ACGTCGAATCTAGGGA,82,88,6,9,2944,0,0
4507,ACGTCGACTCTAGGGA,82,88,6,12,2945,0,0
4509,ACGTCGAATCTAGGGA,82,88,6,12,2947,0,0
4510,ACGTCGAATCTAGGGA,82,88,6,9,2948,0,0
4511,ACGTCGAATCTAGGGA,82,88,6,12,2949,0,0
4513,ACGTCGAATCTAGGGA,82,88,6,12,2951,0,0
4516,ACGTCGAATCTAGGGA,82,88,6,9,2954,0,0
4517,ACGTCGAATCTAGGGA,82,88,6,9,2956,0,0
4520,ACGTCGAATCTAGGGA,82,88,6,12,2959,0,0
4522,ACGTCGAATCTAGGGA,82,88,6,12,2963,0,0
4523,ACGTCGGACCTAGGGA,82,88,6,9,2964,0,0
4524,ACGTCGAATGTAGGGA,82,88,6,9,2966,0,0
4527,ACGTCGAATCTAGGGA,82,88,6,12,2969,0,0
4529,ACGTCGAATCTAAGGA,82,88,6,12,2973,0,0
4531,ACGTCGAATCTAGGGA,82,88,6,12,2975,0,0
4533,ACGTCGAATCTCGGGA,82,88,6,12,2977,0,0
4535,GCGTCGAATCTAGGGA,82,88,6,12,2985,0,0
4537,ACGTCGACTCTACGGA,82,88,6,12,2987,0,0
4538,ACGTCGAATCAAGGGA,82,88,6,9,2988,0,0
4539,ACGTCGAATCTAGGGA,82,88,6,12,2989,0,0
4542,ACGTCGAATCTAGGGA,82,88,6,12,2992,0,0
4544,ACGTCGACTCTAGGGA,82,88,6,12,2994,0,0
4545,ACGTCGAATCTAGGGA,82,88,6,12,2996,0,0
4546,ACGTCGAATCTAGGGA,82,88,6,12,2997,0,0
4548,AAGTCCGATCTAGGGA,82,88,6,9,3001,0,0
4549,ACGTCGAATCTAGGGA,82,88,6,12,3003,0,0
4559,ACGTCGAATCAAGGGA,82,88,6,9,3017,0,0
4561,ACGTCGACTCTAGGGA,82,88,6,12,3021,0,0
4563,ACGTCGAATCTAGGGA,82,88,6,12,3023,0,0
4565,ACGTCGAATCTAGGGA,82,88,6,12,3026,0,0
4568,ACGTCGACTCTAGGGA,82,88,6,12,3030,0,0
4569,ACGTCGAATCTAGGGA,82,88,6,12,3031,0,0
4570,ACGTCGACTCTAGGGA,82,88,6,12,3033,0,0
4571,ACGTCGAATCAAGGGA,82,88,6,12,3035,0,0
4572,ACGTCGAATCAAGGGA,82,88,6,12,3038,0,0
4574,ACGTCGAATCTAGGGA,82,88,6,12,3040,0,0
4575,ACGTCGAATCTAGGGA,82,88,6,9,3041,0,0
4579,ACGTCGCATCTAGGGA,82,88,6,9,3047,0,0
4581,ACGTCGAATCTAGGGA,82,88,6,12,3051,0,0
4582,ACGTCGACTCTAGGGA,82,88,6,12,3053,0,0
4583,ACGTCGAATCTAGGGA,82,88,6,12,3055,0,0
4584,GCGTCGAATCTAGGGA,82,88,6,12,3056,0,0
4587,ACGTCGAATCTAGGGA,82,88,6,12,3060,0,0
4591,ACGTCGAATCTAGGGA,82,88,6,12,3064,0,0
4592,TCGTCGAATCTAGGGA,82,88,6,12,3065,0,0
4593,ACGTCGAATCTAGGGA,82,88,6,12,3067,0,0
4594,ACGTGGACTCTAGGGA,82,88,6,12,3068,0,0
4597,ACGTCGGATCTAGGGA,82,88,6,12,3072,0,0
4598,ACGTCGAATCTAGGGA,82,88,6,12,3073,0,0
4600,ACGTCGACTCTAGGGA,82,88,6,12,3077,0,0
4601,ACGTCGAATCTAGGGA,82,88,6,12,3079,0,0
4604,ACGTCGACTCTAGGGA,82,88,6,9,3083,0,0
4605,ACGTCGAATCAAGGGA,82,88,6,9,3084,0,0
4606,ACGTCGACTCTAGGGA,82,88,6,12,3085,0,0
4608,ACGTAGGATCTAGGGA,82,88,6,12,3088,0,0
4609,ACGTCGACTCTAGGGA,82,88,6,12,3089,0,0
4610,ACGTCGGATCTAGGGA,82,88,6,12,3090,0,0
4611,ACGTCGACTCTAGGGA,82,88,6,12,3092,0,0
4612,ACGACGAATCTAGGGA,82,88,6,12,3093,0,0
4613,ACGTCGAATCTAGGGA,82,88,6,12,3097,0,0
4614,ACGTCGAATCTAGGGA,82,88,6,12,3100,0,0
4616,ACGTCGAATCTAGGGA,82,88,6,12,3103,0,0
4617,ACGTCGAATCAAGGGA,82,88,6,12,3105,0,0
4618,ACGTCGACTCTAGGGA,82,88,6,12,3106,0,0
4619,ACGTCGAATCTAGGCA,82,88,6,12,3108,0,0
4621,ACGTCGGATCTAGGGA,82,88,6,9,3113,0,0
4622,ACGTCGAATCAAGGGA,82,88,6,9,3114,0,0
4624,ACGTCGAATCAAAGGA,82,88,6,9,3118,0,0
4625,ACGTCGAATCTAGGGA,82,88,6,12,3119,0,0
4626,ACGTCGCATCTAGGGA,82,88,6,9,3120,0,0
4629,AAGTCGGATCTAGGGA,82,88,6,9,3124,0,0
4632,ACGTCGAATCTAGGGA,82,88,6,12,3128,0,0
4633,ACGTCGAATCTAGGGA,82,88,6,12,3130,0,0
4634,ACGTCGACTCTAGGGA,82,88,6,9,3131,0,0
4635,ACGTCGAATCTAGGGA,82,88,6,12,3133,0,0
4637,ACGTCGAATCTAGGGA,82,88,6,12,3138,0,0
4641,ACATCGAATCTAGGGA,82,88,6,12,3147,0,0
4643,ACGTCGAATCTCGGGA,82,88,6,12,3154,0,0
4645,ACGTCGAATCTAGGGA,82,88,6,12,3157,0,0
4647,ACGTCGAATCTAGGGA,82,88,6,12,3160,0,0
4651,ACGGCGAATCTAGGGA,82,88,6,12,3170,0,0
4653,ACGTCGACTCTAGGGA,82,88,6,12,3173,0,0
4654,ACGTCGAATCTAGGCA,82,88,6,12,3174,0,0
4655,ACGTCGAATCTAGGGA,82,88,6,15,3176,0,0
4656,ACGTCGACTCTAGGGA,82,88,6,9,3177,0,0
4657,ACGTCGAATCTAGGGA,82,88,6,12,3178,0,0
4662,ACGTCGACTCTAGGGA,82,88,6,12,3189,0,0
4665,ACGTCGAGTCTAGGGA,82,88,6,12,3192,0,0
4666,ACGTCGAATCTAGGGA,82,88,6,12,3194,0,0
4667,ACGTCGAATCTAGGGA,82,88,6,12,3195,0,0
4668,ACGTCGAATCTAGGGA,82,88,6,12,3196,0,0
4669,ACGTCGAATCTAGGGA,82,88,6,12,3199,0,0
4670,ACGTCGAATCTAGGGA,82,88,6,12,3200,0,0
4671,ACGTCGAATCTAGGGA,82,88,6,12,3201,0,0
4673,ACGTCGACTCTAGGGA,82,88,6,12,3204,0,0
4674,ACGTCGAATCTAGGGA,82,88,6,12,3205,0,0
4675,ACGTCGAATCAAGGGA,82,88,6,12,3206,0,0
4676,ACGTCGACTCTAGGGA,82,88,6,12,3208,0,0
4677,ACGTCGAATCTAGGGA,82,88,6,12,3209,0,0
4680,ACGTCGAATCTAGGGA,82,88,6,12,3212,0,0
4682,ACGTCGAATCTAGGGA,82,88,6,12,3216,0,0
4685,ACGTGGACTCTAGGGA,82,88,6,15,3225,0,0
4686,ACGTCGAATCAAGGGA,82,88,6,12,3227,0,0
4687,ACGTCGCATCTAGGGA,82,88,6,15,3229,0,0
4695,ACGTCGACTCTAGGGA,83,88,5,10,466,0,0
4702,ACGTCGACTCTAGGGA,83,88,5,7,778,0,0
4722,ACGTCGAATCTAGGGA,83,88,5,10,1106,0,0
4736,ACGTCGAATCTAGGGA,83,88,5,10,1390,0,0
4742,ACGTCGAATCTAGGGA,83,88,5,10,1415,0,0
4760,ACGTCGAATCTAGGGA,83,88,5,10,1505,0,0
4768,ACGTCGAATCTAGGGA,84,88,4,8,491,0,0
4772,ACGTCGATTCTAGGGA,84,88,4,8,675,0,0
4774,ACGTCGAATCAAGGGA,84,88,4,8,870,0,0
4775,ACGTCGAATCTAGGGA,84,88,4,11,873,0,0
4776,GCGTCGAATCTAGGGA,84,88,4,8,879,0,0
4777,ACGTCGAATCTAGGGA,84,88,4,11,880,0,0
4778,ACGTCGAATCTAGGGA,84,88,4,11,883,0,0
4779,ACGTCGAATCTAGGGA,84,88,4,8,894,0,0
4780,ACGTCGAATCTCGGGA,84,88,4,11,906,0,0
4781,AAGTCGGATCTAGGGA,84,88,4,8,911,0,0
4782,ACGTCGAATCTAGGGA,84,88,4,11,913,0,0
4783,ACGTCGAATCTAGGGA,84,88,4,11,914,0,0
4785,ACGTCGAATCTAGGGA,84,88,4,11,925,0,0
4789,ACGTCGAATCTAGGGA,84,88,4,11,1158,0,0
4790,ACGTCGAATCTAGGGA,84,88,4,11,1167,0,0
4791,ACGTCGAATCTAGGGA,84,88,4,11,1169,0,0
4792,ACGTCGACTCTAGGGA,84,88,4,8,1173,0,0
4793,ACGTCGAATCTAGGGA,84,88,4,11,1176,0,0
4796,ACGTCGAATCTAGGGA,84,88,4,11,1187,0,0
4799,ACGTCGACTCTAGGGA,84,88,4,11,1199,0,0
4800,ACGTCGAATCAAGGGA,84,88,4,8,1208,0,0
4801,ACGTCGAATCTAGGGA,84,88,4,11,1209,0,0
4803,ACGTCGAATCTAGGGA,84,88,4,11,1230,0,0
4804,ACGTCGAATCTAGGGA,84,88,4,11,1233,0,0
4805,ACGTCGAATCTAGGGA,84,88,4,11,1237,0,0
4806,ACGTCGAATCTAGGGA,84,88,4,11,1242,0,0
4807,ACGTCGACTCTAGGGA,84,88,4,11,1245,0,0
4808,ACATCGAATCTAGGGA,84,88,4,11,1247,0,0
4811,ACGTCGAATCTAGGGA,84,88,4,8,1514,0,0
4812,ACGTCGAATCTAGGGA,84,88,4,11,1521,0,0
4813,ACGTCGAATCAAGGGA,84,88,4,8,1524,0,0
4815,ACGTCGCATCTAGGGA,84,88,4,8,1527,0,0
4816,ACGTCGAATCTAGGGA,84,88,4,11,1530,0,0
4817,ACGTCGAATCTAGGGA,84,88,4,11,1534,0,0
4818,ACGTCGACTCTAGGGA,84,88,4,11,1535,0,0
4820,GCGTCGAATCTAGGGA,84,88,4,11,1538,0,0
4821,ACGTCGAATCTAGGGA,84,88,4,11,1543,0,0
4823,ACGTCGAATCAAGGGA,84,88,4,8,1547,0,0
4824,ACGTCGAATCTAGGGA,84,88,4,11,1550,0,0
4825,TCGTCGAATCTAGGGA,84,88,4,11,1552,0,0
4826,ACGTCGAATCTAGGGA,84,88,4,11,1562,0,0
4827,ACGTCGAATCTAGGGA,84,88,4,11,1564,0,0
4828,ACGTGGACTCTAGGGA,84,88,4,11,1565,0,0
4829,ACGTCGAATCTAGGGA,84,88,4,11,1571,0,0
4830,ACGTCGAATCTAGGGA,84,88,4,11,1572,0,0
4831,ACGTCGGATCTAGGGA,84,88,4,11,1574,0,0
4832,ACGTCGAATCTAGGGA,84,88,4,11,1585,0,0
4833,ACGTCGAATCTAGGGA,84,88,4,11,1591,0,0
4834,ACGTCGAATCTAGGGA,84,88,4,14,1595,0,0
4838,ACGTCGAATCTAGGGA,84,88,4,11,1603,0,0
4840,ACGTCGAATCTAGGGA,84,88,4,14,1613,0,0
4842,ACGTCGAATCTAGGGA,84,88,4,11,1618,0,0
4843,ACGTCGAATCAAGGGA,84,88,4,11,1622,0,0
4844,ACGTCGAATCTAGGGA,84,88,4,11,1624,0,0
4845,ACGTCGAATCTAGGGA,84,88,4,11,1629,0,0
4846,ACGTCGAATCTAGGGA,84,88,4,11,1631,0,0
4847,ACGTCGAATCTAGGGA,84,88,4,11,1634,0,0
4848,ACGTCGAATCTAGGGA,84,88,4,11,1639,0,0
4849,ACGTCGAATCTAGGGA,84,88,4,11,1643,0,0
4850,ACGTCGAATCAAGGGA,84,88,4,11,1647,0,0
4852,ACGTCGAATCTAGGGA,84,88,4,11,1656,0,0
4854,ACGTCGGATCTAGGGA,85,88,3,9,408,0,0
4863,ACGTCGACTCTAGGGA,85,88,3,12,568,0,0
4864,ACGTCGAATCTAGGGA,85,88,3,9,715,0,0
4868,ACGTCGAATCAAGGGA,85,88,3,9,759,0,0
4887,ACGTCGAATCTAGGGA,85,88,3,12,1292,0,0
4893,ACGTCGGATCTAGGGA,85,88,3,9,1319,0,0
4908,ACGTCGAATCAAGGGA,85,88,3,9,1693,0,0
4910,ACGTCGCATCTAGGGA,85,88,3,9,1695,0,0
4922,ACGTCGAATCTAGGGA,86,88,2,10,347,0,0
4929,ACGTCGACTCTAGGGA,86,88,2,10,634,0,0
4968,ACGTCGAATCTAGGGA,86,88,2,10,1448,0,0
4974,ACGTGGACTCTAGGGA,86,88,2,13,1506,0,0
4977,ACGTCGAATCTAGGGA,87,88,1,8,259,0,0
4999,ACGTCGAATCTAGGGA,87,88,1,11,1158,0,0
5017,GCGTCGAATCTAGGGA,87,88,1,11,1538,0,0
5040,ACGTCGAATCAAGGGA,87,88,1,11,1647,0,0
5046,ACGTCGAATCTAGGGA,87,88,1,12,1735,0,0
5048,ACGTCGGATCTAGGGA,87,88,1,9,1763,0,0
5050,ACGTCGACTCTAGGGA,87,88,1,12,1781,0,0
5054,ACGTCGAATCTAGGGA,87,88,1,12,1796,0,0
5056,ACGTCGAATCTAGGGA,87,88,1,12,1802,0,0
534,ACGTCGACTCTAGGGA,60,89,29,8,187,9,0
583,AAGTCGGATCTAGGGA,61,89,28,6,113,8,0
634,ACGTCGACTCTAGGGA,61,89,28,9,413,8,0
879,ACGTCGAATCTAGGGA,65,89,24,7,337,7,0
1059,ACGTCGAATCTAGGGA,67,89,22,9,414,6,0
1265,ACGTCGAATCTAGGGA,69,89,20,8,193,6,0
1352,ACGTCGAATCTAGGGA,69,89,20,11,913,6,0
1504,ACGTCGAATCTAGGGA,70,89,19,12,1025,5,0
1550,ACGTCGAATCTAGGGA,71,89,18,10,604,5,0
1634,ACGTCGAATCTAGGGA,71,89,18,10,1096,5,0
1766,ACGTCGAATCTAGGGA,72,89,17,11,1163,4,0
1845,ACGTCGACTCTAGGGA,73,89,16,9,302,3,0
1870,ACGTCGAATCTAGGGA,73,89,16,9,564,3,0
1901,ACGTCGAATCTAGGGA,73,89,16,9,959,2,0
1950,ACGTCGAATCTAGGGA,73,89,16,9,1284,2,0
1956,ACGTCGACTCTAGGGA,73,89,16,9,1290,2,0
1965,ACGTCGAATCAAGGGA,73,89,16,9,1301,2,0
1967,ACGTCGACTCTAGGGA,73,89,16,9,1303,2,0
2036,ACGTCGAATCTAGGGA,74,89,15,10,603,2,0
2039,ACGTCGAATCTAGGGA,74,89,15,10,626,2,0
2445,ACGTCGACTCTAGGGA,76,89,13,9,390,1,0
2473,ACGTCGAATCAAGGGA,76,89,13,9,759,1,0
2476,ACGTCGAATCTAGGGA,76,89,13,9,766,1,0
2538,ACGTCGAATCTAGGGA,76,89,13,9,1325,1,0
2553,ACGTCGAATCTAGGGA,76,89,13,12,1367,1,0
2634,ACGTGGACTCTAGGGA,76,89,13,12,1780,1,0
2666,ACGTCGAATCTAGGGA,76,89,13,12,1824,1,0
2719,ACGTCGAATCTAGGGA,77,89,12,10,1048,1,0
3244,ACGTCGAATCTAGGGA,79,89,10,9,553,0,0
3268,ACGTCGAATCTAGGGA,79,89,10,12,985,0,0
3296,ACGTCGAATCTAGGGA,79,89,10,12,1309,0,0
3309,ACGTCGAATCTAGGGA,79,89,10,12,1343,0,0
3310,ACGTCGAATCTCGGGA,79,89,10,12,1348,0,0
3314,ACGTCGAATCTAGGGA,79,89,10,12,1353,0,0
3319,GCGTCGAATCTAGGGA,79,89,10,12,1369,0,0
3343,ACGTCGAATCTAGGGA,79,89,10,12,1710,0,0
3393,ACGTCGACTCTAGGGA,79,89,10,12,1820,0,0
3399,ACGTCGAATCTAGGGA,79,89,10,12,1834,0,0
3403,ACGTCGAATCAAGGGA,79,89,10,6,2204,0,0
3408,ACGTCGAATCTAGGGA,79,89,10,9,2214,0,0
3426,ACGTCGACTCTAGGGA,79,89,10,9,2242,0,0
3446,ACGTCGACTCTAGGGA,79,89,10,12,2269,0,0
3562,ACGTCGAATTAAGGGA,80,89,9,7,343,0,0
3598,ACGTCGAATCAAGGGA,80,89,9,7,1091,0,0
4690,ACGTCGAATCAAGGGA,83,89,6,7,343,0,0
4697,AAGTCGGATCTAGGGA,83,89,6,7,583,0,0
4699,ACGTCGAATCTAGGGA,83,89,6,10,597,0,0
4704,ACGTCGACTCTAGGGA,83,89,6,10,790,0,0
4725,ACGTCGAATCTAGGGA,83,89,6,10,1117,0,0
4726,ACGTCGAATCAAGGGA,83,89,6,10,1119,0,0
4728,ACGTCGACTCTAGGGA,83,89,6,10,1123,0,0
4745,ACGTCGAATCTAGGGA,83,89,6,13,1418,0,0
4773,ACGTCGAATCTAGGGA,84,89,5,11,685,0,0
4855,ACGTCGAATCTAGGGA,85,89,4,9,424,0,0
4891,ACGTCGAGTCTAGGGA,85,89,4,12,1312,0,0
4901,ACGTCGAATCTAGGGA,85,89,4,9,1663,0,0
4923,ACGTCGAATCTAGGGA,86,89,3,7,438,0,0
4936,ACGTCGACTCTAGTGA,86,89,3,10,850,0,0
4938,ACGTCGAATCTCGGGA,86,89,3,10,1049,0,0
4963,ACGTCGACTATAGGGA,86,89,3,13,1417,0,0
4965,ACGTCGAATCTAGGGA,86,89,3,10,1431,0,0
4980,ACGTCGAATCTAGGGA,87,89,2,8,379,0,0
4987,ACGTCGAATCTAGGGA,87,89,2,11,873,0,0
5014,ACGTCGAATCAAGGGA,87,89,2,11,1258,0,0
5020,ACGTCGAATCTAGGGA,87,89,2,11,1550,0,0
5022,ACGTGGACTCTAGGGA,87,89,2,11,1565,0,0
5029,ACGTCGACTCTAGGGA,87,89,2,11,1601,0,0
5037,ACGTCGAATCTAGGGA,87,89,2,11,1634,0,0
5049,TCGTCGAATCTAGGGA,87,89,2,12,1766,0,0
5059,ACGTCGAATCTCGGGG,87,89,2,10,1846,0,0
5076,ACGTCGAATCTAGGGA,88,89,1,9,546,0,0
5079,ACGTCGAATCTAGGGA,88,89,1,9,735,0,0
5091,ACGTCGAATCTAGGGA,88,89,1,9,1265,0,0
5107,ACGTCGAATCTAGGGA,88,89,1,9,1663,0,0
5112,ACGTCGAATCAAGGGA,88,89,1,9,1689,0,0
564,ACGTCGAATCTAGGGA,60,90,30,8,362,9,0
568,ACGTCGACTCTAGGGA,60,90,30,11,367,9,0
637,ACGTCGAATCTAGGGA,61,90,29,9,416,9,0
913,ACGTCGAATCTAGGGA,65,90,25,10,586,7,0
925,ACGTCGAATCTAGGGA,65,90,25,10,604,7,0
1023,ACGTCGAATCTAGGGA,66,90,24,11,682,7,0
1180,ACGTGGACTCTAGGGA,68,90,22,10,591,6,0
1280,ACGTCGACTCTAGGGA,69,90,21,11,368,6,0
1299,ACGTCGACTCTAGGGA,69,90,21,8,660,6,0
1348,ACGTCGAATCTCGGGA,69,90,21,11,906,6,0
1438,ACGTCGAATCAAGGGA,70,90,20,9,747,6,0
1480,ACATCGAATCAAGGGA,70,90,20,9,988,6,0
1622,ACGTCGAATCAAGGGA,71,90,19,10,1080,5,0
1647,ACGTCGAATCAAGGGA,71,90,19,10,1119,5,0
1892,ACGTCGAATCTAGGCA,73,90,17,9,758,3,0
1961,ACGTCGAATCTAGGGA,73,90,17,9,1296,3,0
2004,ACCTCGACTCTAGGGA,73,90,17,12,1366,2,0
2474,ACGTCGAATCAAGGGA,76,90,14,9,760,1,0
2477,ACGTCGAATCTAGGGA,76,90,14,9,774,1,0
2482,ACGTCGAATCTAGGGA,76,90,14,9,968,1,0
2580,ACGTCGCATCTAGGGA,76,90,14,9,1695,1,0
2601,ACGTCGAATCTAGGGA,76,90,14,12,1724,1,0
2659,ACGTCGAATCTAGGGA,76,90,14,12,1815,1,0
2689,ACGTCGACTCTAGGGA,77,90,13,10,466,1,0
3230,ACGTCGAATCTAGGGA,79,90,11,9,122,0,0
3249,ACGTCGAATCTAGGGA,79,90,11,9,735,0,0
3272,ACGTCGAATCTAGGGA,79,90,11,9,999,0,0
3275,ACGTCGAATCTAGGGA,79,90,11,12,1016,0,0
3384,ACGTGGACTCTAGGGA,79,90,11,12,1803,0,0
3388,ACGTCGGATCTAGGGA,79,90,11,12,1812,0,0
3404,ACGTCGAATCTAGGGA,79,90,11,9,2205,0,0
3434,ACGTCGAATCTAGGGA,79,90,11,12,2252,0,0
3464,ACGTCGACTCTAGGGA,79,90,11,12,2298,0,0
3484,ACGTCGGATCTAGGGA,79,90,11,12,2332,0,0
3497,ACGTCGAATCTAGGGA,79,90,11,12,2355,0,0
3557,TCGTCGAATCTAAGGA,79,90,11,15,2438,0,0
3569,ACGTCGGATCTAGGGA,80,90,10,10,475,0,0
4693,ACGTCGAATCTAGGGA,83,90,7,10,440,0,0
4738,ACGTCGAATCTAGGGA,83,90,7,10,1400,0,0
4747,ACGTCGACTCTAGGGA,83,90,7,13,1430,0,0
4754,ACGTCGACTCTAGGGA,83,90,7,10,1458,0,0
4755,ACGTCGAATCTAGGGA,83,90,7,10,1459,0,0
4853,ACGTCGACTCTAGGGA,85,90,5,9,386,0,0
4902,ACGTCGAATCTAGGGA,85,90,5,9,1673,0,0
4907,ACGTCGACTCTAGGGA,85,90,5,9,1691,0,0
4931,ACGTCGACTCTAGGGA,86,90,4,7,778,0,0
4957,ACGTCGAATCTAGGGA,86,90,4,10,1390,0,0
4960,ACGTCGAATCTAGGGA,86,90,4,10,1409,0,0
4969,ACGTCGACTCTAGGGA,86,90,4,10,1458,0,0
4979,ACGTCGAATCTAGGGA,87,90,3,8,361,0,0
4995,ACGTCGAATCAAGGGA,87,90,3,8,922,0,0
4997,ACGTCGACTCTAGGGA,87,90,3,11,1143,0,0
5010,ACGTCGAATCTAGGGA,87,90,3,11,1233,0,0
5042,ACTTCGAATCTAGGGA,87,90,3,11,1656,0,0
5045,ACGTCGCATCTAAGGA,87,90,3,9,1731,0,0
5069,ACGTCGAATCTAGGGA,87,90,3,10,1875,0,0
5118,ACGTCGAATCAAGGGA,88,90,2,9,1720,0,0
5119,ACGTCGAATCTAGGGA,89,90,1,7,318,0,0
5131,ACGTCGACTCTAGGGA,89,90,1,10,850,0,0
5146,ACGTCGAATCTAGGGA,89,90,1,10,1409,0,0
5149,ACGTCGACTATAGGGA,89,90,1,13,1417,0,0
5160,ACGTCGAATCTAGGGA,89,90,1,12,1825,0,0
5161,ACGTCGGATCTAGGGA,89,90,1,12,1829,0,0
5168,ACGTCGAATCTAGGGA,89,90,1,13,1895,0,0
5174,AGGTCGAATCTAGGGA,89,90,1,13,1930,0,0
5175,GCGTCGAATCTAGGGA,89,90,1,13,1934,0,0
466,ACGTCGACTCTAGGGA,58,91,33,9,300,10,0
546,ACGTCGAATCTAGGGA,60,91,31,8,261,9,0
976,ACGTCGAATCTAGGGA,66,91,25,8,362,7,0
1158,ACGTCGAATCTAGGGA,68,91,23,10,441,7,0
1328,ACGTCGAATCTAGGGA,69,91,22,8,879,6,0
1376,ACGTCGACTCTAGGGA,70,91,21,6,50,6,0
1431,ACGTCGAATCTAGGGA,70,91,21,9,733,6,0
1629,ACGTCGAATCTAGGGA,71,91,20,10,1088,6,0
1631,ACGTCGAATCTAGGGA,71,91,20,10,1093,6,0
1691,ACGTCGACTCTAGGGA,72,91,19,8,660,5,0
1693,ACGTCGAATCAAGGGA,72,91,19,8,663,5,0
1866,ACGTCGAATCTAGGGA,73,91,18,9,548,4,0
1876,ACGTCGAATCTAGGGA,73,91,18,9,709,4,0
1934,GCGTCGAATCTAGGGA,73,91,18,12,1033,3,0
1966,ACGTCGAATCTAGGGA,73,91,18,9,1302,3,0
2019,ACGTCGAATCTAGGGA,74,91,17,10,345,2,0
2027,ACGTCGAATCTAGGGA,74,91,17,10,463,2,0
2529,ACGTCGAATCAAGGGA,76,91,15,9,1313,1,0
2548,ACGTCGAATCTAGGGA,76,91,15,12,1356,1,0
2565,ACGTCGAATCTAGGGA,76,91,15,9,1673,1,0
2648,ACGTCGAATCAAGGGA,76,91,15,9,1800,1,0
2652,ACGTCGAATCAAGGGA,76,91,15,9,1804,1,0
3297,ACGTCGAGTCTAGGGA,79,91,12,12,1312,0,0
3302,ACGTCGAATCAAGGGA,79,91,12,9,1321,0,0
3307,ACGTCGAATCTAGGGA,79,91,12,9,1328,0,0
3347,ACGTCGAAACTAGGGA,79,91,12,12,1717,0,0
3430,CCGTCGAATCTAAGGA,79,91,12,12,2248,0,0
3444,ACGTCGAATCTAGGGA,79,91,12,12,2264,0,0
3491,ACGTCGAATCTAGGGA,79,91,12,9,2347,0,0
3531,ACGTAGGATCTAGGGA,79,91,12,12,2406,0,0
3586,ACGTCGACTCTAGGGA,80,91,11,7,1037,0,0
4284,ACGTCGACTCTAGGGA,82,91,9,9,390,0,0
4285,ACGTCGGATCTAGGGA,82,91,9,9,408,0,0
4295,ACGTCGAATCTAGGGA,82,91,9,9,715,0,0
4692,ACGTCGAATCTAGGGA,83,91,8,7,438,0,0
4739,ACGTCGAATCTAGGGA,83,91,8,10,1401,0,0
4741,ACGTCGAATCTAGGGA,83,91,8,10,1409,0,0
4753,ACGTCGAATCTAGGGA,83,91,8,13,1452,0,0
4757,ACGTCGAATCTAGGGA,83,91,8,10,1487,0,0
4865,ACGTCGAATCTAGGGA,85,91,6,9,735,0,0
4866,ACGTCGACTCTAGGGA,85,91,6,9,737,0,0
4883,ACGTCGACTCTAGGGA,85,91,6,12,1280,0,0
4886,ACGTCGAATCTAGGGA,85,91,6,12,1291,0,0
4935,ACATCGAATCTAGGGA,86,91,5,10,842,0,0
4945,ACGTCGAATCTAGGGA,86,91,5,10,1105,0,0
4948,ACGTCGACTCTAGGGA,86,91,5,10,1111,0,0
4953,ACGTCGACTCTAGGGA,86,91,5,7,1376,0,0
4975,ACGTCGAGTCTAGGGA,86,91,5,13,1508,0,0
4976,ACGTCGATTCTAGGGA,87,91,4,8,106,0,0
4981,ACGTCGACTCTAGGGA,87,91,4,8,660,0,0
4988,ACGTCGAATCTAGGGA,87,91,4,8,879,0,0
5000,ACGTCGAATCTAGGGA,87,91,4,11,1167,0,0
5004,ACGTCGACTCTAGGGA,87,91,4,11,1184,0,0
5015,ACGTCGAATCTAGGGA,87,91,4,11,1525,0,0
5021,ACGTCGAATCTAGGGA,87,91,4,11,1562,0,0
5026,ACGTCGAATCTAGGGA,87,91,4,11,1591,0,0
5028,ACGTCGAATCTAGCGA,87,91,4,11,1596,0,0
5033,ACGTCGAATCAAGGGA,87,91,4,11,1622,0,0
5034,ACGTCGAATCTAGGGA,87,91,4,11,1624,0,0
5043,ACGTCGAATCTACGGA,87,91,4,12,1721,0,0
5044,ACGTCGAATCTAGGGA,87,91,4,12,1724,0,0
5060,ACGTCGAATCTACGGA,87,91,4,10,1849,0,0
5065,ACGTCGAATCTAGGGA,87,91,4,10,1866,0,0
5080,ACGTCGACTCTAGGGA,88,91,3,9,737,0,0
5089,ACGTCGAATCTAGGGA,88,91,3,12,1023,0,0
5094,ACGTCCACTCTAGGGA,88,91,3,12,1280,0,0
5105,ACGTCGAATCTAGGGA,88,91,3,12,1352,0,0
5126,ACGTCGAATCTAGGGA,89,91,2,10,637,0,0
5132,ACGTCGAATCTCGGGA,89,91,2,10,1049,0,0
5141,ACGTCGACTCTAGGGA,89,91,2,7,1376,0,0
5166,ACGTCGAATCTAGGCA,89,91,2,10,1892,0,0
5171,ACGTCGAATCTAGGGA,89,91,2,10,1911,0,0
5181,ACTTCGACTCTAGGGA,89,91,2,13,1962,0,0
5198,ACGTCGAATCTCGGGA,90,91,1,11,906,0,0
5203,ACGTCGAATCTAGGGA,90,91,1,11,1158,0,0
5211,ACGTCGAATCAAGGGA,90,91,1,8,1208,0,0
5222,ACGTGGACTCTAGGGA,90,91,1,11,1565,0,0
5238,ACGTCGAAGCTAGGGA,90,91,1,12,1724,0,0
5251,ACGTCGAATCTAGGGA,90,91,1,10,1849,0,0
5257,ACGTCGACTCTAGGGA,90,91,1,10,1869,0,0
424,ACGTCGAATCTAGGGA,57,92,35,8,274,11,0
685,ACGTCGAATCTAGGGA,62,92,30,10,445,9,0
737,ACGTCGACTCTAGGGA,63,92,29,8,360,9,0
988,ACATCGAATCAAGGGA,66,92,26,8,382,8,0
1258,ACGTCGAATCAAGGGA,68,92,24,10,860,7,0
1309,ACGTCGAATCTAGGGA,69,92,23,11,685,7,0
1396,ACGTCGACTCTAGGGA,70,92,22,9,522,6,0
1409,ACGTCGAATCTAGGGA,70,92,22,9,553,6,0
1417,ACGTCGACTATAGGGA,70,92,22,12,574,6,0
1565,ACGTGGACTCTAGGGA,71,92,21,10,786,6,0
1591,ACGTCGAATCTAGGGA,71,92,21,10,847,6,0
1650,ACGTCGACTCTAGGGA,71,92,21,10,1123,6,0
1829,ACGTCGGATCTAGGGA,72,92,20,11,1243,4,0
1864,ACGTCGAATCTAGGGA,73,92,19,9,546,4,0
1869,ACGTCGACTCTAGGGA,73,92,19,9,557,4,0
1889,ACGTCGAATCAAGGGA,73,92,19,9,752,3,0
1911,ACGTCGAATCTAGGGA,73,92,19,9,982,3,0
1984,ACGTCGAATCTGGGGA,73,92,19,12,1327,3,0
1987,ACGTCGAATCTAGGGA,73,92,19,12,1331,3,0
1998,ACGTCGAATCTAGGGA,73,92,19,12,1352,3,0
2045,ACGTCGAATCAAGGGA,74,92,18,7,787,2,0
2643,ACGTCGACTCTAGGGA,76,92,16,12,1792,2,0
2657,ACGTCGACTCTAGGGA,76,92,16,12,1813,2,0
3232,ACGTCGAATCTCGGGA,79,92,13,9,313,0,0
3276,ACGTCGAATCTAGGGA,79,92,13,12,1023,0,0
3365,ACGTCGGATCTAGGGA,79,92,13,9,1763,0,0
3392,ACGTCGAATCTAGGGA,79,92,13,12,1819,0,0
3412,ACGTCGAATCTAGGGA,79,92,13,12,2222,0,0
3437,AAGTCGGATCTAGGGA,79,92,13,9,2256,0,0
3443,ACGGCGAATCTAGGGA,79,92,13,12,2263,0,0
3449,ACGTCGACTCTAGGGA,79,92,13,12,2276,0,0
3459,ACGTCGACTCTAGGGA,79,92,13,12,2293,0,0
3560,ACGTCGAATCTAGGGA,80,92,12,7,318,0,0
3565,ACGTCGAATCTAGGGA,80,92,12,10,440,0,0
3566,ACGTCGAATCTAGGGA,80,92,12,10,456,0,0
3568,ACGTCGACTCTAGGGA,80,92,12,10,466,0,0
3570,AAGTCCGATCTAGGGA,80,92,12,7,583,0,0
3571,ACGTCGAATCTAGGGA,80,92,12,10,586,0,0
3573,ACGTCGAATCTAGGGA,80,92,12,10,598,0,0
3575,ACGTCGAATCTAGGGA,80,92,12,10,637,0,0
3576,ACGTCGACTCTAGGGA,80,92,12,7,778,0,0
3582,ACGTCGACTCTAGGGA,80,92,12,10,797,0,0
3584,ACATCGAATCTAGGGA,80,92,12,10,842,0,0
3585,ACGTCGACTCTAGGGA,80,92,12,10,850,0,0
3591,ACGTCGAATCTAGGGT,80,92,12,10,1062,0,0
3592,ACCTCGACTCTAGGGA,80,92,12,10,1065,0,0
3595,ACGTCGACTCTAGGGA,80,92,12,10,1076,0,0
3600,ACGTCGAATCTAGGGA,80,92,12,10,1106,0,0
4763,ACGTCGAATCTAGGGA,84,92,8,8,106,0,0
4861,ACGTCGAATATAGGGA,85,92,7,9,553,0,0
4900,ACGTCGAATCTAGGGA,85,92,7,12,1353,0,0
4914,ACGTCGAATCTAGGGA,85,92,7,9,1709,0,0
4934,ACGTCGAATCTAGGGA,86,92,6,10,830,0,0
4944,ACGTCGAATCAAGGGA,86,92,6,7,1091,0,0
4984,ACGTCGAATCTAGGGA,87,92,5,8,675,0,0
5007,ACGTCGACTCTAGGGA,87,92,5,11,1199,0,0
5051,ACGTCGAATCTAGGGA,87,92,5,12,1791,0,0
5055,ACGTCGAATCTAGGGA,87,92,5,9,1798,0,0
5062,ACGTCGGATCTAGGGA,87,92,5,10,1862,0,0
5071,ACGTCGACTCTAGGGA,88,92,4,9,386,0,0
5072,ACGTCGAATCTAGGGA,88,92,4,9,424,0,0
5073,ACGTCGACTCTAGGGA,88,92,4,9,522,0,0
5074,ACGTCGAATCTAGGGA,88,92,4,9,533,0,0
5075,ACGTCGACTCTAGGGA,88,92,4,9,534,0,0
5077,CCGTCGAATCTAGGGA,88,92,4,9,564,0,0
5078,ACGTCGACTCTAGGGA,88,92,4,12,568,0,0
5081,ACGTCGAATCAAGGGA,88,92,4,9,752,0,0
5082,ACGTCGAATCAAGGGA,88,92,4,9,759,0,0
5083,ACGTCGAATCTAGGGA,88,92,4,12,764,0,0
5084,ACGTCGAATCAAGGGA,88,92,4,6,949,0,0
5085,ACGTCGAATCTAGGGA,88,92,4,9,976,0,0
5086,ACGTCGAATCTAGGGA,88,92,4,9,982,0,0
5087,ACATCGAATCAAGGGA,88,92,4,9,988,0,0
5088,ACGTCGAATCTAGGGA,88,92,4,12,1000,0,0
5090,ACGTCGAATCAAGGGA,88,92,4,6,1260,0,0
5092,ACGTCGACTCTAGGGA,88,92,4,9,1274,0,0
5093,ACGTCGAATCTAGGGA,88,92,4,9,1277,0,0
5095,ACGTCGAATCTAGGGA,88,92,4,12,1291,0,0
5096,ACGTCGAATCTAGGGA,88,92,4,12,1292,0,0
5097,ACGTCGACTCTAGGGA,88,92,4,9,1299,0,0
5098,ACGTCGAATCTAGGGA,88,92,4,12,1309,0,0
5099,ACGTCGACTCTAGGGA,88,92,4,12,1314,0,0
5100,ACGTCGAATCAAGGGA,88,92,4,9,1321,0,0
5101,ACGTCGAATCTAGGGA,88,92,4,12,1324,0,0
5102,ACGTCGAATCTAGGGA,88,92,4,9,1325,0,0
5103,ACGTCGAATCTAGGGA,88,92,4,9,1328,0,0
5104,ACGTCGAATCTCGGGA,88,92,4,12,1348,0,0
5106,ACGTCGAATCTAGGGA,88,92,4,12,1353,0,0
5108,ACGTCGAATCTAGGGA,88,92,4,9,1673,0,0
5109,ACGTCGACTCTAGGGA,88,92,4,9,1674,0,0
5110,ACGTCGAATCTAGGGA,88,92,4,9,1683,0,0
5111,ACGTCGAATCAAGGGA,88,92,4,9,1684,0,0
5113,ACGTCGACTCTAGGGA,88,92,4,9,1691,0,0
5114,ACGTCGAATCAAGGGA,88,92,4,9,1693,0,0
5115,ACGTCGCATCTAGGGA,88,92,4,9,1695,0,0
5116,ACGTCGAAACTAGGGA,88,92,4,12,1717,0,0
5117,ACGTCGACTCTAGGGA,88,92,4,9,1718,0,0
5122,ACGTCGAATCTAGGGA,89,92,3,7,438,0,0
5130,ACGTCGAATCTAGGGA,89,92,3,10,830,0,0
5148,ACGTCGAATCTAGGGA,89,92,3,10,1416,0,0
5165,ACGTCGAATCAAGGGA,89,92,3,10,1889,0,0
5177,ACGTCGACTCTAGGGA,89,92,3,10,1937,0,0
5183,ACGTCGAATCTAGGGA,89,92,3,13,1973,0,0
5221,ACGTCGAATCAAGGGA,90,92,2,8,1547,0,0
5240,ACGTCGAATCTAGGGA,90,92,2,12,1735,0,0
5241,ACGTCGAATCTAGGGA,90,92,2,12,1761,0,0
5244,ACGTCGAATCTAGGGA,90,92,2,12,1791,0,0
5283,ACGTCGAATCTAGGGA,91,92,1,12,1353,0,0
5303,ACGTCGAATCTAGGGA,91,92,1,10,2446,0,0
5305,ACGTCGAATCTAGGGA,91,92,1,10,2460,0,0
5309,ACGTCGAATCTAGGGA,91,92,1,10,2492,0,0
5314,ACGTCGAATCTAGGGA,91,92,1,10,2510,0,0
5321,ACGTCGAATCTAGGCA,91,92,1,13,2531,0,0
5326,ACGTCGAATCTAGGGA,91,92,1,13,2554,0,0
5337,ACGTCGGATCTAGGGA,91,92,1,10,2624,0,0
5339,ACGTCGACTCTAGGGA,91,92,1,13,2635,0,0
343,ACGTCGAATCAAGGGA,55,93,38,6,219,12,0
850,ACGTCGACTCTAGGGA,64,93,29,9,558,9,0
870,ACGTCGAATCAAGGGA,65,93,28,7,236,8,0
911,AAGTCGGATCTAGGGA,65,93,28,7,583,8,0
1000,ACGTCGAATCTAGGGA,66,93,27,11,510,8,0
1065,ACGTCGACTCTAGGGA,67,93,26,9,524,8,0
1106,ACGTCGAATCTAGGGA,67,93,26,9,731,8,0
1208,ACGTCGAATCAAGGGA,68,93,25,7,783,7,0
1249,ACGTCGAATCAAGGGA,68,93,25,10,845,7,0
1416,ACGTCGAATCTAGGGA,70,93,23,9,572,7,0
1585,ACGTCGAATCTAGGGA,71,93,22,10,830,6,0
1601,ACGTCGACTCTAGGGA,71,93,22,10,1046,6,0
1663,ACGTCGAATCTAGGGA,72,93,21,8,106,6,0
1792,ACGTCGACTCTAGGGA,72,93,21,11,1199,5,0
1846,ACGTCGAATCTCGGGG,73,93,20,9,313,4,0
2446,ACGTCGAATCTAGGGA,76,93,17,9,406,2,0
2460,ACGTCGAATCTAGGGA,76,93,17,9,556,2,0
2466,ACGTCGACTCTAGGGA,76,93,17,9,737,2,0
2623,ACGTCGAATCTAGGGA,76,93,17,12,1761,2,0
2687,ACGTCGAATCTAGGGA,77,93,16,10,456,2,0
2698,ACGTCGACTCTAGGGA,77,93,16,10,634,2,0
3312,ACGTCGAATCTAGGGA,79,93,14,9,1351,0,0
3332,ACGTCGACTCTAGGGA,79,93,14,9,1691,0,0
3425,ACGTCGAATCTAGGGA,79,93,14,12,2241,0,0
3472,ACGTCGAATCTAGGGA,79,93,14,12,2313,0,0
3494,ACGTCGCATCTAGGGA,79,93,14,9,2352,0,0
3495,ACGTCGAATCTAGGGA,79,93,14,9,2353,0,0
3500,ACGTCGAATCTAGGGA,79,93,14,12,2359,0,0
3501,ACGTCGAATCTAGGGA,79,93,14,12,2360,0,0
3502,GCGTCGAATCTAGGGA,79,93,14,12,2361,0,0
3510,TCGTCGAATCTAGGGA,79,93,14,12,2373,0,0
3520,ACGTCGACTCTAGGGA,79,93,14,12,2389,0,0
3521,ACGTCGAATCTAGGGA,79,93,14,12,2390,0,0
3522,ACGTCGAATCTAGGGA,79,93,14,12,2391,0,0
3527,ACGTCGACTCTAGGGA,79,93,14,12,2398,0,0
3529,ACGTCGAATCTAGGGA,79,93,14,12,2400,0,0
3532,ACGTCGACTCTAGGGA,79,93,14,12,2407,0,0
3535,ACGTCGAATCTAGGGA,79,93,14,15,2411,0,0
3537,ACGTCGAATCTAGGGA,79,93,14,12,2414,0,0
3538,ACGTCGAATCTAGGGA,79,93,14,12,2415,0,0
3541,ACGTCGAATCTAGGGA,79,93,14,12,2420,0,0
3542,ACGTCGAATCTAGGGA,79,93,14,12,2422,0,0
3544,ACGTCGAATCTAGGGA,79,93,14,12,2424,0,0
3549,ACGTCGAATCTAGGGA,79,93,14,12,2429,0,0
3558,ACGTCGAATCTAGGGA,79,93,14,12,2439,0,0
4305,ACGTCGAATCTAGGGA,82,93,11,9,967,0,0
4707,ACGTCGACTCTAGGGA,83,93,10,10,797,0,0
4720,ACGTCGAATCAAGGGA,83,93,10,7,1091,0,0
4734,ACGTCGACTCTAGGGA,83,93,10,10,1386,0,0
4735,ACGTCGACTCTAGGGA,83,93,10,10,1389,0,0
4740,ACGTCGACTCTAGGGA,83,93,10,10,1407,0,0
4743,ACGTCGAATCTAGGGA,83,93,10,10,1416,0,0
4746,ACGTCGAATCTAGGGA,83,93,10,10,1423,0,0
4750,ACGTCGAATCAAGGGA,83,93,10,10,1438,0,0
4751,ACGTCGAATCTAGGGA,83,93,10,10,1439,0,0
4756,ACATCGAATCAAGGGA,83,93,10,10,1480,0,0
4758,ACGTCGAATCAAGGGA,83,93,10,10,1495,0,0
4759,ACGTCGAATCTAGGGA,83,93,10,13,1504,0,0
4761,ACGTGGACTCTAGGGA,83,93,10,13,1506,0,0
4762,ACGTCGAGTCTAGGGA,83,93,10,13,1508,0,0
4856,ACGTCGACTCTAGGGA,85,93,8,9,522,0,0
4857,ACGTCGAATCTAGGGA,85,93,8,9,533,0,0
4859,ACGTCGAATCTAGGGA,85,93,8,9,540,0,0
4860,ACGTCGAATCTAGGGA,85,93,8,9,546,0,0
4869,ACGTCGAATCTAGGGA,85,93,8,12,764,0,0
4870,ACGTCGAATCAAGGGA,85,93,8,6,949,0,0
4872,ACGTCGAATCTAGGGA,85,93,8,9,976,0,0
4873,ACGTCGAATCTAGGGA,85,93,8,9,982,0,0
4874,ACATCGAATCAAGGGA,85,93,8,9,988,0,0
4875,ACGTCGAATCTAGGGA,85,93,8,12,1000,0,0
4876,ACGTCGAATCTAGGGA,85,93,8,12,1023,0,0
4877,ACGTCGAATCAAGGGA,85,93,8,9,1030,0,0
4878,ACGTAGAATCAAGGGA,85,93,8,6,1260,0,0
4879,ACGTCGAATCTAGGGA,85,93,8,9,1265,0,0
4880,ACGCCGACTCTAGGGA,85,93,8,9,1271,0,0
4881,ACGTCGACTCTAGGGA,85,93,8,9,1274,0,0
4882,ACGTCGAATCTAGGGA,85,93,8,9,1277,0,0
4884,ACGTCGAATCTAGGGA,85,93,8,12,1285,0,0
4885,ACGTGGACTCTAGGGA,85,93,8,9,1286,0,0
4890,ACGTCGAATCTAGGGA,85,93,8,12,1309,0,0
4892,ACGTCGACTCTAGGGA,85,93,8,12,1314,0,0
4894,ACGTCGAATCAAGGGA,85,93,8,9,1321,0,0
4895,ACGTCGAATCTAGGGA,85,93,8,12,1324,0,0
4899,ACGTCGAATCTAGGGA,85,93,8,12,1352,0,0
4903,ACGTCGACTCTAGGGA,85,93,8,9,1674,0,0
4904,ACGTCGAATCTAGGGA,85,93,8,9,1683,0,0
4906,ACGTCGAATCAAGGGA,85,93,8,9,1689,0,0
4909,ACGTCGAATCTAGGGA,85,93,8,9,1694,0,0
4913,ACGTCGAATCAAGGGA,85,93,8,9,1702,0,0
4915,ACGTCGAAACTAGGGA,85,93,8,12,1717,0,0
4917,AGGTCGAATCTAAGGA,85,93,8,12,1719,0,0
4918,ACGTCGAATCAAGGGA,85,93,8,9,1720,0,0
4937,ACGTCGACTCTAGGGA,86,93,7,7,1037,0,0
4940,ACGTCGAATCTAGGTA,86,93,7,10,1059,0,0
4971,ACGTCGAATCTAGGGA,86,93,7,10,1487,0,0
4982,ACGTCGAATCTAGGGA,87,93,6,8,661,0,0
4990,ACGTCGAATCTAGGGA,87,93,6,11,883,0,0
4993,AAGTCGGATCTAGGGA,87,93,6,8,911,0,0
4998,ACGTCGAATCTAGGGA,87,93,6,11,1157,0,0
5006,GCGGCGAATCTAGGGA,87,93,6,11,1196,0,0
5008,ACGTCGAATCAAGGGA,87,93,6,8,1208,0,0
5009,ACGTCGAATCTAGGGA,87,93,6,11,1230,0,0
5011,ACGTCGAATCTAGGGA,87,93,6,11,1237,0,0
5012,ACGTCGACTCTAGGGA,87,93,6,11,1245,0,0
5013,ACGTCGAATCAAGGGA,87,93,6,11,1249,0,0
5016,ACGTCGCATCTAGGGA,87,93,6,8,1527,0,0
5018,ACGCCGAATCTAGGGA,87,93,6,11,1543,0,0
5019,ACGTCGAATCAAGGGA,87,93,6,8,1547,0,0
5023,ACGTCGAATCTAGGGA,87,93,6,11,1571,0,0
5024,ACGTCGGATCTAGGGA,87,93,6,11,1574,0,0
5025,ACGTCGAATCTAGGGA,87,93,6,11,1585,0,0
5027,ACGTCGAATCTAGGGA,87,93,6,14,1595,0,0
5030,ACGTCGAATCTAGGGA,87,93,6,11,1603,0,0
5031,ACGTAGGATCTAGGGA,87,93,6,11,1605,0,0
5032,ACGTCGAATCTAGGGA,87,93,6,14,1613,0,0
5035,ACGTCGAATCTAGGGA,87,93,6,11,1629,0,0
5036,ACGTCGAATCTAGGGA,87,93,6,11,1631,0,0
5038,ACGTCGAATCTAGGGA,87,93,6,11,1639,0,0
5039,ACGTCGAATCTAGGGA,87,93,6,11,1643,0,0
5041,ACGTCGACTCTAGGGA,87,93,6,11,1650,0,0
5047,ACGTCGAATCTAGGGA,87,93,6,12,1761,0,0
5052,ACGTCGACTCTAGGGA,87,93,6,12,1792,0,0
5053,ACGTCGAATCTAGGGA,87,93,6,12,1793,0,0
5057,ACGTGGACTCTAGGGA,87,93,6,12,1803,0,0
5058,ACGTCGACTCTAGGGA,87,93,6,10,1845,0,0
5061,ACGTCGAATCTAGGGA,87,93,6,10,1854,0,0
5063,ACGTCGAATCTAGGGA,87,93,6,10,1864,0,0
5064,ACGTCGACTCTAGGGA,87,93,6,10,1865,0,0
5066,ACGTCGAATCTAGGGA,87,93,6,10,1867,0,0
5067,ACGTCGACTCTAGGGA,87,93,6,10,1869,0,0
5068,ACGTCGAATCTAGGGA,87,93,6,10,1870,0,0
5070,ACGTCGAATCTAGGGA,87,93,6,10,1876,0,0
5121,ACGTCGAATCAAGGGA,89,93,4,7,343,0,0
5135,ACGTCGACTCTAGGGA,89,93,4,10,1076,0,0
5143,ACGTCGAATCTAGGGA,89,93,4,10,1382,0,0
5200,ACGTCGAATCAAGGGA,90,93,3,8,922,0,0
5208,ACGTCGAATCTAGGGA,90,93,3,11,1187,0,0
5213,ACGTCGAATCTAGGGA,90,93,3,11,1233,0,0
5227,ACGTCGAATCTAGGGA,90,93,3,11,1596,0,0
5232,ACGTCGAATCTAGGGA,90,93,3,11,1631,0,0
5237,ACGTCGAATCTACGGA,90,93,3,12,1721,0,0
5242,ACGTCGGATCTAGGGA,90,93,3,9,1763,0,0
5245,ACGTCGACTCTAGGGA,90,93,3,12,1792,0,0
5254,ACGTCGACTCTAGGGA,90,93,3,10,1865,0,0
5271,ACATCGAATCAAGGGA,91,93,2,9,988,0,0
5272,ACGTCGAATCTAGGGA,91,93,2,12,1000,0,0
5275,ACGTCGAATCTAGGGA,91,93,2,9,1277,0,0
5278,ACGTCGAATCTAGGGA,91,93,2,12,1309,0,0
5284,ACGTCGAATCTAGGGA,91,93,2,9,1663,0,0
5289,ACGTCGAATCAAGGGA,91,93,2,9,1689,0,0
5292,ACGTCGACTCTAGGGA,91,93,2,9,1718,0,0
5307,ACGTCGAATCTAGGGA,91,93,2,10,2481,0,0
5308,ACGTCGAATCAAGGGA,91,93,2,10,2491,0,0
5351,ACGTCGAATCTAGGGA,92,93,1,10,597,0,0
5356,ACGTCGACTCTAGGGA,92,93,1,10,850,0,0
5371,ACGTCGAATCTAGGGA,92,93,1,10,1423,0,0
5381,ACGTCGACTCTAGGGA,92,93,1,10,1879,0,0
5393,ACTTCGACTCTAGGGA,92,93,1,13,1962,0,0
5406,ACGTCGAATCTAGGGA,92,93,1,11,2703,0,0
281,ACGTCGACTCTAGGGA,53,94,41,10,179,13,0
778,ACGTCGACTCTAGGGA,64,94,30,6,50,9,0
1062,ACGTCGAATCTAGGGA,67,94,27,9,424,8,0
1157,ACGTCGAATCTAGGGA,68,94,26,10,440,8,0
1187,ACGTCGAATCTAGGGA,68,94,26,10,608,8,0
1314,ACGTCGACTCTAGGGA,69,94,25,11,698,7,0
1321,ACGTCGAATCAAGGGA,69,94,25,8,870,7,0
1458,ACGTCGACTCTAGGGA,70,94,24,9,950,7,0
1798,ACGTCGAATCTAGGGA,72,94,22,8,1205,6,0
1935,ACGTCGAATCTAGGGA,73,94,21,12,1034,4,0
2441,ACGTCGAATCTAGGGA,76,94,18,9,224,2,0
2503,ACGTCGAATCTAGGGA,76,94,18,12,1032,2,0
2537,ACGTCGAATCTAGGGA,76,94,18,12,1324,2,0
2544,AAGACGGATCTAGGGA,76,94,18,9,1350,2,0
2596,ACGTCGACTCTAGGGA,76,94,18,9,1718,2,0
2603,ACGTCGACTCTAGGGA,76,94,18,12,1726,2,0
2708,ACGTCGAATCTAGGGA,77,94,17,10,820,2,0
3257,ACGTCGAATCTAGGGA,79,94,15,12,764,1,0
3293,ACGTCGAATCTAGGGA,79,94,15,9,1296,1,0
3299,ACGTCGACTCTAGGGA,79,94,15,12,1314,0,0
3342,ACGTCGAATCTAGGGA,79,94,15,9,1709,0,0
3415,ACGTCGAATCAAGGGA,79,94,15,9,2226,0,0
3433,ACGTCGAATCTAGGGA,79,94,15,9,2251,0,0
3441,ACGTCGAATCTAGGGA,79,94,15,12,2260,0,0
3469,ACGTCGAATCTAGGGA,79,94,15,12,2308,0,0
4300,ACGTCGAATCAAGGGA,82,94,12,9,752,0,0
4919,ACGTCGAATCTAGGGA,86,94,8,7,318,0,0
5123,ACGTCGACTCTAGGGA,89,94,5,10,466,0,0
5124,ACGTCGGATCTAGGGA,89,94,5,10,475,0,0
5139,ACGTCGAATCAAGGGA,89,94,5,10,1119,0,0
5140,ACGTCGAATCTAGGGA,89,94,5,13,1139,0,0
5153,ACGTCGAATCTAGGGA,89,94,5,10,1439,0,0
5158,ACGTGGACTCTAGGGA,89,94,5,13,1506,0,0
5185,ACGTCGAATCTAGGGA,90,94,4,8,259,0,0
5195,ACGTCGAATCTAGGGA,90,94,4,11,873,0,0
5197,ACGTCGAATCTAGGGA,90,94,4,11,883,0,0
5210,ACGTCGACTCTAGGGA,90,94,4,11,1199,0,0
5226,ACGTCGAATCTAGGGA,90,94,4,14,1595,0,0
5228,ACGTCGACTCTAGGGA,90,94,4,11,1601,0,0
5229,ACGTCGAATCTAGGGA,90,94,4,11,1603,0,0
5230,ACGTCGAATCTAGGGA,90,94,4,11,1624,0,0
5231,ACGTCGAATCTAGGGA,90,94,4,11,1629,0,0
5233,ACGTCGAATCTAGGGA,90,94,4,11,1639,0,0
5234,ACGTCGAATCTAGGGA,90,94,4,11,1643,0,0
5235,ACGTCGACTCTAGGGA,90,94,4,11,1650,0,0
5236,ACGTCGAATCTAGGGA,90,94,4,11,1656,0,0
5239,ACGTCGAATCTAAGGA,90,94,4,9,1731,0,0
5243,ACGTCGACTCTAGGGA,90,94,4,12,1781,0,0
5246,ACGTCCAATCTAGGGA,90,94,4,12,1796,0,0
5247,ACGTCGAATCTAGGGA,90,94,4,9,1798,0,0
5248,ACGTCGAATCTAGGGA,90,94,4,12,1802,0,0
5249,ATGTGGACTCTAGGGA,90,94,4,12,1803,0,0
5250,ACGTCGAATCTCGGGG,90,94,4,10,1846,0,0
5252,ACGTCGAATCTAGGGA,90,94,4,10,1854,0,0
5253,ACGTCGATTCTAGGGA,90,94,4,10,1864,0,0
5255,ACGTCGAATCTAGGGA,90,94,4,10,1866,0,0
5256,ACGTCGAATCTAGGGA,90,94,4,10,1867,0,0
5258,ACGTCGAATCTAGGGA,90,94,4,10,1875,0,0
5259,ATGTCGAATCTAGGGA,90,94,4,10,1876,0,0
5262,ACGTCGAGTCTAGGGA,91,94,3,9,522,0,0
5285,ACGTCGAATCTAGGGA,91,94,3,9,1673,0,0
5288,ACGTCGAATCAAGGGA,91,94,3,9,1684,0,0
5293,ACGTCGAATCAAGGGA,91,94,3,9,1720,0,0
5294,ACGTCGACTCTAGGGA,91,94,3,13,1980,0,0
5306,ACGTCGACTCTAGGGA,91,94,3,10,2466,0,0
5330,ACGTCGACTCTAGGGA,91,94,3,10,2596,0,0
5332,ACGTCGAATCTAGGGA,91,94,3,13,2600,0,0
5336,ACGTCGAATCTAGGGA,91,94,3,13,2623,0,0
5357,ACGTCGAATCTCGGGA,92,94,2,10,1049,0,0
5359,ACGTCGACTCTAGGGA,92,94,2,10,1065,0,0
5362,ACGTCGAATCTAGGGA,92,94,2,10,1105,0,0
5390,ACGTCGACTCTAGGGA,92,94,2,10,1937,0,0
5391,ACGTCGAATCTAGGGA,92,94,2,13,1951,0,0
5392,ACGTCGAATCTAGGGA,92,94,2,13,1957,0,0
5395,ACGTCGAATCTAGGGA,92,94,2,11,2016,0,0
5402,ACGTCGAATCTAGGGA,92,94,2,11,2692,0,0
5409,ACATCGAATCTAGGGA,92,94,2,11,2712,0,0
5415,ACGTCGACTCTAGGGA,93,94,1,8,660,0,0
5426,ACGTCGAATCTAGGGA,93,94,1,11,1167,0,0
5428,ACGTCGACTCTAGGGA,93,94,1,8,1173,0,0
5441,ACGTCGAATCTAGGGA,93,94,1,11,1571,0,0
5448,ACGTCGAATCTAGGGA,93,94,1,11,1656,0,0
5451,ACGTCGAATCTAAGGA,93,94,1,9,1731,0,0
5467,ACGTCGAATCTAGGGA,93,94,1,10,3238,0,0
5470,ACGTCGAATCTAGGGA,93,94,1,13,3257,0,0
5472,ACATCGAATCAAGGGA,93,94,1,10,3270,0,0
5477,ACGTCGTATCTAGGGA,93,94,1,10,3284,0,0
752,ACGTCGAATCAAGGGA,63,95,32,8,382,10,0
1076,ACGTCGACTCTAGGGA,67,95,28,9,545,8,0
1139,ACGTCGAATCTAGGGA,67,95,28,12,775,8,0
1143,ACGTCGACTCTAGGGA,68,95,27,10,178,8,0
1184,ACGTCGACTCTAGGGA,68,95,27,10,602,8,0
1277,ACGTCGAATCTAGGGA,69,95,26,8,361,8,0
1379,ACGTCGAATCAAGGGA,70,95,25,6,158,7,0
1423,ACGTCGAATCTAGGGA,70,95,25,9,715,7,0
1525,ACGTCGAATCTAGGGA,71,95,24,10,345,7,0
1547,ACGTCGAATCAAGGGA,71,95,24,7,599,7,0
1603,ACGTCGAATCTAGGGA,71,95,24,10,1048,7,0
1720,ACGTCGAATCAAGGGA,72,95,23,8,892,7,0
1724,ACGTCGAATCTAGGGA,72,95,23,11,898,6,0
1731,ACGTCGAATCTAAGGA,72,95,23,8,912,6,0
1895,ACGTCGAATCTAGGGA,73,95,22,12,764,4,0
1897,ACGTCGAATCTAGGGA,73,95,22,9,774,4,0
2037,ACGTCGAATCTAGGGA,74,95,21,10,604,3,0
2501,ACGTCGAATCAAGGGA,76,95,19,9,1030,3,0
2514,ACGTCGAATCTAGGGA,76,95,19,12,1285,3,0
2569,ACGTCGACTCTAGGGA,76,95,19,9,1682,3,0
2611,ACGTCGAATCTAGGGA,76,95,19,12,1739,3,0
3304,ACGTCGAATCTAGGGA,79,95,16,12,1324,0,0
3329,ACGTCGACTCTAGGGA,79,95,16,9,1686,0,0
3372,ACGTCGAATCTAGGGA,79,95,16,12,1782,0,0
3402,ACGTCGAATCTAGGGA,79,95,16,15,1840,0,0
4691,ACGTCGAATCTAGGGA,83,95,12,10,347,0,0
4769,ACGTCGACTCTAGGGA,84,95,11,8,660,0,0
4942,ACGTCGACTCTAGGGA,86,95,9,10,1065,0,0
4958,ACGTCGACTCTAGGGA,86,95,9,10,1396,0,0
4961,ACGTCGAGTCTAGGGA,86,95,9,10,1415,0,0
5127,ACGTCGACTCTAGGGA,89,95,6,7,778,0,0
5142,ACGTCGAATCAAGGGA,89,95,6,7,1379,0,0
5151,ACGTCGAATCTAGGGA,89,95,6,10,1431,0,0
5173,ACGTCGAATCTAGGGA,89,95,6,13,1918,0,0
5201,ACGTCGACTCTAGGGA,90,95,5,11,1143,0,0
5202,ACGTCGAATCTAGGGA,90,95,5,11,1157,0,0
5219,GCGTCGAATCTACGGA,90,95,5,11,1538,0,0
5225,ACGTCGAATCTAGGGA,90,95,5,11,1591,0,0
5266,ACGTCGAATCAAGGGA,91,95,4,9,752,0,0
5268,ACGTCGAATCTAGGGA,91,95,4,12,764,0,0
5274,ACGTCGACTCTAGGGA,91,95,4,9,1274,0,0
5295,ACGTCGAATCTGGGGA,91,95,4,13,1984,0,0
5299,ACGTCGAATCTAGGGA,91,95,4,13,1998,0,0
5300,ACGTCGAATCTAGGGA,91,95,4,13,2009,0,0
5301,ACGTCGAATCTAGGGA,91,95,4,10,2440,0,0
5302,ACGTCGAATCTAGGGA,91,95,4,10,2441,0,0
5304,ACGTCGAATCTAGGGA,91,95,4,10,2454,0,0
5310,ACGTCGACTCTAGGGA,91,95,4,10,2495,0,0
5311,ACGTCGAATCAAGGGA,91,95,4,10,2501,0,0
5312,ACGTCGAATCTAGGGA,91,95,4,13,2503,0,0
5313,ACGTCGAATCTAGGGA,91,95,4,10,2506,0,0
5315,ACGTCGAATCTAGGGA,91,95,4,10,2513,0,0
5316,ACGTCGAATCTAGGGA,91,95,4,13,2514,0,0
5317,ACGTCGAATCTAGGGA,91,95,4,13,2517,0,0
5318,ACGTCGAATCTAGGGA,91,95,4,13,2518,0,0
5319,ACGTCGACTCTAGGGA,91,95,4,10,2525,0,0
5320,ACATCGGATCTAGGGA,91,95,4,10,2526,0,0
5322,ACGTCGAATCTAGTGA,91,95,4,13,2533,0,0
5323,ACGTCGAATCTAGGGA,91,95,4,13,2537,0,0
5324,ACGTCGACTCTAGGGA,91,95,4,10,2539,0,0
5325,AAGACGGATCTAGGGA,91,95,4,10,2544,0,0
5327,ACGTCGACTCTAGGGA,91,95,4,10,2566,0,0
5328,ACGTCGACTCTAGGGA,91,95,4,10,2569,0,0
5329,ACGTCGAATCTAAGGA,91,95,4,13,2594,0,0
5331,ACGTCGAATCAAGGGA,91,95,4,10,2598,0,0
5333,ACGTCGACTCTAGGGA,91,95,4,13,2603,0,0
5334,ACGTCGAATCTAGGGA,91,95,4,13,2609,0,0
5335,ACGTCGAATCTAGGGA,91,95,4,13,2611,0,0
5338,ACGTCGAATCTAGGGA,91,95,4,13,2625,0,0
5340,ACGTCGACTCTAGGGA,91,95,4,13,2643,0,0
5341,ACGTCGAATCTAGGGA,91,95,4,13,2644,0,0
5342,ACGTCGAATCAAGCGA,91,95,4,10,2654,0,0
5343,ACGTCGACTCTAGGGA,91,95,4,13,2657,0,0
5344,ACGTCGACTCTAGGGA,91,95,4,13,2661,0,0
5345,ACGTCGAATCTAGGGA,91,95,4,13,2672,0,0
5384,ACGTCGAATCTAGGGA,92,95,3,10,1897,0,0
5401,ACGTCGAATCTAGGGA,92,95,3,11,2687,0,0
5413,ACGTCGAATCTAGGGA,93,95,2,8,361,0,0
5439,ACGTCGAATCTAGGGA,93,95,2,11,1543,0,0
5462,ACGTCGAATCTACGGA,93,95,2,10,1854,0,0
5465,ACCTCGAATCTAGGGA,93,95,2,10,1875,0,0
5480,ACGTCGAATCAAGGGA,93,95,2,10,3298,0,0
5507,ACGTCGACTCTAGGGA,94,95,1,13,1980,0,0
5524,ACGTCGACTCTAGGGA,94,95,1,10,2525,0,0
5533,ACGTCGAATCAAGGGA,94,95,1,10,2598,0,0
318,ACGTCGAATCTAGGGA,55,96,41,6,42,13,0
660,ACGTCGACTCTAGGGA,62,96,34,7,317,10,0
661,ACGTCGAATCTAGGGA,62,96,34,7,318,10,0
982,ACGTCGAATCTAGGGA,66,96,30,8,372,9,0
1245,ACGTCGACTCTAGGGA,68,96,28,10,839,8,0
1260,ACGTCGAATCAAGGGA,69,96,27,5,102,8,0
1571,ACGTCGAATCTAGGGA,71,96,25,10,793,7,0
1639,ACGTCGAATCTAGGGA,71,96,25,10,1109,7,0
1803,ACGTGGACTCTAGGGA,72,96,24,11,1211,6,0
1834,ACGTCGAATCTAGGGA,72,96,24,11,1251,6,0
1879,ACGTCGACTCTAGGGA,73,96,23,9,725,5,0
1899,ACGTCGAATCTAGGGA,73,96,23,9,952,5,0
2531,ACGTCGAATCTAGGCA,76,96,20,12,1315,3,0
2692,ACGTCGAATCTAGGGA,77,96,19,10,586,3,0
2697,ACGTCGAATCTAGGGA,77,96,19,10,604,3,0
2728,ACGTCGAATCTAGGGA,77,96,19,10,1070,2,0
3416,ACGTCGCATCTAGGGA,79,96,17,9,2228,0,0
4297,ACGTCGACTCTAGGGA,82,96,14,9,737,0,0
4701,ACGTCGAATCTAGGGA,83,96,13,10,637,0,0
4706,ACGTCGAATCTAGGGA,83,96,13,10,796,0,0
4710,ACGTCGACTCTAGGGA,83,96,13,10,850,0,0
4732,ACGTCGAATCTAGGGA,83,96,13,10,1382,0,0
4924,ACGTCGAATCTAGGGA,86,96,10,10,463,0,0
5002,ACGTCGACTCTAGGGA,87,96,9,8,1173,0,0
5005,ACGTCGAATCTAGGGA,87,96,9,11,1187,0,0
5137,ACGTCGAATCTAGGGA,89,96,7,10,1105,0,0
5156,ACATCGAATCAAGGGA,89,96,7,10,1480,0,0
5179,ACGTCGAATCTAGGGA,89,96,7,13,1957,0,0
5192,ACGTCGAATCTAGGGA,90,96,6,8,675,0,0
5193,ACGTCGAATCTAGGGA,90,96,6,11,685,0,0
5194,ACGTCGAATCAAGGGA,90,96,6,8,870,0,0
5196,ACGTCGAATCTAGGGA,90,96,6,11,880,0,0
5199,AAGTCGGATCTAGGGA,90,96,6,8,911,0,0
5204,ACGTCGAATCTAGGGA,90,96,6,11,1167,0,0
5205,ACGTCGAATCTAGGGA,90,96,6,11,1169,0,0
5206,ACGTCGACTCTAGGGA,90,96,6,8,1173,0,0
5207,ACGTCGACTCTAGGGA,90,96,6,11,1184,0,0
5209,GCGTCGAATCTAGGGA,90,96,6,11,1196,0,0
5212,ACGTCGAATCTAGGGA,90,96,6,11,1230,0,0
5214,ACGTCGACTCTAGGGA,90,96,6,11,1245,0,0
5215,ACGTCGAATCAAGGGA,90,96,6,11,1249,0,0
5216,ACGTCGAATCAAGGGA,90,96,6,11,1258,0,0
5217,ACGTCGAATCTAGGGA,90,96,6,11,1525,0,0
5218,ACGTCGCATCTAGGGA,90,96,6,8,1527,0,0
5220,ACGTCGAATCTAGGGA,90,96,6,11,1543,0,0
5223,ACGTCGAATCTAGGGA,90,96,6,11,1571,0,0
5224,ACGTCGAATCTAGGGA,90,96,6,11,1585,0,0
5280,ACGTCGAATCAAGGGA,91,96,5,9,1321,0,0
5287,ACGTCGAATCTAGGGA,91,96,5,9,1683,0,0
5298,ACGTCGAATCTCGGGA,91,96,5,13,1995,0,0
5348,ACGTCGAATCAAGGGA,92,96,4,7,343,0,0
5382,ACGTCGAATCAAGGGA,92,96,4,10,1893,0,0
5386,ACGTCGACTCTAGGGA,92,96,4,10,1916,0,0
5396,ACGTCGAATCAAGGGA,92,96,4,8,2018,0,0
5403,ACGTCGAATCTAGGGA,92,96,4,11,2696,0,0
5404,ACGTCGAATCTAGGGA,92,96,4,11,2697,0,0
5405,ACGTCGACTCTAGGGA,92,96,4,11,2698,0,0
5407,ACGTCGAATCTAGGAA,92,96,4,11,2708,0,0
5408,ACGTCGAATCTAGGGA,92,96,4,11,2709,0,0
5420,ACGTCGAATCTAGGGA,93,96,3,11,880,0,0
5438,GCGTCGAATCTAGGGA,93,96,3,11,1538,0,0
5459,ACGTCGAATCTAGGGA,93,96,3,12,1802,0,0
5475,ACGTCGAATCAAGGGA,93,96,3,10,3278,0,0
5476,ACGCCGACTCTAGGGA,93,96,3,10,3282,0,0
5481,ACGTCGACTCTAGGGA,94,96,2,9,386,0,0
5496,ACGTCGAATCTAGGGA,94,96,2,9,1325,0,0
5501,ACGTCGAATCAAGGGA,94,96,2,9,1684,0,0
5513,ACGTCGAATCTAGGGA,94,96,2,10,2481,0,0
5523,ACGTCGAATCTAGGGA,94,96,2,13,2518,0,0
5539,ACGTCGACTCTAGGGA,94,96,2,13,2635,0,0
5544,ACGTCGAATCTAGGGA,94,96,2,14,2714,0,0
5565,ACGTCGAATCTAGGGA,95,96,1,10,1448,0,0
5587,ACGTCGAATCTAGGGA,95,96,1,11,2686,0,0
5596,AAGTCGGATCTAGGGA,95,96,1,10,3311,0,0
949,ACGTCGAATCAAGGGA,66,97,31,5,102,9,0
1049,ACGTCGAATCTCGGGA,67,97,30,9,313,9,0
1199,ACGTCGACTCTAGGGA,68,97,29,10,634,9,0
1233,ACGTCGAATCTAGGGA,68,97,29,10,820,9,0
1643,ACGTCGAATCTAGGGA,71,97,26,10,1114,8,0
1802,ACGTCGAATCTAGGGA,72,97,25,11,1210,7,0
1854,ACGTCGAATCTAGGGA,73,97,24,9,424,6,0
2034,ACGTCGAATCTAGGGA,74,97,23,10,598,4,0
2513,ACGTCGAATCTAGGGA,76,97,21,9,1282,3,0
2598,ACGTCGAATCAAGGGA,76,97,21,9,1720,3,0
2661,ACGTCGACTCTAGGGA,76,97,21,12,1818,3,0
2682,ACGTCGAATCTAGGGA,77,97,20,10,347,3,0
2712,ACATCGAATCTAGGGA,77,97,20,10,842,3,0
2714,ACGTCGAATCTAGGGA,77,97,20,13,857,2,0
3344,ACGTCGAATCTAGGGA,79,97,18,9,1711,1,0
3353,ACGTCGACTCTAGGGA,79,97,18,12,1725,1,0
3366,ACGTCGAATCTAGGGA,79,97,18,12,1766,1,0
3422,ACGTCGAATCCAGGGA,79,97,18,12,2236,0,0
4696,ACGTCGGATCTAGGGA,83,97,14,10,475,0,0
4698,ACGTCGAATCTAGGGA,83,97,14,10,586,0,0
4764,ACGTCGAATCTAGGGA,84,97,13,8,259,0,0
4766,ACGTCGAATCTAGGGA,84,97,13,8,361,0,0
4767,ACGTCGAATCTAGGGA,84,97,13,8,379,0,0
4943,ACGTCGACTCTAGGGA,86,97,11,10,1076,0,0
4950,ACGTCGAATCAAGGGA,86,97,11,10,1119,0,0
4972,ACGTCGAATCAAGGGA,86,97,11,10,1495,0,0
4978,ACGTCGACTCTAGGGA,87,97,10,11,281,0,0
5003,ACGTGGACTCTAGGGA,87,97,10,11,1180,0,0
5163,ACGTCGAATCAAGGGA,89,97,8,12,1839,0,0
5164,ACGTCGACTCTAGGGA,89,97,8,10,1879,0,0
5167,ACGTCGAATCAAGGGA,89,97,8,10,1893,0,0
5169,ACGTCGAATCTAGGGA,89,97,8,10,1897,0,0
5170,ACGTCGAATCTAGGGA,89,97,8,10,1899,0,0
5172,ACGTCGACTCTAGGGA,89,97,8,10,1916,0,0
5176,ACGTCGAATCTAGGGA,89,97,8,13,1935,0,0
5178,ACGTCGAATCTAGGGA,89,97,8,13,1951,0,0
5180,ACGTCGAATCTAGGGA,89,97,8,10,1961,0,0
5182,ACGTCGAATCTAGGGA,89,97,8,10,1966,0,0
5184,ACGTCGAATCTAGGGA,90,97,7,8,106,0,0
5349,ACGTCGAATCTAGGGA,92,97,5,7,438,0,0
5354,ACGTCGACTCTAGGGA,92,97,5,10,797,0,0
5368,ACGTCGAATCTAGGGA,92,97,5,10,1400,0,0
5421,ACGTCGAATCTAGGGA,93,97,4,11,883,0,0
5422,ACGTCGAATCTCGGGA,93,97,4,11,906,0,0
5423,ACGTCGAATCAAGGGA,93,97,4,8,922,0,0
5424,ACGTCGACTCTAGGGA,93,97,4,11,1143,0,0
5425,ACGTCGAATCTAGGGA,93,97,4,11,1157,0,0
5427,ACGTCGAATCTAGGGA,93,97,4,11,1169,0,0
5429,ACGTCGACTCTAGGGA,93,97,4,11,1184,0,0
5430,ACGTCGAATCTAGGGA,93,97,4,11,1187,0,0
5431,GCGTCGAATCTAGGGA,93,97,4,11,1196,0,0
5432,ACGTCGACTCTAGGGA,93,97,4,11,1199,0,0
5433,ACGTCGAATCTAGGGA,93,97,4,11,1230,0,0
5434,ACGTCGAATCTAGGGA,93,97,4,11,1233,0,0
5435,ACGTCGACTCTAGGGA,93,97,4,11,1245,0,0
5436,ACGTCGAATCTAGGGA,93,97,4,11,1525,0,0
5437,ACGTCGCATCTAGGGA,93,97,4,8,1527,0,0
5440,ACGTCGAATCAAGGGA,93,97,4,8,1547,0,0
5442,ACGTCGAATCTAGGGA,93,97,4,14,1595,0,0
5443,ACGTCGAATCTAGGGA,93,97,4,11,1596,0,0
5444,ACGTCGAATCTAGGGA,93,97,4,11,1603,0,0
5445,ACGTCGAATCTAGGGA,93,97,4,11,1624,0,0
5446,ACGTCGAATCTAGGGA,93,97,4,11,1639,0,0
5447,ACGTCGAATCTAGGGA,93,97,4,11,1643,0,0
5449,ACGTCGAATCTACGGA,93,97,4,12,1721,0,0
5450,ACGTCGAATCTAGGGA,93,97,4,12,1724,0,0
5452,ACATCGAATCTAGGGA,93,97,4,12,1735,0,0
5453,ACGTCGAATCTAGGGA,93,97,4,12,1761,0,0
5454,ACGTCGGATCTAGGGA,93,97,4,9,1763,0,0
5455,ACGTCGACTCTAGGGA,93,97,4,12,1781,0,0
5456,ACGTCGAATCTAGGGA,93,97,4,12,1791,0,0
5457,ACGTCGAATCTAGGGA,93,97,4,12,1796,0,0
5458,ACGTCGAATCTAGGGA,93,97,4,9,1798,0,0
5460,ACGTGGACTCTAGGGA,93,97,4,12,1803,0,0
5461,ACGTCGAATCTAGGGA,93,97,4,10,1849,0,0
5463,ACGTCGACTCTAGGGA,93,97,4,10,1865,0,0
5464,ACGTCGAATCTAGGGA,93,97,4,10,1867,0,0
5466,ACGTCGACTCTAGGGA,93,97,4,10,3233,0,0
5468,ACGTGGAATCTAGGGA,93,97,4,10,3240,0,0
5469,CCGTCGACTCTAGGGA,93,97,4,10,3255,0,0
5471,ACGTCGACTCTAGGGA,93,97,4,13,3265,0,0
5473,ACGTCGAATCAAGGGA,93,97,4,10,3271,0,0
5474,ACGTCGAATCTAGGGA,93,97,4,10,3274,0,0
5478,ACGTCGACTCTAGGGA,93,97,4,10,3288,0,0
5479,ACGTCGAATCTAGGGA,93,97,4,10,3293,0,0
5489,ACGTCGAATCTAGGGA,94,97,3,9,982,0,0
5498,ACGTCGAATCTAGGGA,94,97,3,9,1673,0,0
5504,ACGTCGAAACTAGGGA,94,97,3,12,1717,0,0
5516,ACGTCGACTCTAGGGA,94,97,3,10,2495,0,0
5527,ACGTCGAATCTAGGGA,94,97,3,13,2533,0,0
5530,ACGTCGACTCTAGGGA,94,97,3,10,2566,0,0
5549,ACGTCGAATCTAGGGA,95,97,2,7,318,0,0
5555,ACGTCGACTCTAGGGA,95,97,2,10,797,0,0
5557,ACGTCGAATCTCGGGA,95,97,2,10,1049,0,0
5558,ACGTCGAATCAAGGGA,95,97,2,7,1091,0,0
5600,ACATCGGATCTAGGGA,95,97,2,10,3339,0,0
5605,ACGTCGACTCTAGGGA,95,97,2,13,3353,0,0
5606,ACGTCGAATCTAGGGA,95,97,2,13,3366,0,0
5610,ACGTCGAATCTATGGA,96,97,1,8,106,0,0
5619,ACGTCGAATCTCGGGA,96,97,1,11,906,0,0
5644,ACGTCGAATCTAGGGA,96,97,1,10,1849,0,0
5649,ACGTCGACTCTAGGGA,96,97,1,10,3233,0,0
790,ACGTCGACTCTAGGGA,64,98,34,9,285,10,0
797,ACGTCGACTCTAGGGA,64,98,34,9,308,10,0
1091,ACGTCGAATCAAGGGA,67,98,31,6,706,9,0
1169,ACGTCGAATCTAGGGA,68,98,30,10,471,9,0
1400,ACGTCGAATCTAGGGA,70,98,28,9,531,8,0
1487,ACGTCGAATCTAGGGA,70,98,28,9,1002,8,0
1721,ACGTCGAATCTACGGA,72,98,26,11,893,7,0
2009,ACGTCGAATCTAGGGA,73,98,25,12,1372,5,0
2533,ACGTCGAATCTAGGGA,76,98,22,12,1317,4,0
2554,ACGTCGAATCTAGGGA,76,98,22,12,1368,4,0
2625,ACGTCGAATCTAGGGA,76,98,22,12,1766,4,0
2703,ACGTCGAATCTAGGGA,77,98,21,10,791,3,0
2709,ACGTCGAATCTAGGGA,77,98,21,10,825,3,0
3233,ACGTCGACTCTAGGGA,79,98,19,9,386,2,0
3240,ACGTCGAATCTAGGGA,79,98,19,9,540,2,0
3288,ACGTCGACTCTAGGGA,79,98,19,9,1290,2,0
3334,ACGTCGAATCAAGGGA,79,98,19,9,1693,1,0
3345,ACGTCGAATCTAGGGA,79,98,19,9,1714,1,0
3382,ACGTCGAATCTAGGGA,79,98,19,12,1801,1,0
3492,ACGTCGAATCTAGGGA,79,98,19,12,2348,0,0
4928,ACGTCGAATCTAGGGA,86,98,12,10,597,0,0
5144,ACGTCGACTCTAGGGA,89,98,9,10,1396,0,0
5150,ACGTCGAATCTAGGGT,89,98,9,10,1423,0,0
5260,ACGTCGACTCTAGGGA,91,98,7,9,386,0,0
5263,ACGTCGAATCTAGGGA,91,98,7,9,533,0,0
5277,ACGTCGAATCTAGGGA,91,98,7,12,1292,0,0
5291,ACGTCGAAACTAGGGA,91,98,7,12,1717,0,0
5370,ACGTCGAATCTAGGGA,92,98,6,10,1416,0,0
5372,ACGTCGAATCTAGGGA,92,98,6,10,1439,0,0
5373,ACGTCGAATCTAGGGA,92,98,6,10,1448,0,0
5374,ACGTCGACTCTAGGGA,92,98,6,10,1458,0,0
5375,ACGTCGAATCTAGGGA,92,98,6,10,1487,0,0
5376,ACGTGGACTCTAGGGA,92,98,6,13,1506,0,0
5377,ACGTCGAATCTAGGGA,92,98,6,12,1815,0,0
5378,ACGTCGAATCTAGGGA,92,98,6,12,1825,0,0
5379,ACGTCGAATCTAGGGA,92,98,6,12,1834,0,0
5380,ACGTCGAATCAAGGGA,92,98,6,12,1839,0,0
5383,ACGTCGAATCTAGGGA,92,98,6,13,1895,0,0
5385,ACGTCGAATCTAGGGA,92,98,6,10,1899,0,0
5387,ACGTCGAATCTAGGGA,92,98,6,13,1918,0,0
5388,AGGTCGAATCTAGGGA,92,98,6,13,1930,0,0
5389,ACGTCGAATCTAGGGA,92,98,6,13,1935,0,0
5394,ACGTCGAATCTAGGGA,92,98,6,13,1973,0,0
5397,ACGTCGAATCTAGAGA,92,98,6,11,2034,0,0
5398,ACGTCGAATCTAGGGA,92,98,6,11,2037,0,0
5399,ACGTCGAATCTAGGGA,92,98,6,11,2682,0,0
5400,ACGTCGAATCTAGGGA,92,98,6,11,2686,0,0
5419,ACGTCGAATCTAGGGA,93,98,5,11,873,0,0
5502,ACGTCGAATCAAGGGA,94,98,4,9,1689,0,0
5532,ACGTCGAATCTAGGGA,94,98,4,13,2594,0,0
5556,ACGTCGAATCTAGGGA,95,98,3,10,830,0,0
5578,ACGTCGACTCTAGGGA,95,98,3,10,1937,0,0
5583,ACGTCGAATCTAGGGA,95,98,3,11,2016,0,0
5584,ACGTCGAATCAAGGGA,95,98,3,8,2018,0,0
5588,ACGTCGAATCTAGGGA,95,98,3,11,2692,0,0
5593,ACATCGAATCTAGGGA,95,98,3,11,2712,0,0
5601,ACGTCGAATCTAGGGA,95,98,3,10,3344,0,0
5607,ACGTCGAATCTAGGGA,95,98,3,13,3376,0,0
5623,ACGTCGACTCTAGGGA,96,98,2,8,1173,0,0
5625,ACGTCGACTCTAGGGA,96,98,2,11,1199,0,0
5630,ACGTCGAATCTAGGGA,96,98,2,11,1543,0,0
5638,ACGTCGAATCTAGGGA,96,98,2,12,1761,0,0
5643,ACGTCGAATCTAGGGA,96,98,2,12,1802,0,0
5675,ACGTCGAATCTAGGGA,97,98,1,12,1291,0,0
5697,ACGTCGACTCTAGGGA,97,98,1,10,2495,0,0
5702,ACGTCGACTCTAGGGA,97,98,1,10,2525,0,0
5715,ACGTCGAATCAAGCGA,97,98,1,10,2654,0,0
5718,ACGTCGAATCTAGGGA,97,98,1,11,2727,0,0
5724,ACGTCGAATCTAGGGA,97,98,1,13,3452,0,0
830,ACGTCGAATCTAGGGA,64,99,35,9,532,11,0
1173,ACGTCGACTCTAGGGA,68,99,31,7,580,9,0
1353,ACGTCGAATCTAGGGA,69,99,30,11,914,9,0
1624,ACGTCGAATCTAGGGA,71,99,28,10,1082,8,0
1867,ACGTCGAATCTAGGGA,73,99,26,9,553,6,0
2506,ACGTCGAATCTAGGGA,76,99,23,9,1265,4,0
2539,ACGTCGACTCTAGGGA,76,99,23,9,1326,4,0
2566,ACGTCGACTCTAGGGA,76,99,23,9,1674,4,0
2600,ACGTCGAATCTAGGGA,76,99,23,12,1723,4,0
3348,ACGTCGACTCTAGGGA,79,99,20,9,1718,2,0
3424,ACGTCGGATCTAGGGA,79,99,20,9,2238,1,0
3438,ACGTCGAATCTAGGGA,79,99,20,12,2257,1,0
3456,ACGTCGAATCTAGGGA,79,99,20,12,2289,1,0
3461,ACGTCGAATCTAGGGA,79,99,20,12,2295,1,0
4302,ACGTCGAATCTAGGGA,82,99,17,12,764,1,0
5128,ACGTCGACTCTAGGGA,89,99,10,10,790,0,0
5136,ACGTCGAATCAAGGGA,89,99,10,7,1091,0,0
5145,ACGTCGAATCTAGGGA,89,99,10,10,1400,0,0
5155,ACGTCGACTCTAGGGA,89,99,10,10,1458,0,0
5159,ACGTCGAATCTAGGGA,89,99,10,12,1815,0,0
5162,ACGTCGAATCTAGGGA,89,99,10,12,1834,0,0
5187,ACGTCGAATCTAGGGA,90,99,9,8,361,0,0
5417,ACGTCGAATCAAGGGA,93,99,6,8,663,0,0
5418,ACGTCGAATCTAGGGA,93,99,6,8,675,0,0
5483,ACGTCGAATCTAGGGA,94,99,5,9,533,0,0
5492,ACGTCGAATCTAGGGA,94,99,5,9,1277,0,0
5510,ACGTCGAATCTAGGGA,94,99,5,13,2009,0,0
5537,ACGTCGGATCTAGGGA,94,99,5,10,2624,0,0
5551,ACGTCGAATCTAGGGA,95,99,4,7,438,0,0
5552,ACGTCGGATCTAGGGA,95,99,4,10,475,0,0
5553,ACGTCGAATCTAGGGA,95,99,4,10,597,0,0
5554,ACGTCGACTCTAGGGA,95,99,4,10,790,0,0
5559,ACGTCGAATCTAGGGA,95,99,4,10,1105,0,0
5560,ACGTCGAATCAAGGGA,95,99,4,10,1119,0,0
5561,ACGTCGAATCTAGGGA,95,99,4,10,1382,0,0
5562,ACGTCGAATCTAGGGA,95,99,4,10,1400,0,0
5563,ACGTCGAATCTAGGGA,95,99,4,10,1415,0,0
5564,ACGTCGAATCTAGGGA,95,99,4,10,1439,0,0
5566,ACGTCGAATCTAGGGA,95,99,4,10,1487,0,0
5567,ACGTGGACTCTAGGGA,95,99,4,13,1506,0,0
5568,ACGTCGAATCTAGGGA,95,99,4,12,1815,0,0
5569,ACGTCGAATCTAGGGA,95,99,4,12,1825,0,0
5570,ACGTCGAATCTAGGGA,95,99,4,12,1834,0,0
5571,ACGTCGAATCAAGGGA,95,99,4,12,1839,0,0
5572,ACGTCGACTCTAGGGA,95,99,4,10,1879,0,0
5573,ACGTCGAATCAAGGGA,95,99,4,10,1893,0,0
5574,ACGTCGAATCTAGGGA,95,99,4,10,1899,0,0
5575,ACGTCGACTCTAGGGA,95,99,4,10,1916,0,0
5576,ACGTAGAATCTAGGGA,95,99,4,13,1918,0,0
5577,AGGTCGAATCTAGGGA,95,99,4,13,1930,0,0
5579,ACGTCGAATCTAGGGA,95,99,4,13,1951,0,0
5580,ACGTCGAATCTAGGGA,95,99,4,13,1957,0,0
5581,ACTTCGACTCTAGGGA,95,99,4,13,1962,0,0
5582,ACGTCGAATCTAGGGA,95,99,4,13,1973,0,0
5585,ACGTCGAATCTAGGGA,95,99,4,11,2034,0,0
5586,ACGTCGAATCTAGGGA,95,99,4,11,2682,0,0
5589,ACGTCGAATCTAGGGA,95,99,4,11,2696,0,0
5590,ACGTCGAATCTAGGGA,95,99,4,11,2697,0,0
5591,ACGTCGAATCTAGGGA,95,99,4,11,2703,0,0
5592,ACGTCGAATCTAGGGA,95,99,4,11,2709,0,0
5594,GCGTCGAATCTAGGGA,95,99,4,13,3300,0,0
5595,ACGTCGACTCTAGGGA,95,99,4,13,3303,0,0
5597,ACGTCGAATCTAGGGA,95,99,4,10,3321,0,0
5598,ACGTCGAATCTAGGGA,95,99,4,10,3324,0,0
5599,ACGTCGAATCAAGGGA,95,99,4,10,3334,0,0
5602,ACGTCGAATCTAGGGA,95,99,4,10,3345,0,0
5603,ACGTCGACTCTAGGGA,95,99,4,10,3348,0,0
5604,ACGTCGAATCAAGGGA,95,99,4,10,3350,0,0
5608,ACGTCGAATCTAGGGA,95,99,4,13,3382,0,0
5609,ACGTCGAATCTAGGGA,95,99,4,10,3405,0,0
5613,ACGTCGAATCTAGGGA,96,99,3,8,379,0,0
5614,ACGTCGAATCAAGGGA,96,99,3,8,663,0,0
5621,ACGTCGAATCTAGGGA,96,99,3,11,1167,0,0
5633,ACGTCGAATCTAGGGA,96,99,3,11,1624,0,0
5648,ACGTCGAATCTAGGGA,96,99,3,10,1875,0,0
5656,ACGTCGAATCTAGGGA,96,99,3,10,3274,0,0
5677,ACGTCGAATCTAGGGA,97,99,2,12,1324,0,0
5679,ACGTCGAATCTAGGGA,97,99,2,12,1353,0,0
5680,ACGTCGAATCTAGGGA,97,99,2,9,1673,0,0
5683,ACGTCGAATCAAGGGA,97,99,2,9,1684,0,0
5688,ACGTCGACTCTAGGGA,97,99,2,13,1980,0,0
5691,ACGTCGAATCTAGGGA,97,99,2,13,2009,0,0
5698,ACGTCGAATCTAGGGA,97,99,2,10,2506,0,0
5706,ACGTCGAATCTAGGGA,97,99,2,13,2554,0,0
5716,ACGTCGAATCTAGGGA,97,99,2,13,2672,0,0
5738,ACGTCGGATCTAGGGA,98,99,1,10,475,0,0
5740,ACGTCGAATCTAGGGA,98,99,1,10,830,0,0
5741,ACGTCGAATCTAGGGA,98,99,1,10,1105,0,0
5757,ACGTCGAATCTAGGGA,98,99,1,13,1957,0,0
5759,ACGTCGAATCTAGGGA,98,99,1,13,1973,0,0
5774,ACGTCGACTCTAGGGA,98,99,1,12,4765,0,0
106,ACGTCGAATCTAGGGA,44,100,56,7,58,18,1
259,ACGTCGAATCTAGGGA,53,100,47,7,73,15,1
342,ACGTCGAATCTAGGGA,55,100,45,9,218,14,1
361,ACGTCGAATCTAGGGA,56,100,44,7,166,14,1
379,ACGTCGAATCTAGGGA,56,100,44,7,246,14,1
386,ACGTCGACTCTAGGGA,57,100,43,8,103,13,1
438,ACGTCGAATCTAGGGA,58,100,42,6,116,13,1
475,ACGTCGGATCTAGGGA,58,100,42,9,315,13,1
522,ACGTCGACTCTAGGGA,60,100,40,8,80,12,1
533,ACGTCGAATCTAGGGA,60,100,40,8,186,12,1
597,ACGTCGAATCTAGGGA,61,100,39,9,286,12,1
663,ACGTCGAATCAAGGGA,62,100,38,7,322,12,1
675,ACGTCGAATCTAGGGA,62,100,38,7,430,12,1
735,ACGTCGAATCTAGGGA,63,100,37,8,355,11,1
759,ACGTCGAATCAAGGGA,63,100,37,8,493,11,1
764,ACGTCGAATCTAGGGA,63,100,37,11,500,11,1
873,ACGTCGAATCTAGGGA,65,100,35,10,243,11,1
880,ACGTCGAATCTAGGGA,65,100,35,10,339,11,1
883,ACGTCGAATCTAGGGA,65,100,35,10,345,11,1
906,ACGTCGAATCTCGGGA,65,100,35,10,474,11,1
922,ACGTCGAATCAAGGGA,65,100,35,7,599,11,1
1105,ACGTCGAATCTAGGGA,67,100,33,9,730,10,1
1119,ACGTCGAATCAAGGGA,67,100,33,9,747,10,1
1167,ACGTCGAATCTAGGGA,68,100,32,10,469,10,1
1196,GCGTCGAATCTAGGGA,68,100,32,10,624,10,1
1230,ACGTCGAATCTAGGGA,68,100,32,10,814,10,1
1274,ACGTCGACTCTAGGGA,69,100,31,8,353,9,1
1291,ACGTCGAATCTAGGGA,69,100,31,11,510,9,1
1292,ACGTCGAATCTAGGGA,69,100,31,11,512,9,1
1324,ACGTCGAATCTAGGGA,69,100,31,11,873,9,1
1325,ACGTCGAATCTAGGGA,69,100,31,8,875,9,1
1382,ACGTCGAATCTAGGGA,70,100,30,9,297,9,1
1415,ACGTCGAATCTAGGGA,70,100,30,9,571,9,1
1439,ACGTCGAATCTAGGGA,70,100,30,9,750,9,1
1448,ACGTCGAATCTAGGGA,70,100,30,9,763,9,1
1506,ACGTGGACTCTAGGGA,70,100,30,12,1027,9,1
1527,ACGTCGCATCTAGGGA,71,100,29,7,437,9,1
1538,GCGTCGAATCTAGGGA,71,100,29,10,470,9,1
1543,ACGTCGAATCTAGGGA,71,100,29,10,586,9,1
1595,ACGTCGAATCTAGGGA,71,100,29,13,857,9,1
1596,ACGTCGAATCTAGGGA,71,100,29,10,858,9,1
1656,ACGTCGAATCTAGGGA,71,100,29,10,1134,9,1
1673,ACGTCGAATCTAGGGA,72,100,28,8,351,8,1
1674,ACGTCGACTCTAGGGA,72,100,28,8,360,8,1
1683,ACGTCGAATCTAGGGA,72,100,28,8,491,8,1
1684,ACGTCGAATCAAGGGA,72,100,28,8,493,8,1
1689,ACGTCGAATCAAGGGA,72,100,28,8,519,8,1
1695,ACGTCGCATCTAGGGA,72,100,28,8,678,8,1
1717,ACGTCGAAACTAGGGA,72,100,28,11,883,8,1
1718,ACGTCGACTCTAGGGA,72,100,28,8,885,8,1
1735,ACGTCGAATCTAGGGA,72,100,28,11,918,8,1
1761,ACGTCGAATCTAGGGA,72,100,28,11,1157,8,1
1763,ACGTCGGATCTAGGGA,72,100,28,8,1159,8,1
1781,ACGTCGACTCTAGGGA,72,100,28,11,1184,8,1
1791,ACGTCGAATCTAGGGA,72,100,28,11,1197,8,1
1796,ACGTCGAATCTAGGGA,72,100,28,11,1203,8,1
1815,ACGTCGAATCTAGGGA,72,100,28,11,1225,7,1
1825,ACGTCGAATCTAGGGA,72,100,28,11,1239,7,1
1839,ACGTCGAATCAAGGGA,72,100,28,11,1258,7,1
1849,ACGTCGAATCTAGGGA,73,100,27,9,399,7,1
1865,ACGTCGACTCTAGGGA,73,100,27,9,547,7,1
1875,ACGTCGAATCTAGGGA,73,100,27,9,708,7,1
1893,ACGTCGAATCAAGGGA,73,100,27,9,759,6,1
1916,ACGTCGACTCTAGGGA,73,100,27,9,997,6,1
1918,ACGTCGAATCTAGGGA,73,100,27,12,1000,6,1
1930,AGGTCGAATCTAGGGA,73,100,27,12,1028,6,1
1937,ACGTCGACTCTAGGGA,73,100,27,9,1261,6,1
1951,ACGTCGAATCTAGGGA,73,100,27,12,1285,6,1
1957,ACGTCGAATCTAGGGA,73,100,27,12,1291,6,1
1962,ACTTCGACTCTAGGGA,73,100,27,12,1297,6,1
1973,ACGTCGAATCTAGGGA,73,100,27,12,1315,6,1
1980,ACGTCGACTCTAGGGA,73,100,27,12,1323,5,1
1990,ACGTCGAATCTAGGGA,73,100,27,12,1337,5,1
1995,ACGTCGAATCTCGGGA,73,100,27,12,1348,5,1
2016,ACGTCGAATCTAGGGA,74,100,26,10,339,5,1
2018,ACGTCGAATCAAGGGA,74,100,26,7,343,5,1
2440,ACGTCGAATCTAGGGA,76,100,24,9,122,4,1
2454,ACGTCGAATCTAGGGA,76,100,24,9,540,4,1
2481,ACGTCGAATCTAGGGA,76,100,24,9,967,4,1
2491,ACGTCGAATCAAGGGA,76,100,24,9,995,4,1
2492,ACGTCGAATCTAGGGA,76,100,24,9,999,4,1
2495,ACGTCGACTCTAGGGA,76,100,24,9,1010,4,1
2510,ACGTCGAATCTAGGGA,76,100,24,9,1277,4,1
2517,ACGTCGAATCTAGGGA,76,100,24,12,1291,4,1
2518,ACGTCGAATCTAGGGA,76,100,24,12,1292,4,1
2525,ACGTCGACTCTAGGGA,76,100,24,9,1303,4,1
2526,ACATCGGATCTAGGGA,76,100,24,9,1308,4,1
2594,ACGTCGAATCTAGGGA,76,100,24,12,1716,4,1
2609,ACGTCGAATCTAGGGA,76,100,24,12,1735,4,1
2624,ACGTCGGATCTAGGGA,76,100,24,9,1763,4,1
2635,ACGTCGACTCTAGGGA,76,100,24,12,1781,4,1
2644,ACGTCGAATCTAGGGA,76,100,24,12,1793,4,1
2654,ACGTCGAATCAAGCGA,76,100,24,9,1808,4,1
2672,ACGTCGAATCTAGGGA,76,100,24,12,1832,4,1
2686,ACGTCGAATCTAGGGA,77,100,23,10,448,4,1
2696,ACGTCGAATCTAGGGA,77,100,23,10,603,4,1
2723,ACGTCGAATCTAGGGA,77,100,23,10,1062,3,1
2727,ACGTCGAATCTAGGGA,77,100,23,10,1067,3,1
2731,ACGTCGAATCTAGGGA,77,100,23,10,1081,3,1
3238,ACGTCGAATCTAGGGA,79,100,21,9,533,3,1
3255,CCGTCGACTCTAGGGA,79,100,21,9,753,3,1
3265,ACGTCGACTCTAGGGA,79,100,21,12,979,3,1
3270,ACATCGAATCAAGGGA,79,100,21,9,988,3,1
3271,ACGTCGAATCAAGGGA,79,100,21,9,995,3,1
3274,ACGTCGAATCTAGGGA,79,100,21,9,1005,3,1
3278,ACGTCGAATCAAGGGA,79,100,21,9,1030,3,1
3282,ACGCCGACTCTAGGGA,79,100,21,9,1271,3,1
3284,ACGTCGTATCTAGGGA,79,100,21,9,1277,3,1
3298,ACGTCGAATCAAGGGA,79,100,21,9,1313,3,1
3300,GCGTCGAATCTAGGGA,79,100,21,12,1316,2,1
3303,ACGTCGACTCTAGGGA,79,100,21,12,1323,2,1
3311,AAGTCGGATCTAGGGA,79,100,21,9,1350,2,1
3321,ACGTCGAATCTAGGGA,79,100,21,9,1663,2,1
3324,ACGTCGAATCTAGGGA,79,100,21,9,1673,2,1
3339,ACATCGGATCTAGGGA,79,100,21,9,1698,2,1
3350,ACGTCGAATCAAGGGA,79,100,21,9,1720,2,1
3376,ACGTCGAATCTAGGGA,79,100,21,12,1791,2,1
3405,ACGTCGAATCTAGGGA,79,100,21,9,2209,2,1
3431,ACGTCGAATCAAGGGA,79,100,21,9,2249,1,1
3447,ACGTCGAATCAAGTGA,79,100,21,9,2270,1,1
3452,ACGTCGAATCTAGGGA,79,100,21,12,2282,1,1
3479,ACGTCGAATCTAGGGA,79,100,21,12,2322,1,1
3486,ACGTCGAATCTAGGGA,79,100,21,12,2335,1,1
3489,ACGTCGAATCTAGGGA,79,100,21,15,2341,1,1
4281,ACGTCGACTCTAGGGA,82,100,18,9,302,2,1
4286,ACGTCGAATCTAGGGA,82,100,18,9,424,2,1
4294,ACGTCGACTCTAGGGA,82,100,18,12,568,2,1
4298,ACGTCGAATCTAGGGA,82,100,18,9,738,2,1
4304,ACGTCGAATCAAGGGA,82,100,18,6,949,2,1
4688,ACGTCGAATCTAGGGA,83,100,17,7,318,1,1
4700,ACGTCGACTCTAGGGA,83,100,17,10,634,1,1
4705,ACGTCGAATCTAGGGA,83,100,17,10,791,1,1
4713,ACGTCGACTCTAGGGA,83,100,17,10,1055,1,1
4717,ACGTCGAATCTAGGGA,83,100,17,10,1066,1,1
4729,ACGTCGAATCTAGGGA,83,100,17,13,1139,1,1
4765,ACGTCGACTCTAGGGA,84,100,16,11,281,1,1
4770,ACGTCGAATCTAGGGA,84,100,16,8,661,1,1
4771,ACGTCGAATCAAGGGA,84,100,16,8,663,1,1
4921,ACGTCGAATCAAGGGA,86,100,14,7,343,1,1
4925,ACGTCGACTCTAGGGA,86,100,14,10,466,1,1
4926,ACGTCGGATCTAGGGA,86,100,14,10,475,1,1
4927,AAGTCGGATCTAGGGA,86,100,14,7,583,1,1
4932,ACGTCGACTCTAGGGA,86,100,14,10,790,0,1
4933,ACGTCGACTCTAGGGA,86,100,14,10,797,0,1
4939,ACGTCGACTCTAGGGA,86,100,14,10,1055,0,1
4941,ACGTCGAATCTAGGGA,86,100,14,10,1062,0,1
4947,ACGTCGAATCTAGTGA,86,100,14,10,1108,0,1
4952,ACGTCGAATCTAGGGA,86,100,14,13,1139,0,1
4954,ACGTCGAATCAAGGGA,86,100,14,7,1379,0,1
4955,ACGTCGAATCTAGGGA,86,100,14,10,1382,0,1
4956,ACGTCGACTCTAGGGA,86,100,14,10,1386,0,1
4959,ACGTCGAATCTAGGGA,86,100,14,10,1400,0,1
4962,ACGTCGAATCTAGGGA,86,100,14,10,1416,0,1
4964,ACGTCGAATCTAGGGA,86,100,14,10,1423,0,1
4966,ACGTCGAATCAAGGGA,86,100,14,10,1438,0,1
4967,ACGTCGAATCTAGGGA,86,100,14,10,1439,0,1
4970,ACATCGAATCAAGGGA,86,100,14,10,1480,0,1
4973,ACGTCGAATCTAGGGA,86,100,14,13,1504,0,1
4983,ACGTCGAATCAAGGGA,87,100,13,8,663,1,1
4985,ACGTCGAATCTAGGGA,87,100,13,11,685,1,1
4986,ACGTCGAATCAAGGGA,87,100,13,8,870,1,1
4989,ACGTCGAATCTAGGGA,87,100,13,11,880,1,1
4991,ACGTCGGATCTAGGGA,87,100,13,8,894,1,1
4992,ACGTCGAATCTCGGGA,87,100,13,11,906,1,1
4994,ACGTCGAATCTAGGGA,87,100,13,11,913,0,1
4996,ACGTCGAATCTAGGGT,87,100,13,11,925,0,1
5001,ACGTCGAATCTAGGGA,87,100,13,11,1169,0,1
5120,ACGTCGAATCTAGGGA,89,100,11,10,342,0,1
5125,ACGTCGAATCTAGGGA,89,100,11,10,597,0,1
5129,ACGTCGACTCTAGGGA,89,100,11,10,797,0,1
5133,ACGTCGAATCTAGGGA,89,100,11,10,1062,0,1
5134,ACGTCGACTCTAGGGA,89,100,11,10,1065,0,1
5138,ACGTCGAATCTAGGGA,89,100,11,10,1106,0,1
5147,ACGTCGAATCTAGGGA,89,100,11,10,1415,0,1
5152,ACGTCGAATCAAGGGA,89,100,11,10,1438,0,1
5154,ACGTCGAATCTAGGGA,89,100,11,10,1448,0,1
5157,ACGTCGAATCTAGGGA,89,100,11,10,1487,0,1
5186,ACGTCGACTCTAGGGA,90,100,10,11,281,0,1
5188,ACGTCGAATCTAGGGA,90,100,10,8,379,0,1
5189,ACGTCGACTCTAGGGA,90,100,10,8,660,0,1
5190,ACGTCGAATCTAGGGA,90,100,10,8,661,0,1
5191,ACGTCGAATCAAGGGA,90,100,10,8,663,0,1
5261,ACATCGAATCTAGGGA,91,100,9,9,424,0,1
5264,ACGTCGAGTCTAGGGA,91,100,9,9,735,0,1
5265,ACGTCGACTCTAGGGA,91,100,9,9,737,0,1
5267,ACGTCGAATCAAGGGA,91,100,9,9,759,0,1
5269,ACGTCGAATCAAGGGA,91,100,9,6,949,0,1
5270,ACGTCGAATCTAGGGA,91,100,9,9,982,0,1
5273,ACGTCGAATCAAGGGA,91,100,9,6,1260,0,1
5276,ACGTCGAATCTAGGGA,91,100,9,12,1291,0,1
5279,ACGTCGACTCTAGGGA,91,100,9,12,1314,0,1
5281,ACGTCGAATCTAGGGA,91,100,9,12,1324,0,1
5282,ACGTCGAATCTAGGGA,91,100,9,9,1325,0,1
5286,ACGTCGACTCTAGGGA,91,100,9,9,1674,0,1
5290,ACGTCGCATCTAGGGA,91,100,9,9,1695,0,1
5296,ACGTCGAATCTAGGGA,91,100,9,13,1987,0,1
5297,ACGTCGAATCTTGGGA,91,100,9,13,1990,0,1
5346,ACGTCGAATCTAGGGA,92,100,8,7,318,0,1
5347,ACGTCGAATCTAGGGA,92,100,8,10,342,0,1
5350,ACGTCGGATCTAGGGA,92,100,8,10,475,0,1
5352,ACGTCGACTCTAGGGA,92,100,8,7,778,0,1
5353,ACGTCGACCCTAGGGA,92,100,8,10,790,0,1
5355,ACGTCGAATCTAGGGA,92,100,8,10,830,0,1
5358,ACGTCGAATCTAGGGA,92,100,8,10,1062,0,1
5360,ACGTCGACTCTAGGGA,92,100,8,10,1076,0,1
5361,ACGTCGAATCAAGGGA,92,100,8,7,1091,0,1
5363,ACGTCGAATCTAGGGA,92,100,8,10,1106,0,1
5364,ACGTCGAATCAAGGGA,92,100,8,10,1119,0,1
5365,ACGTCGAATCTAGGGA,92,100,8,13,1139,0,1
5366,ACGTCGAATCAAGGGA,92,100,8,7,1379,0,1
5367,ACGTCGAATCTAGGGA,92,100,8,10,1382,0,1
5369,ACGTCGAATCTAGGGA,92,100,8,10,1415,0,1
5410,ACGTCGAATCTAGGGA,93,100,7,8,106,0,1
5411,ACGTCGAATCTAGGGA,93,100,7,8,259,0,1
5412,ACGTCGACTCTAGGGA,93,100,7,11,281,0,1
5414,ACGTCGAATCTAGGGA,93,100,7,8,379,0,1
5416,ACGTCGAATCTAGGGA,93,100,7,8,661,0,1
5482,ACGTCGACTCTAGGGA,94,100,6,9,522,0,1
5484,ACGTCGAATCTAGGGA,94,100,6,9,735,0,1
5485,ACGTCGAATCAAGGGA,94,100,6,9,752,0,1
5486,ACGTCGAATCAAGGGA,94,100,6,9,759,0,1
5487,ACGTCGAATCTAGGGA,94,100,6,12,764,0,1
5488,ACGTCGAATCAAGGGA,94,100,6,6,949,0,1
5490,ACGTCGAATCAAGGGA,94,100,6,6,1260,0,1
5491,ACGTCGACTCTAGGGA,94,100,6,9,1274,0,1
5493,ACGTCGAATCTAGGGA,94,100,6,12,1291,0,1
5494,ACGTCGAATCTAGGGA,94,100,6,12,1292,0,1
5495,ACGTCGAATCTAGGGA,94,100,6,12,1324,0,1
5497,ACGTCGAATCTAGGGA,94,100,6,12,1353,0,1
5499,ACGTCGACTCTAGGGA,94,100,6,9,1674,0,1
5500,ACGTCGAATCTAGGGA,94,100,6,9,1683,0,1
5503,ACGTCGCATCTAGGGA,94,100,6,9,1695,0,1
5505,ACGTCGACTCTAGGGA,94,100,6,9,1718,0,1
5506,ACGTCGAATCAAGGGA,94,100,6,9,1720,0,1
5508,ACGTCGAATCTAGGGA,94,100,6,13,1990,0,1
5509,ACGTCGAATCTCGGGA,94,100,6,13,1995,0,1
5511,ACGTCGAATCTAGGGA,94,100,6,10,2440,0,1
5512,ACGTCGAATCTAGGGA,94,100,6,10,2454,0,1
5514,ACGTCGAATCAAGGGA,94,100,6,10,2491,0,1
5515,ACGTCGAATCTAGGGA,94,100,6,10,2492,0,1
5517,ACGTCGAATCAAGGGA,94,100,6,10,2501,0,1
5518,ACGTCGAATCTAGGGA,94,100,6,10,2506,0,1
5519,ACGTCGAATCTAGGGA,94,100,6,10,2510,0,1
5520,ACGTCGAATCTAGGGA,94,100,6,10,2513,0,1
5521,ACGTCGAATCTAGGGA,94,100,6,13,2514,0,1
5522,ACGTCGAATCTAGGGA,94,100,6,13,2517,0,1
5525,ACATCGGATCTAGGGA,94,100,6,10,2526,0,1
5526,ACGTCGAATCTAGGCA,94,100,6,13,2531,0,1
5528,ACGTCGACTCTAGGGA,94,100,6,10,2539,0,1
5529,ACGTCGAATCTAGGGA,94,100,6,13,2554,0,1
5531,ACGTCGACTCTAGGGA,94,100,6,10,2569,0,1
5534,ACGTCGAATCTAGGGA,94,100,6,13,2600,0,1
5535,ACGTCGAATCTAGGGA,94,100,6,13,2609,0,1
5536,ACGTCGAATCTAGGGA,94,100,6,13,2611,0,1
5538,ACGTCGAATCTAGGGA,94,100,6,13,2625,0,1
5540,ACGTCGAATCTAGGGA,94,100,6,13,2644,0,1
5541,ACGTCGAATCAAGCGA,94,100,6,10,2654,0,1
5542,ACGTCGACTCTAGGGA,94,100,6,13,2661,0,1
5543,ACGTCGAATCTAGGGA,94,100,6,13,2672,0,1
5545,ACGTCGAATCTAGGGA,94,100,6,11,2723,0,1
5546,ACGTCGAATCTAGGGA,94,100,6,11,2727,0,1
5547,ACGTCGAATCTAGGGA,94,100,6,11,2728,0,1
5548,ACGTCGAATCTAGGGA,94,100,6,11,2731,0,1
5550,ACGTCGAATCTAGGGA,95,100,5,10,342,0,1
5611,ACGTCGAATCTAGGGA,96,100,4,8,259,0,1
5612,ACGTCGAATCTAGGGA,96,100,4,8,361,0,1
5615,ACGTCGAATCTAGGGA,96,100,4,8,675,0,1
5616,ACGTCGAATCTAGGGA,96,100,4,11,873,0,1
5617,ACGGCGAATCTAGGGA,96,100,4,11,880,0,1
5618,ACGTCGAATCTAGGGA,96,100,4,11,883,0,1
5620,ACGTCGAATCAAGGGA,96,100,4,8,922,0,1
5622,ACGTCGAATCTAGGGA,96,100,4,11,1169,0,1
5624,GCGTCGAATCTAGGGA,96,100,4,11,1196,0,1
5626,ACGTCGAATCTAGGGA,96,100,4,11,1230,0,1
5627,ACGTCGAATCTAGGGA,96,100,4,11,1233,0,1
5628,ACGTCGCATCTAGGGA,96,100,4,8,1527,0,1
5629,GCGTCGAATCTAGGGA,96,100,4,11,1538,0,1
5631,ACGTCGAATCTAGGGA,96,100,4,14,1595,0,1
5632,ACGTCGAATCTAGGGA,96,100,4,11,1596,0,1
5634,ACGTCGAATCTAGGGA,96,100,4,11,1643,0,1
5635,ACGTCGAATCTAGGGA,96,100,4,11,1656,0,1
5636,ACGTCGAATCTACGGA,96,100,4,12,1721,0,1
5637,ACGTCGAATCTAGGGA,96,100,4,12,1735,0,1
5639,ACGTCGGATCTAGGGA,96,100,4,9,1763,0,1
5640,ACGTCGACTCTAGGGA,96,100,4,12,1781,0,1
5641,ACGTCGAATCTAGGGA,96,100,4,12,1791,0,1
5642,ACGTCGAATCTAGGGA,96,100,4,12,1796,0,1
5645,ACGTCGAATCAAGGGA,96,100,4,10,1854,0,1
5646,ACGTCGACTCTAGGGA,96,100,4,10,1865,0,1
5647,ACGTCGAATCTAGGGA,96,100,4,10,1867,0,1
5650,ACGTCGAATCTAGGGA,96,100,4,10,3238,0,1
5651,ACGTCGAATCTAGGGA,96,100,4,10,3240,0,1
5652,CCGTCGACTCTAGGGA,96,100,4,10,3255,0,1
5653,ACGTCGACTCTAGGGA,96,100,4,13,3265,0,1
5654,ACATCGAATCAAGGGA,96,100,4,10,3270,0,1
5655,ACGTCGAATCAAGGGA,96,100,4,10,3271,0,1
5657,ACGTCGAATCAAGGGA,96,100,4,10,3278,0,1
5658,ACGCCGACTCTAGGGA,96,100,4,10,3282,0,1
5659,ACGTCGTATCTAGGGA,96,100,4,10,3284,0,1
5660,ACGTCGACTCTAGGGA,96,100,4,10,3288,0,1
5661,ACGTCGAATCAAGGGA,96,100,4,10,3298,0,1
5662,ACGTCGACTCTAGGGA,96,100,4,10,4281,0,1
5663,ACGTCGAATCTAGGGA,96,100,4,10,4286,0,1
5664,ACGTCGACTCTAGGGA,96,100,4,13,4294,0,1
5665,ACGTCGAATCTAGGGA,96,100,4,10,4298,0,1
5666,ACGTCGAATCTAGGGA,96,100,4,13,4302,0,1
5667,ACGTCGAATCAAGGGA,96,100,4,7,4304,0,1
5668,ACGTCGACTCTAGGGA,97,100,3,9,386,0,1
5669,ACGTCGACTCTAGGGA,97,100,3,9,522,0,1
5670,ACGTCGAATCTAGGGA,97,100,3,9,533,0,1
5671,ACGTCGAATCTAGGGA,97,100,3,9,735,0,1
5672,ACGTCGAATCAAGGGA,97,100,3,9,759,0,1
5673,ACGTCGAATCTAGGGA,97,100,3,12,764,0,1
5674,ACGTCGACTCTAGGGA,97,100,3,9,1274,0,1
5676,ACGTCGAATCTAGGGA,97,100,3,12,1292,0,1
5678,ACGTCGAATCTAGGGA,97,100,3,9,1325,0,1
5681,ACGTCGACTCTAGGGA,97,100,3,9,1674,0,1
5682,ACGTCGAATCTAGGGA,97,100,3,9,1683,0,1
5684,ACGTCGAATCAAGGGA,97,100,3,9,1689,0,1
5685,ACGTCGCATCTAGGGA,97,100,3,9,1695,0,1
5686,ACGTCGAAACTAGGGA,97,100,3,12,1717,0,1
5687,ACGTCGACTCTAGGGA,97,100,3,9,1718,0,1
5689,ACGTCGAATCTAGGGA,97,100,3,13,1990,0,1
5690,ACGTCGAATCTCGGGA,97,100,3,13,1995,0,1
5692,ACGTCGAATCTAGGGA,97,100,3,10,2440,0,1
5693,ACGTCGAATCTAGGGA,97,100,3,10,2454,0,1
5694,ACGTCGAATCTAGGGA,97,100,3,10,2481,0,1
5695,ACGTCGAATCAAGGGA,97,100,3,10,2491,0,1
5696,ACGTCGAATCTAGGGA,97,100,3,10,2492,0,1
5699,ACGTCGAATCTAGGGA,97,100,3,10,2510,0,1
5700,ACGTCGAATCTAGGGA,97,100,3,13,2517,0,1
5701,ACGTCGAATCTAGGGA,97,100,3,13,2518,0,1
5703,ACATCGGATCTAGGGA,97,100,3,10,2526,0,1
5704,ACGTCGAATCTAGGGA,97,100,3,13,2533,0,1
5705,ACGTCGACTCTAGGGA,97,100,3,10,2539,0,1
5707,ACGTCGACTCTAGGGA,97,100,3,10,2566,0,1
5708,ACGTCGAATCTAGGGA,97,100,3,13,2594,0,1
5709,ACGTCGAATCTAGGGA,97,100,3,13,2600,0,1
5710,ACGTCGAATCTAGGGA,97,100,3,13,2609,0,1
5711,ACGTCGGATCTAGGGA,97,100,3,10,2624,0,1
5712,ACGTCGAATCTAGGGA,97,100,3,13,2625,0,1
5713,ACGTCGACTCTAGGGA,97,100,3,13,2635,0,1
5714,ACGTCGAATCTAGGGA,97,100,3,13,2644,0,1
5717,ACGTCGAATCTAGGGA,97,100,3,11,2723,0,1
5719,ACGTCGAATCTAGGGA,97,100,3,11,2731,0,1
5720,ACGTCGGATCTAGGGA,97,100,3,10,3424,0,1
5721,ACGTCGAATCAACGGA,97,100,3,10,3431,0,1
5722,ACGTCGAATCTAGGGA,97,100,3,13,3438,0,1
5723,ACGTCGAATCAAGTGA,97,100,3,10,3447,0,1
5725,ACGTCGAATCTAGGGA,97,100,3,13,3456,0,1
5726,ACGTCGAATCTAGGGA,97,100,3,13,3461,0,1
5727,ACGTCGAATCTAGGGA,97,100,3,13,3479,0,1
5728,ACGTCGAATCTAGGGA,97,100,3,13,3486,0,1
5729,ACGTCGAATCTAGGGA,97,100,3,16,3489,0,1
5730,ACGTCGAATCTAGGGA,97,100,3,8,4688,0,1
5731,ACGTCGACTCTAGGGA,97,100,3,11,4700,0,1
5732,ACGTCGAATCTAGGGA,97,100,3,11,4705,0,1
5733,ACGTCGACTCTAGGGA,97,100,3,11,4713,0,1
5734,ACGTCGAATCTAGGGA,97,100,3,11,4717,0,1
5735,ACGTCGAATCTAGGGA,97,100,3,14,4729,0,1
5736,ACGTCGAATCTAGGGA,98,100,2,10,342,0,1
5737,ACGTCGAATCTAGGGA,98,100,2,7,438,0,1
5739,ACGTCGAATCTAGGGA,98,100,2,10,597,0,1
5742,ACGTCGAATCAAGGGA,98,100,2,10,1119,0,1
5743,ACGTCGAATCTAGGGA,98,100,2,10,1382,0,1
5744,ACGTCGAATCTAGGGA,98,100,2,10,1415,0,1
5745,ACGTCGAATCTAGGGA,98,100,2,10,1439,0,1
5746,ACGTCGAATCTAGGGA,98,100,2,10,1448,0,1
5747,ACGTGGACTCTAGGGA,98,100,2,13,1506,0,1
5748,ACGTCGAATCTAGGGA,98,100,2,12,1815,0,1
5749,ACGTCGAATCTAGGGA,98,100,2,12,1825,0,1
5750,ACGTCGAATCAAGGGA,98,100,2,12,1839,0,1
5751,ACGTCGAATCAAGGGA,98,100,2,10,1893,0,1
5752,ACGTCGACTCTAGGGA,98,100,2,10,1916,0,1
5753,ACGTCGAATCTAGGGA,98,100,2,13,1918,0,1
5754,AGGTCGAATCTAGGGA,98,100,2,13,1930,0,1
5755,ACGTCGACTCTAGGGA,98,100,2,10,1937,0,1
5756,ACGTCGAATCTAGGGA,98,100,2,13,1951,0,1
5758,ACTTCGACTCTAGTGA,98,100,2,13,1962,0,1
5760,ACGTCGAATCTAGGGA,98,100,2,11,2016,0,1
5761,ACGTCGAATCAAGGGA,98,100,2,8,2018,0,1
5762,ACGTCGAATCTAGGGA,98,100,2,11,2686,0,1
5763,ACGTCGAATCTAGGGA,98,100,2,11,2696,0,1
5764,GCGTCGAATCTAGGGA,98,100,2,13,3300,0,1
5765,ACGTCGACTCTAGGGA,98,100,2,13,3303,0,1
5766,AAGTCGGATATAGGGA,98,100,2,10,3311,0,1
5767,ACGTCGAATCTAGGGA,98,100,2,10,3321,0,1
5768,ACGTCGAATCTAGGGA,98,100,2,10,3324,0,1
5769,ACATCGGATCTAGGGA,98,100,2,10,3339,0,1
5770,ACGTCGACTCTAGGGA,98,100,2,10,3348,0,1
5771,ACGTCGAATCAAGGGA,98,100,2,10,3350,0,1
5772,ACGTCGAATCTAGGGA,98,100,2,13,3376,0,1
5773,ACGTCGAATCTAGGGA,98,100,2,10,3405,0,1
5775,ACGTCGAATCTAGGGA,98,100,2,9,4770,0,1
5776,ACGTCGAATCAAGGGA,98,100,2,9,4771,0,1
5777,ACGTCGAATCAAGGGA,98,100,2,8,4921,0,1
5778,ACGTCGACTCTAGGGA,98,100,2,11,4925,0,1
5779,ACGTCGGATCTAGGGA,98,100,2,11,4926,0,1
5780,AAGTCGGATCTAGGGA,98,100,2,8,4927,0,1
5781,ACGTCGAATCTAGGGA,99,100,1,8,106,0,1
5782,ACGTCGAATCTAGGGA,99,100,1,8,259,0,1
5783,ACGTCGAATCTAGGGA,99,100,1,8,361,0,1
5784,ACGTCGAATCTAGGGA,99,100,1,8,379,0,1
5785,ACGTCGAATCAAGGGA,99,100,1,8,663,0,1
5786,ACGTCGAATCTAGGGA,99,100,1,8,675,0,1
5787,ACGTCGAATCTAGGGA,99,100,1,11,873,0,1
5788,ACGTCGAATCTAGGGA,99,100,1,11,880,0,1
5789,ACGTCGAATCTAGGGA,99,100,1,11,883,0,1
5790,ACGTCGAATCTCGGGA,99,100,1,11,906,0,1
5791,ACGTCGAATCAAGGGA,99,100,1,8,922,0,1
5792,ACGTCGAATCTAGGGA,99,100,1,11,1167,0,1
5793,GCGTCGAATCTAGGGA,99,100,1,11,1196,0,1
5794,ACGTCGAATCTAGGGA,99,100,1,11,1230,0,1
5795,ACGTCGCATCTAGGGA,99,100,1,8,1527,0,1
5796,GCGTCGAATCTAGGGA,99,100,1,11,1538,0,1
5797,ACGTCGAATCTAGGGA,99,100,1,11,1543,0,1
5798,ACGTCGAATCTAGGGA,99,100,1,14,1595,0,1
5799,ACGTCGAATCTAGGGA,99,100,1,11,1596,0,1
5800,ACGTCGAATCTAGGGA,99,100,1,11,1656,0,1
5801,ACGTCGAATCTAGGGA,99,100,1,12,1735,0,1
5802,ACGTCGAATCTAGGGA,99,100,1,12,1761,0,1
5803,ACGTCGGATCTAGGGA,99,100,1,9,1763,0,1
5804,ACGTCGACTCTAGGGA,99,100,1,12,1781,0,1
5805,ACGTCGAATCTAGGGA,99,100,1,12,1791,0,1
5806,ACGTCGAATCTAGGGA,99,100,1,12,1796,0,1
5807,ACGTCGAATCTAGGGA,99,100,1,10,1849,0,1
5808,ACGTCGACTCTAGGGA,99,100,1,10,1865,0,1
5809,ACGTCGAATCTAGGGA,99,100,1,10,1875,0,1
5810,ACGTCGAATCTAGGGA,99,100,1,10,3238,0,1
5811,CCGTCGACTCTAGGGA,99,100,1,10,3255,0,1
5812,ACGTCGACTCTAGGGA,99,100,1,13,3265,0,1
5813,ACATCGAATCAAGGGA,99,100,1,10,3270,0,1
5814,ACGTCGAATCAAGGGA,99,100,1,10,3271,0,1
5815,ACGTCGAATCTAGGGA,99,100,1,10,3274,0,1
5816,ACGTCGAATCAAGGGA,99,100,1,10,3278,0,1
5817,ACGCCGACTCTAGGGA,99,100,1,10,3282,0,1
5818,ACGTCGTATCTAGGGA,99,100,1,10,3284,0,1
5819,ACGTCGAATCAAGGGA,99,100,1,10,3298,0,1
5820,ACGTCGACTCTAGGGA,99,100,1,10,4281,0,1
5821,ACGTCGAATCTAGGGA,99,100,1,10,4286,0,1
5822,ACGTCGACTCTAGGGA,99,100,1,13,4294,0,1
5823,ACGTCGAATCTAGGGA,99,100,1,10,4298,0,1
5824,ACGTCGAATCAAGGGA,99,100,1,7,4304,0,1
5825,ACGTCGAATCAAGGGA,99,100,1,9,4983,0,1
5826,ACGTCGAATCTAGGGA,99,100,1,12,4985,0,1
5827,ACGTCGAATCAAGGGA,99,100,1,9,4986,0,1
5828,ACGTCGAATCTAGGGA,99,100,1,12,4989,0,1
5829,ACGTCGGATCTAGGGT,99,100,1,9,4991,0,1
5830,ACGTCGAATCTCGGGA,99,100,1,12,4992,0,1
