Bacterium, DNA, Iteration Born, Iteration Died, Life Span, Generation, Parent Bacterium, Number of Offspring, Alive at End
0,ACGTCGAATCTAGGGA,0,11,11,1,0,3,0
1,ACGTCGAATCTAGGGA,3,3,0,2,0,0,0
2,ACGTCGAATCTAGGGA,6,16,10,2,0,3,0
3,ACGTCGAATCTAGGGA,9,20,11,2,0,3,0
4,ACGTCGAATCTAGGGA,9,32,23,3,2,7,0
5,ACGTCGAATCTAGGGA,12,16,4,3,2,1,0
6,ACGTCGAATCTAGGGA,12,17,5,3,3,1,0
7,ACGTCGAATCTAGGGA,12,17,5,4,4,1,0
8,ACGTCGAATCTAGGGA,15,19,4,3,2,1,0
9,ACGTCGAATCTAGGGA,15,27,12,3,3,3,0
10,ACGTCGAATCTAGGGA,15,28,13,4,4,4,0
11,ACGTCGAATCTAGGGA,15,39,24,4,5,7,0
12,ACGTCGAATCTAGGGA,15,27,12,4,6,3,0
13,ACGTCGAATCTAGGGA,15,20,5,5,7,1,0
14,ACGTCGAATCTAGGGA,18,46,28,3,3,9,0
15,ACGTCGAATCTAGGGA,18,19,1,4,4,0,0
16,ACGTCGAATCTAGGGA,18,18,0,4,8,0,0
17,ACGTCGAATCTAGGGA,18,18,0,4,9,0,0
18,ACGTCGAATCTAGGGA,18,38,20,5,10,6,0
19,ACGTCGAATCTAGGGA,18,25,7,5,11,2,0
20,ACGTCGAATCTAGGGA,18,34,16,5,12,5,0
21,ACGTCGAATCTAGGGA,18,29,11,6,13,3,0
22,ACGTCGAATCTAGGGA,21,21,0,4,4,0,0
23,ACGTCGAATCTAGGGA,21,22,1,4,9,0,0
24,ACGTCGAATCTAGGGA,21,22,1,5,10,0,0
25,ACGTCGAATCTAGGGA,21,33,12,5,11,3,0
26,ACGTCGAATCTAGGGA,21,34,13,5,12,4,0
27,ACGTCGAATCTAGGGA,21,22,1,4,14,0,0
28,ACGTCGAATCTAGGGA,21,38,17,6,18,5,0
29,ACGTCGAATCTAGGGA,21,21,0,6,19,0,0
30,ACGTCGAATCTAGGGA,21,27,6,6,20,1,0
31,ACGTCGAATCTAGGGA,21,26,5,7,21,1,0
32,ACGTCGAATCTAGGGA,24,28,4,4,4,1,0
33,ACGTCGAATCTAGGGA,24,32,8,4,9,2,0
34,ACGTCGAATCTAGGGA,24,27,3,5,10,0,0
35,ACGTCGAATCTAGGGA,24,40,16,5,11,5,0
36,ACGTCGAATCTAGGGA,24,40,16,5,12,5,0
37,ACGTCGAATCTAGGGA,24,64,40,4,14,13,0
38,ACGTCGAATCTAGGGA,24,59,35,6,18,11,0
39,ACGTCGAATCTAGGGA,24,28,4,6,19,1,0
40,ACGTCGAATCTAGGGA,24,41,17,6,20,5,0
41,ACGTCGAATCTAGGGA,24,35,11,7,21,3,0
42,ACGTCGAATCTAGGGA,24,24,0,6,25,0,0
43,ACGTCGAATCTAGGGA,24,28,4,6,26,1,0
44,ACGTCGAATCTAGGGA,24,25,1,7,28,0,0
45,ACGTCGAATCTAGGGA,24,34,10,7,30,3,0
46,ACGTCGAATCTAGGGA,24,41,17,8,31,5,0
47,ACGTCGAATCTAGGGA,27,34,7,4,4,2,0
48,ACGTCGAATCTAGGGA,27,29,2,5,10,0,0
49,ACGTCGAATCTAGGGA,27,29,2,5,11,0,0
50,ACGTCGAATCTAGGGA,27,36,9,4,14,2,0
51,ACGTCGAATCTAGGGA,27,45,18,6,18,5,0
52,ACGTCGAATCTAGGGA,27,30,3,6,20,0,0
53,ACGTCGAATCTAGGGA,27,27,0,7,21,0,0
54,ACGTCGAATCTAGGGA,27,33,6,6,25,1,0
55,ACGTCGAATCTAGGGA,27,38,11,6,26,3,0
56,ACGTCGAATCTAGGGA,27,53,26,7,28,8,0
57,ACGTCGAATCTAGGGA,27,87,60,5,32,19,0
58,ACGTCGAATCTAGGGA,27,28,1,5,33,0,0
59,ACGTCGAATCTAGGGA,27,42,15,6,35,4,0
60,ACGTCGAATCTAGGGA,27,45,18,6,36,5,0
61,ACGTCGAATCTAGGGA,27,33,6,5,37,1,0
62,ACGTCGAATCTAGGGA,27,42,15,7,38,4,0
63,GCGTCGAATCTAGGGA,27,29,2,7,39,0,0
64,ACGTCGAATCTAGGGA,27,32,5,7,40,1,0
65,ACGTCGAATCTAGGGA,27,29,2,8,41,0,0
66,ACGTCGAATCTAGGGA,27,38,11,7,43,3,0
67,ACGTCGAATCTAGGGA,27,50,23,8,45,7,0
68,ACGTCGAATCTAGGGA,27,36,9,9,46,2,0
69,ACGTCGAATCTAGGGA,30,52,22,4,4,7,0
70,ACGTCGAATCTAGGGC,30,44,14,5,11,4,0
71,ACGTCGAATCTAGGGA,30,36,6,4,14,1,0
72,ACGTCGAATCTAGGGA,30,40,10,6,18,3,0
73,ACGTCGAATCTAGGGA,30,33,3,6,20,0,0
74,ACGTCGAATCTAGGGA,30,46,16,6,25,5,0
75,ACGTCGAATCTAGGGA,30,39,9,6,26,2,0
76,ACGTCGAATCTAGGGA,30,42,12,7,28,3,0
77,ACGTCGAATCTAGGGA,30,35,5,5,33,1,0
78,ACGTCGAATCTAGGGA,30,31,1,6,35,0,0
79,ACGTCGAATCTAGGGA,30,46,16,6,36,5,0
80,ACGTCGAATCTAGGGA,30,44,14,5,37,4,0
81,ACGTCGAATCTAGGGA,30,44,14,7,38,4,0
82,ACGTCGAATCTAGGGA,30,40,10,7,40,3,0
83,ACGTCGAATCTAGGGA,30,38,8,8,41,2,0
84,ACGTCGAATCTAGGGA,30,31,1,8,45,0,0
85,ACGTCGAATCTAGGGA,30,31,1,9,46,0,0
86,ACGTCGAATCTAGGGA,30,70,40,5,47,13,0
87,ACGTCGAATCTAGGGA,30,36,6,5,50,1,0
88,ACGTCGAATCTAGGGA,30,44,14,7,51,4,0
89,ACGTCGAATCTAGGGA,30,30,0,7,54,0,0
90,ACGTCGAATCTAGGGA,30,43,13,7,55,4,0
91,ACGTCGAATCTAGGGA,30,37,7,8,56,2,0
92,TCGTCGAATCTAGGGA,30,37,7,6,57,2,0
93,ACGTCGAATCTAGGGA,30,63,33,7,59,10,0
94,ACGTCGAATCTAGGGA,30,66,36,7,60,11,0
95,ACGTCGAATCTAGGGA,30,46,16,6,61,5,0
96,ACGTCGAATCTAGGGA,30,31,1,8,62,0,0
97,ACGTCGAATCTAGGGA,30,34,4,8,64,1,0
98,ACGTCGAATCTAGGGA,30,30,0,8,66,0,0
99,ACGTCGAATCTAGGGA,30,30,0,9,67,0,0
100,ACGTCGAATCTAGGGA,30,62,32,10,68,10,0
101,ACGTCGAATCTAGGGA,33,34,1,5,11,0,0
102,ACGTCGAATCTAGGGA,33,33,0,4,14,0,0
103,ACGTCGAATCTAGGGA,33,37,4,6,18,1,0
104,ACGTCGAATCTAGGGA,33,35,2,6,20,0,0
105,ACGTCGAATCTAGGGA,33,40,7,6,26,2,0
106,ACGTCGAATCTAGGGA,33,37,4,7,28,1,0
107,ACGTCGAATCTAGGGA,33,57,24,6,35,7,0
108,ACGTCGAATCTAGGGA,33,35,2,6,36,0,0
109,ACGTCGAATCTAGGGA,33,36,3,5,37,0,0
110,ACGTCGAATCTAGGGA,33,76,43,7,38,14,0
111,ACGTCGAATCTAGGGA,33,39,6,7,40,1,0
112,ACGTAGAATCTAGGGA,33,49,16,8,41,5,0
113,ACGTCGAATCTAGGGA,33,47,14,8,45,4,0
114,ACGTCGAATCTAGGGA,33,46,13,9,46,4,0
115,ACGTCGAATCTAGGGA,33,35,2,5,47,0,0
116,ACGTCGAATCTAGGGA,33,34,1,5,50,0,0
117,ACGTCGAATCTAGGGA,33,33,0,7,51,0,0
118,ACGTCGAATCTAGGGA,33,48,15,7,55,4,0
119,ACGTCGAATCTAGGGA,33,46,13,8,56,4,0
120,ACGTCGAATCTAGGGA,33,40,7,6,57,2,0
121,ACGTCGAATCTAGGGA,33,36,3,7,59,0,0
122,ACGTCGAATCTAGGGA,33,34,1,7,60,0,0
123,ACGTCGAATCTAGGGA,33,49,16,8,62,5,0
124,ACGTCGAATCTAGGGA,33,53,20,8,66,6,0
125,ACGTCGAATCTAGGGA,33,42,9,9,67,2,0
126,ACGTCGAATCTAGGGA,33,35,2,10,68,0,0
127,ACGTCGAATCTAGGGA,33,38,5,5,69,1,0
128,ACGTCGAATCTAGGGC,33,33,0,6,70,0,0
129,ACGGCGAATCTAGGGA,33,39,6,5,71,1,0
130,ACGTCGAATCTAGGGA,33,37,4,7,72,1,0
131,ACGTCGAATCTAGGGA,33,52,19,7,74,6,0
132,ACGTCGAATCTAGGGA,33,39,6,7,75,1,0
133,ACGTCGAATCTAGGGA,33,34,1,8,76,0,0
134,ACGTCGAATCTAGGGA,33,83,50,6,77,16,0
135,ACGTCGAATCTAGGGA,33,41,8,7,79,2,0
136,ACGTCGAATCTAGGGA,33,44,11,6,80,3,0
137,ACGTCGAATCTAGGGA,33,46,13,8,81,4,0
138,ACGTCGAATCTAGGGA,33,40,7,8,82,2,0
139,ACGTCGAATCTAGGGA,33,33,0,9,83,0,0
140,ACGTCGAATCTAGGGA,33,39,6,6,86,1,0
141,ACGTCGAATCTAGGGA,33,43,10,6,87,3,0
142,ACGTCGAATCTAGGGA,33,38,5,8,88,1,0
143,ACGTCGAATCTAGGGA,33,35,2,8,90,0,0
144,ACGTCGAATCTAGGGA,33,34,1,9,91,0,0
145,TCGTCGAATCTAGGGA,33,42,9,7,92,2,0
146,ACGTCGAATCTAGGGA,33,33,0,8,93,0,0
147,ACGTCGAATCTAGGGA,33,37,4,8,94,1,0
148,ACGTCGAATCTAGGGA,33,36,3,7,95,0,0
149,ACGTCGAATCTAGGGA,33,34,1,9,97,0,0
150,ACGTCGAATCTAGGGA,33,49,16,11,100,5,0
151,ACGTCGAATCTAGGGA,36,38,2,5,11,0,0
152,ACGTCGAATCTAGGGA,36,42,6,4,14,1,0
153,ACGTCGAATCTAGGGA,36,53,17,6,18,5,0
154,ACGTCGAATCTAGGGA,36,40,4,7,28,1,0
155,ACGTCGAATCTAGGGA,36,41,5,6,35,1,0
156,ACGTCGAATCTAGGGA,36,41,5,6,36,1,0
157,ACGTCGAATCTAGGGA,36,46,10,5,37,3,0
158,ACGTCGAATCTAGGGA,36,41,5,7,38,1,0
159,ACGTCGAATCTAGGGA,36,43,7,7,40,2,0
160,ACGTCGAATCTAGGGA,36,54,18,9,46,5,0
161,ACGTCGAATCTAGGGA,36,46,10,7,51,3,0
162,ACGTCGAATCTAGGGA,36,41,5,7,55,1,0
163,ACGTCGAATCTAGGGA,36,39,3,8,56,0,0
164,ACGTCGAATCTAGGGT,36,38,2,6,57,0,0
165,ACGTCGAATCTAGGGA,36,41,5,7,59,1,0
166,ACGTCGAATCTAGGGA,36,42,6,7,60,1,0
167,ACGTCGAATCTAGGGA,36,40,4,8,62,1,0
168,ACGTCGAATCTAGGGA,36,36,0,8,66,0,0
169,ACGTCGAATCTAGGGA,36,37,1,9,67,0,0
170,ACGTCGAATCTAGGGA,36,58,22,5,69,7,0
171,ACGTCGAATCTAGGGC,36,37,1,6,70,0,0
172,ACGTCGAATCTAGGGA,36,44,8,7,72,2,0
173,ACGTCGAATCTAGGGA,36,41,5,7,74,1,0
174,ACGTCGAATCTAGGGA,36,42,6,7,75,1,0
175,ACGTCGAATCTAGGGA,36,39,3,8,76,0,0
176,ACGTCGAATCTAGGGA,36,75,39,7,79,12,0
177,ACGTCGAATCTAGGGA,36,50,14,6,80,4,0
178,ACGTCGAATCTAGGGA,36,39,3,8,81,0,0
179,ACGTCGAATCTAGGGA,36,40,4,8,82,1,0
180,ACGTCGAATCTAGGGA,36,48,12,9,83,3,0
181,ACGTCGAATCTAGGGA,36,47,11,6,86,3,0
182,ACGTCGAATCTAGGGA,36,43,7,8,88,2,0
183,ACGTCGAATCTAGGGA,36,38,2,8,90,0,0
184,ACGTCGAATCTAGGGA,36,47,11,9,91,3,0
185,TCGTCGAATCTAGGGA,36,37,1,7,92,0,0
186,ACATCGAATCTAGGGA,36,51,15,8,93,4,0
187,ACGTCGAATCTAGGGA,36,54,18,8,94,5,0
188,ACGTCGAATCTAGGGA,36,50,14,7,95,4,0
189,ACGTCGAATCTAGGGA,36,38,2,11,100,0,0
190,ACGTCGAATCTAGGGA,36,37,1,7,103,0,0
191,ACGTCGAATCTAGGGA,36,41,5,7,105,1,0
192,ACGTCGAAGCTAGGGA,36,41,5,8,106,1,0
193,ACGTCGAATCTAGGGA,36,46,10,7,107,3,0
194,ACGTCGAATCTAGGGA,36,39,3,8,110,0,0
195,ACGTCGAATCTAGGGA,36,36,0,8,111,0,0
196,ACGTAGAATCTAGGGA,36,38,2,9,112,0,0
197,ACGTCGAATCTAGGGA,36,38,2,9,113,0,0
198,ACGTCGAATCTAGGGA,36,37,1,10,114,0,0
199,ACGTCGAATCTAGGGA,36,38,2,8,118,0,0
200,ACGTCGAATCTAGGGA,36,36,0,9,119,0,0
201,ACGTCGAATCTAGGGA,36,39,3,7,120,0,0
202,ACGTCGAATCTAGGGA,36,42,6,9,123,1,0
203,ACGTCGAATATAGGGA,36,43,7,9,124,2,0
204,ACGTCGAATCTAGGGA,36,40,4,10,125,1,0
205,ACGTCGAATCTAGGGA,36,39,3,6,127,0,0
206,ACGGCGAATCTAGGGA,36,41,5,6,129,1,0
207,ACGTCGAATCTAGGGA,36,46,10,8,130,3,0
208,ACGTCGAATCTAGGGA,36,38,2,8,131,0,0
209,ACGTCGAATCTAGGGA,36,37,1,8,132,0,0
210,ACGTCGAATCTAGGGA,36,43,7,7,134,2,0
211,ACGTCGAATCTAGGGA,36,70,34,8,135,11,0
212,ACGTCGAATCTAGGGA,36,47,11,7,136,3,0
213,ACGTCGAATCTAGGGA,36,36,0,9,137,0,0
214,ACGTCGAATCTAGGGA,36,39,3,9,138,0,0
215,ACGTCGAATCTAGGGA,36,47,11,7,140,3,0
216,ACGTCGAATCTAGGGA,36,38,2,7,141,0,0
217,ACGTCGAATCTAGGGA,36,38,2,9,142,0,0
218,TCGTCGAATCTAGGGA,36,37,1,8,145,0,0
219,ACGTCGAATCTAGGGA,36,39,3,9,147,0,0
220,ACGTCGAATCTAGGGA,36,77,41,12,150,13,0
221,ACGTCGAATCTAGGGA,39,42,3,4,14,0,0
222,ACGTCGAATCTAGGGA,39,57,18,6,35,5,0
223,ACGTCGAATCTAGGGA,39,57,18,6,36,5,0
224,ACGTCGAATCTAGGGA,39,41,2,5,37,0,0
225,ACGTCGAATCTAGGGA,39,55,16,7,38,5,0
226,ACGTCGAATCTAGGGA,39,47,8,7,40,2,0
227,ACGTCGAATCTAGGGA,39,41,2,9,46,0,0
228,ACGTCGAATCTAGGGA,39,68,29,7,51,9,0
229,ACGTCGAATCTAGGGA,39,39,0,8,56,0,0
230,ACGTCGAATCTAGGGA,39,39,0,6,57,0,0
231,ACGTCGAATCTAGGGA,39,39,0,7,59,0,0
232,ACGTCGAATCTAGGGA,39,39,0,7,60,0,0
233,ACGTCGAATCTAGGGA,39,45,6,8,62,1,0
234,ACGTCGAATCTAGGGA,39,49,10,9,67,3,0
235,ACGTCGAATCTAGGGA,39,39,0,5,69,0,0
236,ACGTCGAATCTAGGGC,39,57,18,6,70,5,0
237,ACGTCGAATCTAGGGA,39,42,3,7,72,0,0
238,ACGTCGAATCTAGGGA,39,43,4,7,74,1,0
239,ACGTCGAATCTAGGGA,39,48,9,8,76,2,0
240,ACGTCGAATCTAGGGA,39,43,4,7,79,1,0
241,ACGTCGAATCTAGGGA,39,48,9,6,80,2,0
242,ACGTCGAATCTAGGGA,39,48,9,8,81,2,0
243,ACGTCGAATCTAGGGA,39,40,1,8,82,0,0
244,ACGTCGAATCTAGGGA,39,42,3,6,86,0,0
245,ACGTCGAATCTAGGGA,39,43,4,8,88,1,0
246,ACGTCGAATCTAGGGA,39,47,8,8,90,2,0
247,ACGTCGAATCTAGGGA,39,40,1,8,93,0,0
248,ACGTCGAATCTAGGGA,39,39,0,8,94,0,0
249,ACGTCGAATCTAGGGA,39,58,19,7,95,6,0
250,ACGTCGAATCTAGGGA,39,47,8,11,100,2,0
251,ACGTCGAATCTAGGGA,39,68,29,7,105,9,0
252,ACGTCGAATCTAGGGA,39,51,12,7,107,3,0
253,ACGTCGAATCTAGGGA,39,44,5,8,110,1,0
254,ACGTAGAATCTAGGGA,39,41,2,9,112,0,0
255,ACGTCGAATCTAGGGA,39,51,12,9,113,3,0
256,ACGTCGAATCTAGGGA,39,39,0,10,114,0,0
257,ACGTCGAATCTAGGGA,39,51,12,8,118,3,0
258,ACGTCGAATCTAGGGA,39,60,21,9,119,6,0
259,ACGTCGAATCTAGGGA,39,39,0,7,120,0,0
260,ACGTCGAATCTAGGGA,39,40,1,9,123,0,0
261,ACGTCGAATCTAGGGA,39,43,4,9,124,1,0
262,ACGTCGAATCTAGGGA,39,46,7,10,125,2,0
263,ACGTCGAATCTAGGGA,39,42,3,8,131,0,0
264,ACGTCGAATCTAGGGA,39,49,10,7,134,3,0
265,ACGTCGAATCTAGGGA,39,44,5,8,135,1,0
266,ACGTCGAATCTAGGGA,39,56,17,7,136,5,0
267,ACGTCGAATCTAGGGA,39,53,14,9,137,4,0
268,ACGTCGAATCTAGGGA,39,45,6,9,138,1,0
269,ACGTCGAATCTAGGGA,39,40,1,7,141,0,0
270,TCGTCGAATCTAGGGA,39,43,4,8,145,1,0
271,ACGTCGAATCTAGGGA,39,51,12,12,150,3,0
272,ACGTCGAATCTAGGGA,39,44,5,5,152,1,0
273,ACGTCGAATCTAGGGA,39,40,1,7,153,0,0
274,ACGTCGAATCTAGGGA,39,39,0,8,154,0,0
275,ACGTCGAATCTAGGGA,39,62,23,7,155,7,0
276,ACGTCGAATCTAGGGA,39,55,16,7,156,5,0
277,ACGTCGAATCTAGGGA,39,42,3,6,157,0,0
278,ACGTCGAATCTAGGGA,39,42,3,8,158,0,0
279,ACGTCGAATCTAGGGA,39,58,19,8,159,6,0
280,ACGTCGAATCTAGGGA,39,42,3,10,160,0,0
281,ACGTCGAATCTAGGGA,39,43,4,8,161,1,0
282,ACGTCGAATCTAGGGA,39,40,1,8,162,0,0
283,ACGTCGAATCTAGGGA,39,41,2,8,165,0,0
284,ACGTCGAATCTAGGGA,39,53,14,8,166,4,0
285,ACGTCGAATCTAGGGA,39,49,10,9,167,3,0
286,ACGTCGAATCTAGGGA,39,39,0,6,170,0,0
287,ACGTCGAATCTAGGGA,39,41,2,8,172,0,0
288,ACGTCGAATCTAGGGA,39,39,0,8,173,0,0
289,ACGTCGAATCTAGGGA,39,62,23,8,174,7,0
290,ACGTCGAATCTAGGGA,39,64,25,8,176,8,0
291,ACGTCGAATCTAGGGA,39,64,25,7,177,8,0
292,ACGTCGAATCTAGGGA,39,49,10,9,179,3,0
293,ACGTCGAATCTAGGGA,39,50,11,10,180,3,0
294,ACGTCGAATCTAGGGA,39,116,77,7,181,25,0
295,ACGTCGAATCTAGGGA,39,40,1,9,182,0,0
296,ACGTCGAATCTAGGGA,39,42,3,10,184,0,0
297,ACATCGAATCTAGGGA,39,41,2,9,186,0,0
298,ACGTCGAATCTAGGGA,39,48,9,9,187,2,0
299,ACGTCGAATCTAGGGA,39,40,1,8,188,0,0
300,ACGTCGAATCTAGGGA,39,43,4,8,191,1,0
301,ACGTCGAAGCTAGGAA,39,54,15,9,192,4,0
302,ACGTCGAATCTAGGGA,39,40,1,8,193,0,0
303,ACGTCGAATCTAGGGA,39,39,0,10,202,0,0
304,ACGTCGAATATAGGGA,39,42,3,10,203,0,0
305,ACGTCGAATCTAGGGA,39,42,3,11,204,0,0
306,ACGGCGAATCTAGGGA,39,51,12,7,206,3,0
307,ACGTCGAATCTAGGGA,39,43,4,9,207,1,0
308,ACGTCGAATCTAGGGA,39,43,4,8,210,1,0
309,ACGTCGAATCTAGGGA,39,40,1,9,211,0,0
310,ACGTCGAATCTAGGGA,39,43,4,8,212,1,0
311,ACGTCGAATCTAGGGA,39,44,5,8,215,1,0
312,ACGTCGAATCTAGGGA,39,46,7,13,220,2,0
313,ACGTCGAATCTAGGGA,42,62,20,4,14,6,0
314,ACGTCGAATCTAGGGA,42,42,0,5,37,0,0
315,ACGTCGAATCTAGGGA,42,54,12,7,38,3,0
316,ACGTCGAATCTAGGGA,42,54,12,7,51,3,0
317,ACGTCGAATCTAGGGA,42,46,4,8,56,1,0
318,ACGTCGAATCTAGGGA,42,49,7,6,57,2,0
319,ACGTCGAATCTAGGGA,42,70,28,7,60,9,0
320,ACGTCGAATCTAGGGA,42,63,21,9,67,6,0
321,ACGTCGAATCTAGGGA,42,49,7,5,69,2,0
322,ACGTCGAATCTAGGGC,42,43,1,6,70,0,0
323,ACGTCGAATCTAGGGA,42,45,3,7,74,0,0
324,ACGTCGAATCTAGGGA,42,60,18,7,79,5,0
325,ACGTCGAATCTAGGGA,42,47,5,6,80,1,0
326,ACGTCGAATCTAGGGA,42,51,9,8,81,2,0
327,ACGTCGAATCTAGGGA,42,46,4,6,86,1,0
328,ACGTCGAATCTAGGGA,42,42,0,8,88,0,0
329,ACGTCGAATCTAGGGA,42,43,1,8,90,0,0
330,ACGTCGAATCTAGGGA,42,45,3,8,93,0,0
331,ACGTCGAATCTAGGGA,42,56,14,8,94,4,0
332,ACGTCGAATCTAGGGA,42,59,17,7,95,5,0
333,ACGTCGAATCTAGGGA,42,44,2,11,100,0,0
334,ACGTCGAATCTAGGGA,42,42,0,7,107,0,0
335,ACGTCGAATCTAGGGA,42,56,14,8,110,4,0
336,ACGTAGAATCTAGGGA,42,48,6,9,112,1,0
337,ACGTCGAATCTAGGGA,42,44,2,9,113,0,0
338,ACGTCGAATCTAGGGA,42,59,17,10,114,5,0
339,ACGTCGAATCTAGGGA,42,50,8,8,118,2,0
340,ACGTCGAATCTAGGGA,42,51,9,9,119,2,0
341,ACGTCGAATCTAGGGA,42,44,2,9,123,0,0
342,ACGTCGAATCTAGGGA,42,47,5,9,124,1,0
343,ACGTCGAATCTAGGGA,42,48,6,8,131,1,0
344,ACGTCGAATCTAGGGA,42,48,6,7,134,1,0
345,ACGTCGAATCTAGGGA,42,62,20,7,136,6,0
346,ACGTCGAATCTAGGGA,42,48,6,9,137,1,0
347,ACGTCGAATCTAGGGA,42,51,9,7,141,2,0
348,ACGTCGAATCTAGGGA,42,43,1,12,150,0,0
349,ACGTCGAATCTAGGGA,42,48,6,7,153,1,0
350,ACGTCGAATCTAGGGA,42,47,5,6,157,1,0
351,ACGTCGAATCTAGGGA,42,47,5,8,159,1,0
352,ACGTCGAATCTAGGGA,42,68,26,10,160,8,0
353,ACGTCGAATCTAGGGA,42,74,32,8,161,10,0
354,ACGTCGAATCTAGGGA,42,55,13,6,170,4,0
355,ACGTCGAATCTAGGGA,42,45,3,8,172,0,0
356,ACGTCGAATCTAGGGA,42,82,40,8,176,13,0
357,ACGTCGAATCTAGGGA,42,51,9,7,177,2,0
358,ACGTCGAATCTAGGGA,42,48,6,10,180,1,0
359,ATGTCGAATCTAGGGA,42,45,3,7,181,0,0
360,ACGTCGAATCTAGGGA,42,50,8,9,182,2,0
361,ACGTCGAATCTAGGGA,42,49,7,10,184,2,0
362,ACATCGAATCTAGGGA,42,46,4,9,186,1,0
363,ACGTCGAATCTAGGGA,42,46,4,9,187,1,0
364,ACGTCGAATCTAGGGA,42,46,4,8,188,1,0
365,ACGTCGAATCTAGGGA,42,51,9,8,193,2,0
366,ACGTCGAATATAGGGA,42,53,11,10,203,3,0
367,ACGTCGAATCTAGGGA,42,47,5,9,207,1,0
368,ACGTCGAATCTAGGGA,42,42,0,8,210,0,0
369,ACGTCGAATCTAGGGA,42,52,10,9,211,3,0
370,ACGTCGAATCTAGGGA,42,44,2,8,212,0,0
371,ACGTCGAATCTAGGGA,42,46,4,8,215,1,0
372,ACGTCGAATCTAGGGA,42,65,23,13,220,7,0
373,ACGTCGAATCTAGGGA,42,64,22,7,222,7,0
374,ACGTCGAATCTAGGGA,42,42,0,7,223,0,0
375,ACGTCGAATCTAGGGA,42,56,14,8,225,4,0
376,ACGTCGAATCTAGGGA,42,99,57,8,226,18,0
377,ACGTCGAATCTAGGGA,42,49,7,8,228,2,0
378,ACGTCGAATCTAGGGA,42,43,1,9,233,0,0
379,ACGTCGAATCTAGGGA,42,51,9,10,234,2,0
380,ACGTCGAATCTAGGGC,42,55,13,7,236,4,0
381,ACGTCGAATCTAGGGA,42,47,5,8,238,1,0
382,ACGTCGAATCTAGGGA,42,44,2,9,239,0,0
383,ACGTCGAATCTAGGGA,42,50,8,8,240,2,0
384,ACGTCGAATCTAGGGA,42,45,3,7,241,0,0
385,ACGTCCAATCTAGGGA,42,45,3,9,242,0,0
386,ACGTCGAATCTAGGGA,42,56,14,9,245,4,0
387,ACGTCGAATCTAGGGA,42,53,11,9,246,3,0
388,ACGTCGAATCTAGGGA,42,54,12,8,249,3,0
389,ACGTCGAATCTAGGGA,42,58,16,12,250,5,0
390,ACGTCGAATCTAGGGA,42,53,11,8,251,3,0
391,GCGTCGAATCTAGGGA,42,44,2,8,252,0,0
392,ACGTCGAATCTAGGGA,42,62,20,9,253,6,0
393,ACGTCGAATCTAGGGA,42,57,15,10,255,4,0
394,ACGTCGAATCTAGGGA,42,55,13,9,257,4,0
395,ACGTCGAATCTAGGGA,42,47,5,10,258,1,0
396,ACGTCGAATCTAGGGA,42,44,2,10,261,0,0
397,ACGTCGAATCTAGGGA,42,46,4,11,262,1,0
398,ACGTCGAATCTAGGGA,42,48,6,8,264,1,0
399,ACGTCGAATCTAGGGA,42,58,16,9,265,5,0
400,ACGTCGAATCTAGGGA,42,49,7,8,266,2,0
401,ACGTCGAATCTAGGGA,42,47,5,10,267,1,0
402,ACGTCGAATCTAGGGA,42,43,1,10,268,0,0
403,TCGTCGAATCTAGGGA,42,43,1,9,270,0,0
404,ACGTCGAATCTAGGGA,42,42,0,13,271,0,0
405,ACGTCGAATCTAGGGA,42,54,12,6,272,3,0
406,ACGTCGAATCTAGGGA,42,45,3,8,275,0,0
407,ACGTCGAATCTAGGGA,42,60,18,8,276,5,0
408,ACGTCGAATCTAGGGA,42,44,2,9,279,0,0
409,ACGTCGAATCTAGGGA,42,46,4,9,281,1,0
410,ACGTCGAATCTAGGGA,42,49,7,9,284,2,0
411,ACGTCGAATCTAGGGA,42,52,10,10,285,3,0
412,ACGTCGAATCTAGGGA,42,48,6,9,289,1,0
413,ACGTCGAATCTAGGGA,42,46,4,9,290,1,0
414,ACGTCGAATCTAGGGA,42,43,1,8,291,0,0
415,ACGTCGAATCTAGGGA,42,50,8,10,292,2,0
416,ACGTCGAATCTAGGGA,42,46,4,11,293,1,0
417,ACGTCGAATCTAGGGA,42,53,11,8,294,3,0
418,ACGTCGAATCTAGGGA,42,46,4,10,298,1,0
419,ACGTCGAATCTAGGGA,42,48,6,9,300,1,0
420,ACGTCGAAGCTAGGAA,42,58,16,10,301,5,0
421,ACGGCGAATCTAGGGA,42,42,0,8,306,0,0
422,ACGTCGAATCTAGGGA,42,64,22,10,307,7,0
423,ACGTCGAATCTAGGGA,42,42,0,9,308,0,0
424,ACGTCGAATCTAGGGA,42,48,6,9,310,1,0
425,ACGTCGAATCTAGGGA,42,50,8,9,311,2,0
426,ACGTCGAATCTAGGGA,42,49,7,14,312,2,0
427,ACGTCGAATCTAGGGA,45,54,9,4,14,2,0
428,ACGTCGAATCTAGGGA,45,51,6,5,37,1,0
429,ACGTCGAATCTAGGGA,45,46,1,7,38,0,0
430,ACGTCGAATCTAGGGA,45,49,4,8,56,1,0
431,ACGTCGAATCTAGGGA,45,49,4,6,57,1,0
432,ACGTCGAATCTAGGGA,45,57,12,9,67,3,0
433,ACGTCGAATCTAGGGA,45,46,1,5,69,0,0
434,ACGTCGAATCTAGGGA,45,49,4,7,74,1,0
435,GCGTCGAATCTAGGGA,45,60,15,7,79,4,0
436,ACGTCGAATCTAGGGA,45,57,12,6,86,3,0
437,ACGTCGAATCTAGGGA,45,57,12,8,93,3,0
438,ACGTCGAATCTAGGGA,45,59,14,8,94,4,0
439,ACGTCGAATCTAGGGA,45,47,2,7,95,0,0
440,ACGTCGAATCTAGGGA,45,61,16,11,100,5,0
441,ACGTCGAATCTAGGGA,45,72,27,7,107,8,0
442,ACGTCGAATCTAGGGA,45,61,16,8,110,5,0
443,ACGTAGAATCTAGGGA,45,56,11,9,112,3,0
444,ACGTCGAATCTAGGGA,45,64,19,9,113,6,0
445,ACGTCGAATCTAGGGA,45,51,6,10,114,1,0
446,ACGTCGAATCTAGGGA,45,49,4,8,118,1,0
447,ACGTCGAATCTAGGGA,45,46,1,9,119,0,0
448,ACGTCGAATCTAGGGA,45,49,4,9,123,1,0
449,ACGTCGAATCTAGGGA,45,46,1,9,124,0,0
450,ACGTCGAATCTAGGGA,45,50,5,8,131,1,0
451,ACGTCGAATCTAGGGA,45,45,0,7,134,0,0
452,ACGTCGAATCTAGGGA,45,45,0,9,137,0,0
453,ACGTCGAATCTAGGGA,45,52,7,12,150,2,0
454,ACGTCGAATCTAGGGA,45,72,27,7,153,8,0
455,ACGTCGAATCTAGGGA,45,45,0,6,157,0,0
456,ACGTCGAATCTAGGGA,45,51,6,10,160,1,0
457,ACGTCGAATCTAGGGA,45,46,1,8,161,0,0
458,ACGTCGAATCTAGGGA,45,77,32,6,170,10,0
459,ACGTCGAATCTAGTGA,45,54,9,8,176,2,0
460,ACGTCGAATCTAGGGA,45,65,20,7,177,6,0
461,ACGTCGAATCTAGGGA,45,57,12,10,180,3,0
462,ACGTCGAATCTAGGGA,45,45,0,7,181,0,0
463,ACGTCGAATCTAGGGA,45,50,5,10,184,1,0
464,ACATCGAATCTAGGGA,45,51,6,9,186,1,0
465,ACGTCGAATCTAGGGA,45,56,11,9,187,3,0
466,ACGTCGAATCTAGGGA,45,48,3,8,188,0,0
467,ACGTCGAATCTAGGGA,45,60,15,8,193,4,0
468,ACGTCGAATCTAGGGA,45,49,4,9,207,1,0
469,ACGTCGAATCTAGGGA,45,47,2,9,211,0,0
470,ACGTCGAATCTAGGGA,45,111,66,8,212,21,0
471,ACGTCGAATCTAGGGA,45,72,27,8,215,8,0
472,ACGTCGAATCTAGGGA,45,46,1,13,220,0,0
473,ACGTCGAATCTAGGGA,45,62,17,7,222,5,0
474,ACGTCGAATCTAGGGA,45,46,1,7,223,0,0
475,ACGTCGAATCTAGGGA,45,68,23,8,225,7,0
476,ACGTCGAATCTAGGGA,45,45,0,8,226,0,0
477,ACGTCGAATCTAGGGA,45,45,0,8,228,0,0
478,ACGTCGAATCTAGGGA,45,45,0,10,234,0,0
479,ACGTCGAATCTAGGGC,45,52,7,7,236,2,0
480,ACGTCGAATCTAGGGA,45,45,0,9,239,0,0
481,ACGTCGAATCTAGGGA,45,81,36,7,241,11,0
482,ACGTCGAATCTAGGGA,45,49,4,9,242,1,0
483,ACGTCGAATCTAGGGA,45,52,7,9,246,2,0
484,ACGTCGAATCTAGGGA,45,58,13,8,249,4,0
485,ACGTCGAATCTAGGGA,45,50,5,12,250,1,0
486,ACGTCGAATCTAGGGA,45,47,2,8,251,0,0
487,ACGTCGAATCTAGGGA,45,46,1,8,252,0,0
488,ACGTCGAATCTAGGGA,45,46,1,10,255,0,0
489,ACGTCGAATCTAGGGA,45,63,18,9,257,5,0
490,ACGTCGAATCTAGGGA,45,51,6,10,258,1,0
491,ACGTCGAATCTAGGGA,45,48,3,11,262,0,0
492,ACGTCGAATCTAGGGA,45,75,30,8,264,9,0
493,ACGTCGAATCTAGGGA,45,49,4,8,266,1,0
494,ACGTCGAATCTAGGGA,45,59,14,10,267,4,0
495,ACGTCGAATCTAGGGA,45,49,4,13,271,1,0
496,ACGTCGAATCTAGGGA,45,74,29,8,275,9,0
497,ACGTCGAATCTAGGGA,45,56,11,8,276,3,0
498,ACGTCGAATCTAGGGA,45,47,2,9,279,0,0
499,ACGTCGAATCTAGGGA,45,58,13,9,284,4,0
500,ACGTCGAATCTAGGGA,45,54,9,10,285,2,0
501,ACGTCGAATCTAGGGA,45,63,18,9,289,5,0
502,ACGTCGAATCTAGGGA,45,54,9,9,290,2,0
503,ACGTCGAATCTAGGGA,45,51,6,8,291,1,0
504,ACGTCGAATCTAGGGA,45,49,4,10,292,1,0
505,ACGTCGAATCTAGGGA,45,61,16,11,293,5,0
506,ACGTCGAATCTAGGGA,45,46,1,8,294,0,0
507,ACGTCGAATCTAGGGA,45,46,1,10,298,0,0
508,ACGTCGAAGCTAGGAA,45,50,5,10,301,1,0
509,ACGGCCAATCTAGGGA,45,46,1,8,306,0,0
510,ACGTCGAATCTAGGGA,45,74,29,14,312,9,0
511,ACGTCGAATCTAGGGA,45,59,14,5,313,4,0
512,ACGTCGAATCTAGGGA,45,52,7,8,315,2,0
513,ACGTCGAATCTAGGGA,45,51,6,8,316,1,0
514,ACGTCGAATCTAGGGA,45,50,5,9,317,1,0
515,ACGTCGAATCTAGGGA,45,55,10,7,318,3,0
516,ACGTCGAATCTAGGGA,45,45,0,8,319,0,0
517,ACGGCGAATCTAGGGA,45,45,0,10,320,0,0
518,ACGTCGAATCTAGGGA,45,53,8,6,321,2,0
519,ACGTCGAATCTAGGGA,45,72,27,8,324,8,0
520,ACGTCGAATCTAGGGA,45,72,27,7,325,8,0
521,ACGTCGAATCTAGGGA,45,81,36,9,326,11,0
522,ACGTCGAATCTAGGGA,45,46,1,7,327,0,0
523,ACGTCGAATCTAGGGA,45,46,1,9,331,0,0
524,ACGTCGAATCTAGGGA,45,70,25,8,332,8,0
525,ACGTCGAATCTAGGGA,45,46,1,9,335,0,0
526,ACGTAGAATCTAGGGA,45,45,0,10,336,0,0
527,ACGTCGAATCTAGGGA,45,51,6,11,338,1,0
528,ACGTCGAATCTAGGGA,45,49,4,9,339,1,0
529,ACGTCGAATCTAGGGA,45,49,4,10,340,1,0
530,ACGTCGAATCTAGGGA,45,50,5,10,342,1,0
531,ACGTCGAATCTAGGGA,45,83,38,9,343,12,0
532,ACGTCGAATCTAGGGA,45,56,11,8,344,3,0
533,ACGTCGAATCTAGGGA,45,58,13,8,345,4,0
534,ACGTCGAATCTAGGGA,45,58,13,10,346,4,0
535,ACGTCGAATCTAGGGA,45,59,14,8,347,4,0
536,ACGTCGAATCTAGGGA,45,45,0,8,349,0,0
537,ACGTCGAATCTAGGGA,45,46,1,7,350,0,0
538,ACGTCGAATCTAGGGA,45,47,2,9,351,0,0
539,ACGTCGAATCTAGGGA,45,76,31,11,352,10,0
540,ACGTCGAATCTAGGGA,45,54,9,9,353,2,0
541,ACGTCGAATCTAGGGA,45,69,24,7,354,7,0
542,ACGTCGAATCTAGGGA,45,63,18,9,356,5,0
543,ACGTCGAATCTAGGGA,45,50,5,8,357,1,0
544,ACGTCGAATCTAGGGA,45,45,0,11,358,0,0
545,ACGTCGAATCTAGGGA,45,62,17,10,360,5,0
546,ACGTCGAATCTAGGGA,45,76,31,11,361,10,0
547,ACATCGAATCTAGGGA,45,46,1,10,362,0,0
548,ACGTCGAATCTAGGGA,45,47,2,10,363,0,0
549,ACGTCGAATCTAGGGA,45,46,1,9,364,0,0
550,ACGTCGAATCTAGGGA,45,69,24,9,365,7,0
551,ACGTCGAATATAGGGA,45,45,0,11,366,0,0
552,ACGTCGAATCTAGGGC,45,65,20,10,367,6,0
553,ACGTCGAATCTAGGGA,45,54,9,10,369,2,0
554,ACGTCGAATCTAGGGA,45,46,1,9,371,0,0
555,ACGTCGAATCTAGGGA,45,45,0,14,372,0,0
556,ACGTCGAATCTAGGGA,45,54,9,8,373,2,0
557,ACGTCGAACCTAGGGA,45,49,4,9,375,1,0
558,ACGTCGAATCTAGGGA,45,50,5,9,376,1,0
559,ACGTCGAATCTAGGGA,45,72,27,9,377,8,0
560,ACGTCGAATCTAGGGA,45,51,6,11,379,1,0
561,ACGTCGAATCTAGGGC,45,48,3,8,380,0,0
562,ACGTCGAATCTAGGGA,45,50,5,9,381,1,0
563,ACGTCGAATCTAGGGA,45,50,5,9,383,1,0
564,ACGTCGAATCTAGGGA,45,53,8,10,386,2,0
565,ACGTCGAATCTAGGGA,45,45,0,10,387,0,0
566,ACGTCGAATCTAGGGA,45,50,5,9,388,1,0
567,ACGTCGAATCTAGGGA,45,45,0,13,389,0,0
568,ACGTCGAATCTAGGGA,45,47,2,9,390,0,0
569,ACGTCGAATCTAGGGA,45,46,1,10,392,0,0
570,ACGTCGAATCTAGGGA,45,58,13,11,393,4,0
571,ACGTCGAATCTAGGGA,45,46,1,10,394,0,0
572,ACGTCGAATCTAGGGA,45,54,9,11,395,2,0
573,ACGTCGAATCTAGGGA,45,45,0,12,397,0,0
574,ACGTCGAATCTAGGGA,45,79,34,9,398,11,0
575,ACGTCGAATCTAGGGA,45,45,0,10,399,0,0
576,ACGTCGAATCTAGGGA,45,62,17,9,400,5,0
577,ACGTCGAATCTAGGGA,45,45,0,11,401,0,0
578,ACGTCGAATCTAGGGA,45,45,0,7,405,0,0
579,ACGTCGAATCTAGGGA,45,56,11,9,407,3,0
580,ACGTCGAATCTAGGGA,45,55,10,10,409,3,0
581,ACGTCGAATCTAGGGA,45,49,4,10,410,1,0
582,ACGTCGAATCTAGGGA,45,63,18,11,411,5,0
583,ACGTCGAATCTAGGGA,45,61,16,10,412,5,0
584,ACGTCGAATCTAGGGA,45,53,8,10,413,2,0
585,ACGTCGAATCTAGGGA,45,52,7,11,415,2,0
586,ACGTCGAATCTAGGGA,45,55,10,12,416,3,0
587,ACGTCGAATCTAGGGA,45,62,17,9,417,5,0
588,ACGTCGAATCTAGGGA,45,56,11,11,418,3,0
589,ACGTCGAATCTAGGGA,45,73,28,10,419,9,0
590,ACGTCGAAGCTAGGAA,45,52,7,11,420,2,0
591,ACGTCGAATCTAGGGA,45,76,31,11,422,10,0
592,ACGTCGAATCTAGGGA,45,47,2,10,424,0,0
593,ACGTCGAATCTAGGGA,45,55,10,10,425,3,0
594,ACGTCGAATCTAGGGA,45,53,8,15,426,2,0
595,ACGTCGAATCTAGGGA,48,52,4,5,37,1,0
596,ACGTCGAATCTAGGGA,48,52,4,7,38,1,0
597,AAGTCGAATCTAGGGA,48,70,22,8,56,7,0
598,ACGTCGAATCTAGGGA,48,51,3,6,57,0,0
599,ACGTCGAATCTAGGGA,48,64,16,9,67,5,0
600,ACGTCGAATCTAGGGA,48,61,13,5,69,4,0
601,ACGTCGAATCTAGGGA,48,52,4,6,86,1,0
602,ACGTCGAATCTAGGGA,48,58,10,8,93,3,0
603,ACGTCGAATCTAGGGA,48,53,5,8,94,1,0
604,ACGTCGAATCTAGGGA,48,54,6,11,100,1,0
605,ACGTCGAATCTAGGGA,48,50,2,7,107,0,0
606,ACGTCGAATCTAGGGA,48,49,1,8,110,0,0
607,ACGTAGAATCTAGGGA,48,54,6,9,112,1,0
608,ACGTCGAATCTAGGGA,48,54,6,9,123,1,0
609,ACGTCGAATCTAGGGA,48,53,5,9,124,1,0
610,ACGTCGAATCTAGGGA,48,50,2,8,131,0,0
611,ACGTCGAATCTAGGGA,48,51,3,7,134,0,0
612,ACGTCGAATCTAGGGA,48,65,17,12,150,5,0
613,ACGTCGAATCTAGGGA,48,49,1,7,153,0,0
614,ACGTCGAATCTAGGGA,48,52,4,10,160,1,0
615,ACGTCGAATCTAGGGA,48,56,8,6,170,2,0
616,ACGTCGAATCTAGGGA,48,51,3,8,176,0,0
617,ACGTCGAATCTAGGGA,48,51,3,7,177,0,0
618,ACATCGAATCTAGCGA,48,53,5,9,186,1,0
619,ACGTCGAATCTAGGGA,48,50,2,9,187,0,0
620,ACGTCGAATCTAGGGA,48,57,9,8,188,2,0
621,ACGTCGAATCTAGGGA,48,57,9,9,211,2,0
622,ACGTCGAATCTAGGGA,48,48,0,13,220,0,0
623,ACGTCGAATCTAGGGA,48,49,1,7,222,0,0
624,ACGTCGAATCTAGGGA,48,50,2,7,223,0,0
625,ACGTCGAATCTAGGGA,48,53,5,8,225,1,0
626,ACGTCGAATCTAGGGA,48,50,2,8,228,0,0
627,ACGTCGAATCTAGGGA,48,56,8,10,234,2,0
628,ACGTCGAATCTAGGGC,48,52,4,7,236,1,0
629,ACGTCGAATCTAGGGA,48,53,5,8,249,1,0
630,ACGTCGAATCTAGGGA,48,56,8,8,251,2,0
631,ACGTCGAATCTAGGGA,48,49,1,8,252,0,0
632,ACGTCGAATCTAGGGA,48,96,48,10,255,15,0
633,ACGTCGAATCTAGGGA,48,53,5,9,257,1,0
634,ACGTCGAATCTAGGGA,48,55,7,10,258,2,0
635,ACGTCGAATCTAGGGA,48,55,7,8,264,2,0
636,ACGTCGAATCTAGGGA,48,49,1,8,266,0,0
637,ACGTCGAATCTAGGGA,48,48,0,10,267,0,0
638,ACGTCGAATCTAGGGA,48,51,3,13,271,0,0
639,ACGTCGAATCAAGGGA,48,50,2,8,275,0,0
640,ACGTCGAATCTAGGGA,48,74,26,8,276,8,0
641,ACGTCGAATCTAGGGA,48,52,4,9,279,1,0
642,ACGTCGAATCTAGGGA,48,61,13,9,284,4,0
643,ACGTCGAATCTAGGGA,48,51,3,10,285,0,0
644,ACGTCGAATCTAGGGA,48,49,1,9,289,0,0
645,ACGTCGAATCTAGGGA,48,52,4,9,290,1,0
646,ACGTCGAATCTAGGGA,48,56,8,8,291,2,0
647,ACGTCGAATCTAGGGA,48,62,14,10,292,4,0
648,ACGTCGAATCTAGGGA,48,52,4,11,293,1,0
649,ACGTCGAATCTAGGGA,48,63,15,8,294,4,0
650,ACGTCGAAGCTAGGAA,48,49,1,10,301,0,0
651,ACGGCGAATCTAGGGA,48,48,0,8,306,0,0
652,ACGTCGAATCTAGGGA,48,59,11,5,313,3,0
653,ACGTCGAATCTAGGGA,48,69,21,8,315,6,0
654,ACGTCGAATCTAGGGA,48,58,10,8,316,3,0
655,ACGTCGAATCTAGGGA,48,48,0,7,318,0,0
656,ACGTCGAATCTAGGGA,48,50,2,8,319,0,0
657,ACGTCGAATCTAGGGA,48,69,21,10,320,6,0
658,ACGTCGAATCTAGGGA,48,51,3,6,321,0,0
659,ACGTCGAATCTAGGGA,48,60,12,8,324,3,0
660,ACGTCGAATCTAGGGA,48,48,0,9,326,0,0
661,ACGTCGAATCTAGGGA,48,48,0,9,331,0,0
662,ACGTCGAATCTAGGGA,48,67,19,8,332,6,0
663,ACGTCGAATCTAGGGA,48,70,22,9,335,7,0
664,ACGTCGAATCTAGGGA,48,51,3,11,338,0,0
665,ACGTCGAATCTAGGGA,48,70,22,9,339,7,0
666,ACGTCGAATCTAGGGA,48,66,18,10,340,5,0
667,ACGTCGAATCTAGGGA,48,48,0,8,345,0,0
668,ACGTCGAAGCTAGGGA,48,48,0,8,347,0,0
669,ACGTCGAATCTAGGGA,48,59,11,11,352,3,0
670,ACGTCGAATCTAGGGA,48,49,1,9,353,0,0
671,ACGTCGAATCTAGGGA,48,48,0,7,354,0,0
672,ACGTCGAATCTAGGGA,48,48,0,9,356,0,0
673,ACGTCGAATCTAGGGA,48,69,21,8,357,6,0
674,ACGTCGAATCTAGGGA,48,59,11,10,360,3,0
675,ACGTCGAATCTAGGGA,48,68,20,11,361,6,0
676,ACGTCGAATCTAGGGA,48,54,6,9,365,1,0
677,ACGTCGAATATAGGGA,48,57,9,11,366,2,0
678,ACGTCGAATCTAGGGA,48,52,4,10,369,1,0
679,ACGTCGAATCTAGGGA,48,49,1,14,372,0,0
680,ACGTCGAATCTAGGGA,48,50,2,8,373,0,0
681,ACGTCGAATCTAGGGA,48,79,31,9,375,10,0
682,ACGTCGAATCTAGGGA,48,61,13,9,376,4,0
683,ACGTCGAATCTAGGGA,48,60,12,9,377,3,0
684,ACGTCGAATCTAGGGA,48,54,6,11,379,1,0
685,ACGTCGAATCTAGGGC,48,48,0,8,380,0,0
686,ACGTCGAATCTAGGGA,48,58,10,9,383,3,0
687,ACGTCGAATCTAGGGA,48,63,15,10,386,4,0
688,ACGTCGAATCTAGGGA,48,50,2,10,387,0,0
689,ACGTCGAATCTAGGGA,48,60,12,9,388,3,0
690,ACGTCGAATCTAGGGA,48,51,3,13,389,0,0
691,ACGTCGAATCTAGGGA,48,48,0,9,390,0,0
692,ACGTCGAATCTAGGGA,48,61,13,10,392,4,0
693,ACGTCGAATCTAGGGA,48,51,3,11,393,0,0
694,ACGTCGAATCTAGGGA,48,51,3,10,394,0,0
695,ACGTCGAATCTAGGGA,48,52,4,10,399,1,0
696,AGGTCGAATCTAGGGA,48,52,4,9,400,1,0
697,ACGTCGAATCTAGGGA,48,51,3,7,405,0,0
698,ACGTCGAATCTAGGGA,48,60,12,9,407,3,0
699,ACGTCGAATCTAGGGA,48,51,3,10,410,0,0
700,ACGTCGAATCTAGGGA,48,48,0,11,411,0,0
701,ACGTCGAATCTAGGGA,48,69,21,11,415,6,0
702,ACGTCGAATCTAGGGA,48,51,3,9,417,0,0
703,ACGTCGAAGCTAGGAA,48,53,5,11,420,1,0
704,ACGTCGAATCTAGGGA,48,54,6,11,422,1,0
705,ACGTCGAATCTAGGGA,48,62,14,10,425,4,0
706,ACGTCGAATCTAGGGA,48,54,6,15,426,1,0
707,ACGTCGAATCTAGGGA,48,51,3,5,427,0,0
708,ACGTCGAATCTAGGGA,48,52,4,6,428,1,0
709,ACGTCGAATCTAGGGA,48,58,10,9,430,3,0
710,ACGTCGAATCTAGGGA,48,51,3,7,431,0,0
711,ACGTCGAATCTAGGGA,48,51,3,10,432,0,0
712,ACGTCGAATCTAGGGA,48,48,0,8,434,0,0
713,GCGTCGAATCTAGGGA,48,50,2,8,435,0,0
714,ACGTCGAATCTAGGGA,48,71,23,7,436,7,0
715,ACGTCGAATCTAGGGA,48,54,6,9,437,1,0
716,ACGTCGAATCTAGGGA,48,55,7,9,438,2,0
717,ACGTCGAATCTAGGGA,48,56,8,12,440,2,0
718,ACGTCGAATCTAGGGA,48,55,7,8,441,2,0
719,ACGTCGAATCTAGGGA,48,54,6,9,442,1,0
720,ACGTAGAATCTAGGGA,48,48,0,10,443,0,0
721,ACGTCGAATCTAGGGA,48,58,10,10,444,3,0
722,ACGTCGAATCTAGGGA,48,50,2,11,445,0,0
723,ACGTCGAATCTAGGGA,48,50,2,9,446,0,0
724,ACGTCGATTCTAGGGA,48,52,4,10,448,1,0
725,ACGTCGAATCTAGGGA,48,51,3,9,450,0,0
726,ACGTCGAATCTAGGGA,48,54,6,13,453,1,0
727,ACGTCGAATCTAGGGA,48,55,7,8,454,2,0
728,ACGTCGAATCTAGGGA,48,112,64,11,456,21,0
729,ACGTCGAATCTAGGGA,48,49,1,7,458,0,0
730,ACGTCGAATCTAGTGA,48,97,49,9,459,16,0
731,ACGTCGAATCTAGGGA,48,54,6,8,460,1,0
732,ACGTCGAATCTAGGGA,48,67,19,11,461,6,0
733,ACGTCGAATCTAGGGA,48,69,21,11,463,6,0
734,ACATCGAATCTAGGGA,48,50,2,10,464,0,0
735,ACGTCGAATCTAGGGA,48,58,10,10,465,3,0
736,ACGTCGAATCTAGGGA,48,68,20,9,467,6,0
737,ACGTCGAATCTAGGGA,48,54,6,10,468,1,0
738,ACGTCGAATCTAGGGA,48,51,3,9,470,0,0
739,ACGTCGAATCTAGGGA,48,70,22,9,471,7,0
740,ACGTCGAATCTAGGGA,48,50,2,8,473,0,0
741,ACGTCGAATCTAGGGA,48,82,34,9,475,11,0
742,ACGTCGAATCTAGGGC,48,52,4,8,479,1,0
743,ACGTCGAATCTAGGGA,48,59,11,8,481,3,0
744,ACGTCGAATCTAGGGA,48,73,25,10,482,8,0
745,ACGTCGAATCTAGGGA,48,66,18,10,483,5,0
746,ACGTCGAATCTAGGGA,48,65,17,9,484,5,0
747,ACGTCGAATCTAGGGA,48,50,2,13,485,0,0
748,ACGTCGAATCTAGGGA,48,49,1,10,489,0,0
749,ACGTCGAATCTAGGGA,48,65,17,11,490,5,0
750,ACGTCGAATCTAGGGA,48,55,7,9,492,2,0
751,ACGTCGAATCTAGGGA,48,56,8,9,493,2,0
752,ACGTCGAATCTAGGGA,48,66,18,11,494,5,0
753,ACGTCGAATCTAGGGA,48,57,9,14,495,2,0
754,ACGTCGAATCTAGGGA,48,64,16,9,496,5,0
755,ACGTCGAATCTAGGGA,48,65,17,9,497,5,0
756,ACGTCGAATCTAGGGA,48,84,36,10,499,11,0
757,ACGTCGAATCTAGGGA,48,52,4,11,500,1,0
758,ACGTCGAATCTAGGGA,48,70,22,10,501,7,0
759,ACGTCGAATCTAGGGA,48,66,18,10,502,5,0
760,ACGTCGAATCTAGGGA,48,57,9,9,503,2,0
761,ACGTCGAATCTAGGGA,48,58,10,11,504,3,0
762,ACGTCGAATCTAGGGA,48,50,2,12,505,0,0
763,ACGTCGAAACTAGGAA,48,48,0,11,508,0,0
764,ACGTCGAATCTAGGGA,48,54,6,15,510,1,0
765,ACGTCGAATCTAGGGA,48,49,1,6,511,0,0
766,ACGTCGAATCTAGGGA,48,49,1,9,512,0,0
767,ACGTCGAATCTAGGGA,48,53,5,9,513,1,0
768,ACGTCGAATCTAGGGA,48,52,4,10,514,1,0
769,ACGTCGAATCTAGGGA,48,58,10,8,515,3,0
770,ACGTCGAATCTAGGGA,48,68,20,7,518,6,0
771,ACGTCGAATCTAGGGA,48,48,0,9,519,0,0
772,ACGTCGAATCTAGGGA,48,55,7,8,520,2,0
773,ACGTCGAATCTAGGGA,48,56,8,10,521,2,0
774,ACGTCGAATCTAGGGA,48,53,5,9,524,1,0
775,ACGTCGAATCTAGGGA,48,51,3,12,527,0,0
776,ACGTCGAATCTAGGGA,48,67,19,10,528,6,0
777,ACGTCGAATCTAGGGA,48,49,1,11,529,0,0
778,ACGTCGAATCTAGGGA,48,62,14,11,530,4,0
779,ACGTCGAATCTAGGGA,48,59,11,10,531,3,0
780,ACGTCGAATCTAGGGA,48,63,15,9,532,4,0
781,ACGTCGAATCTAGGGA,48,65,17,9,533,5,0
782,ACGTCGAATCTAGGGA,48,48,0,11,534,0,0
783,ACGTCGAATCTAGGGA,48,52,4,9,535,1,0
784,ACGTCGAATCTAGGGA,48,49,1,12,539,0,0
785,ACGTCGAATCTAGGGA,48,67,19,10,540,6,0
786,ACGTCGAATCTAGGGA,48,57,9,8,541,2,0
787,GCGTCGAATCTAGGGA,48,49,1,10,542,0,0
788,ACGTCGAATCTAGGGA,48,51,3,9,543,0,0
789,ACGTCGAATCTAGGGA,48,49,1,11,545,0,0
790,ACGTCGAATCTAGGGA,48,53,5,12,546,1,0
791,ACGTCGAATCTAGGGA,48,70,22,10,550,7,0
792,ACGTCGAATCTAGGGC,48,50,2,11,552,0,0
793,ACGTCGAATCTAGGGA,48,54,6,11,553,1,0
794,ACGTCGAATCTAGGGA,48,61,13,9,556,4,0
795,ACGTCGAACCTAGGGA,48,51,3,10,557,0,0
796,ACGTCGAATCTAGGGA,48,50,2,10,558,0,0
797,ACGTCGAATCTAGGGA,48,50,2,10,559,0,0
798,ACGTCGAATCTAGGGA,48,59,11,12,560,3,0
799,ACGTCGAATCTAGGGA,48,56,8,10,562,2,0
800,ACGTCGAATCTGGGGA,48,58,10,10,563,3,0
801,ACGTCGAATCTAGGGA,48,51,3,11,564,0,0
802,ACGTCGAATCTAGGGA,48,74,26,10,566,8,0
803,ACGTCGAATCTAGGGA,48,66,18,12,570,5,0
804,ACGTCGAATCTAGGGA,48,53,5,12,572,1,0
805,ACGTCGAATCTAGGGA,48,61,13,10,574,4,0
806,ACGTCGAATCTAGGGA,48,55,7,10,576,2,0
807,ACGTCGAATCTAGGGA,48,55,7,10,579,2,0
808,ACGTCGAATCTAGGGA,48,54,6,11,580,1,0
809,ACGTCGAATCTAGGGA,48,54,6,11,581,1,0
810,ACGTCGAATCTAGGGA,48,51,3,12,582,0,0
811,ACGTCGAATCTAGGGA,48,57,9,11,583,2,0
812,ACGTCGAATCTAGGGA,48,57,9,11,584,2,0
813,ACGTCGAATCTAGGGA,48,74,26,12,585,8,0
814,ACGTCGAATCTAGGGA,48,54,6,13,586,1,0
815,ACGTCGAATCTAGGGA,48,50,2,10,587,0,0
816,ACGTCGAATCTAGGGA,48,53,5,12,588,1,0
817,ACGTCGAATCTAGGGA,48,48,0,11,589,0,0
818,ACGTCGAAGCTAGGAA,48,50,2,12,590,0,0
819,ACGTCGAATCTAGGGA,48,53,5,12,591,1,0
820,ACGTCGAATCTAGGGA,48,56,8,11,593,2,0
821,ACGTCGAATCTAGGGA,48,48,0,16,594,0,0
822,ACGTCGAATCTAGGGA,51,57,6,5,37,1,0
823,ACGTCGAATCTAGGGA,51,54,3,7,38,0,0
824,ACGTCGAATCTAGGGA,51,56,5,8,56,1,0
825,ACGTCGAATCTAGGGA,51,53,2,6,57,0,0
826,ACGTCGAATCTAGGGA,51,63,12,5,69,3,0
827,ACGTCGAATCTAGGGA,51,51,0,6,86,0,0
828,ACGTCGAATCTAGGGA,51,56,5,8,93,1,0
829,ACGTCGAATCTAGGGA,51,55,4,8,94,1,0
830,ACGCCGAATCTAGGGA,51,64,13,11,100,4,0
831,ACGTCGAATCTAGGGA,51,85,34,7,107,11,0
832,ACGTCGAATCTAGGGA,51,75,24,8,110,7,0
833,ACGTCGAATCTAGGGA,51,75,24,9,124,7,0
834,ACGTCGAATCTAGGGA,51,53,2,8,131,0,0
835,ACGTCGAATCTAGGGA,51,53,2,7,134,0,0
836,ACGTCGAATCTAGGGA,51,61,10,7,153,3,0
837,ACGTCGAATCTAGGGA,51,53,2,10,160,0,0
838,ACGTCGAATCTAGGGA,51,51,0,6,170,0,0
839,ACGTCGAATCTAGGGA,51,51,0,8,176,0,0
840,ACGTCGAATCTAGGGA,51,54,3,9,187,0,0
841,ACGTCGAATCTAGGGA,51,63,12,9,211,3,0
842,ACGTCGAATCTAGGGA,51,59,8,13,220,2,0
843,ACGTCGAATCTAGGGA,51,69,18,7,222,5,0
844,ACGTCGAATCTAGGGA,51,60,9,7,223,2,0
845,ACGTCGAATCTAGGGA,51,56,5,8,225,1,0
846,ACGTCGAATCTAGGGA,51,59,8,8,228,2,0
847,ACGTCGAATCTAGGGC,51,67,16,7,236,5,0
848,ACGTCGAATCTAGGGA,51,88,37,8,249,12,0
849,ACGTCGAATCTAGGGA,51,51,0,8,251,0,0
850,ACGTCGAATCTAGGGA,51,65,14,10,258,4,0
851,ACGTCGAATCTAGGGA,51,53,2,8,266,0,0
852,ACGTCGAATCTAGGGA,51,57,6,10,267,1,0
853,ACGTCGAATCTAGGGA,51,54,3,8,275,0,0
854,ACGTCGAATCTAGGGA,51,72,21,8,276,6,0
855,ACGTCGAATCTAGGGA,51,62,11,9,279,3,0
856,ACGTCGAATCTAGGGA,51,55,4,9,284,1,0
857,ACGTCGAATCTAGGGA,51,62,11,9,289,3,0
858,ACGTCGAATCTAGGGA,51,100,49,9,290,16,0
859,ACGTCGAATCTAGGGA,51,53,2,8,291,0,0
860,ACGTCGAATCTAGGGA,51,67,16,8,294,5,0
861,ACGTCGAAGCTAGGAA,51,68,17,10,301,5,0
862,ACGTCGAATCTAGGGA,51,56,5,5,313,1,0
863,ACGTCGAATCTAGGGA,51,58,7,8,315,2,0
864,ACGTCGAATCTAGGGA,51,64,13,8,316,4,0
865,ACGTCGAATCTAGGAA,51,51,0,8,319,0,0
866,ACGTCGAATCTAGGGA,51,51,0,10,320,0,0
867,ACGTCGAATCTAGGGA,51,91,40,8,324,13,0
868,ACGTCGAATCTAGGGA,51,64,13,9,331,4,0
869,ACGTCGAATCTAGGGA,51,51,0,8,332,0,0
870,ACGTCGAATCTAGGGA,51,60,9,9,335,2,0
871,ACGTCGAATCTAGGGA,51,65,14,11,338,4,0
872,ACGTCGAATCTAGGGA,51,75,24,8,345,7,0
873,ACGTCGAATCTAGGGA,51,83,32,11,352,10,0
874,ACGTCGAATCTAGGGA,51,55,4,9,353,1,0
875,ACGTCGAATCTAGGGA,51,63,12,7,354,3,0
876,ACGTCGAATCTAGGGA,51,57,6,9,356,1,0
877,ACGTCGAATATAGGGA,51,52,1,11,366,0,0
878,ACGTCGAATCTAGGGA,51,54,3,10,369,0,0
879,ACGTCGAATCTAGGGA,51,60,9,14,372,2,0
880,ACGTCGAATCTAGGGA,51,61,10,8,373,3,0
881,ACGTCGAATCTAGGGA,51,52,1,9,375,0,0
882,ACGTCGAATCTAGGGA,51,53,2,9,376,0,0
883,ACGTCGAATCTAGGGC,51,63,12,8,380,3,0
884,ACGTCGAATCTAGGGA,51,71,20,10,386,6,0
885,ACGTCGAATCTAGGGA,51,54,3,10,387,0,0
886,ACGTCGAATCTAGGGA,51,62,11,9,388,3,0
887,ACGTCGAATCTAGGGA,51,62,11,13,389,3,0
888,ACGTCGAATCTAGGGA,51,51,0,9,390,0,0
889,ACGTCGAATCTAGGGA,51,58,7,10,392,2,0
890,ACGTCGAATCTAGGGA,51,56,5,11,393,1,0
891,ACGTCGAATCTAGGGA,51,52,1,10,394,0,0
892,ACGTCGAATCTAGGGA,51,72,21,10,399,6,0
893,ACGTCGAATCTAGGGA,51,53,2,7,405,0,0
894,ACGTCGAATCTAGGGA,51,54,3,9,407,0,0
895,ACGTCGAATCTAGGGA,51,59,8,11,411,2,0
896,ACGTCGAATCTAGGGA,51,53,2,9,417,0,0
897,ACGTCGAAGCTAGGAA,51,52,1,11,420,0,0
898,ACGTCGAATCTAGGGA,51,72,21,11,422,6,0
899,ACGTCGAATCTAGGGA,51,51,0,5,427,0,0
900,ACGTCGAATCTAGGGA,51,53,2,10,432,0,0
901,GCGTCGAATCTAGGGA,51,54,3,8,435,0,0
902,ACGTCGAATCTAGGGA,51,55,4,7,436,1,0
903,ACGTCGAATCTAGGGA,51,55,4,9,437,1,0
904,ACGTCGAATCTAGGGA,51,58,7,9,438,2,0
905,ACGTCGAATCTAGGGA,51,98,47,12,440,15,0
906,ACGTCGAATCTAGGGA,51,96,45,8,441,14,0
907,ACGTCGAATCTAGGGA,51,63,12,9,442,3,0
908,ACGTAGAATCTAGGGA,51,76,25,10,443,8,0
909,ACGTCGAATCTAGGGA,51,55,4,10,444,1,0
910,ACGTCGAATCTAGGGA,51,54,3,13,453,0,0
911,ACGTCGAATCTAGGGA,51,70,19,8,454,6,0
912,ACGTCGAATCTAGGGA,51,60,9,7,458,2,0
913,ACGTCGAATCTAGTGA,51,53,2,9,459,0,0
914,ACGTCGAATCTAGGGA,51,57,6,8,460,1,0
915,ACGTCGAATCTAGGGA,51,57,6,11,461,1,0
916,ACGTCGAATCTAGGGA,51,53,2,10,465,0,0
917,ACGTCGAATCTAGGGA,51,55,4,9,467,1,0
918,ACGTCGAATCTAGGGA,51,51,0,9,470,0,0
919,ACGTCGAATCTAGGGA,51,51,0,9,471,0,0
920,ACGTCGAATCTAGGGA,51,71,20,8,473,6,0
921,ACGTCGAATCTAGGGA,51,68,17,9,475,5,0
922,ACGTCGAATCTAGGGC,51,58,7,8,479,2,0
923,ACGTCGAATCTAGGGA,51,51,0,8,481,0,0
924,ACGTCGAATCTAGGGA,51,67,16,10,483,5,0
925,ACGTCGAATCTAGGGA,51,58,7,9,484,2,0
926,ACGTCGAATCTAGGGA,51,53,2,10,489,0,0
927,ACGTCGAATCTAGGGA,51,51,0,9,492,0,0
928,ACGTCGAATCTAGGGA,51,53,2,11,494,0,0
929,ACGTCGAATCTAGGGA,51,80,29,9,496,9,0
930,ACGTCGAATCTAGGGA,51,67,16,9,497,5,0
931,ACGTCGAATCTAGGGA,51,72,21,10,499,6,0
932,ACGTCGAATCTAGGGA,51,53,2,11,500,0,0
933,ACGTCGAATCTAGGGA,51,53,2,10,501,0,0
934,ACGTCGAATCTAGGGA,51,53,2,10,502,0,0
935,ACGTCGAATCTAGGGA,51,65,14,12,505,4,0
936,ACGTCGAATCTAGGGA,51,54,3,15,510,0,0
937,ACGTCGAATCTAGGGA,51,51,0,6,511,0,0
938,ACGTCGAATCTAGGGA,51,56,5,9,512,1,0
939,ACGTCGAATCTAGGGA,51,72,21,8,515,6,0
940,ACGTCGAATCTAGGGA,51,56,5,7,518,1,0
941,ACGTCGAATCTAGGGA,51,60,9,9,519,2,0
942,ACGTCGAATCTAGGGA,51,71,20,8,520,6,0
943,ACGTCGAATCTAGGGA,51,67,16,10,521,5,0
944,ACGTCGAATCTAGGGA,51,70,19,9,524,6,0
945,ACGTCGAATCTAGGGA,51,55,4,10,531,1,0
946,ACGTCGAATCTAGGGA,51,52,1,9,532,0,0
947,ACGTCGAATCTAGGGA,51,52,1,9,533,0,0
948,ACGTCGAATCTAGGGA,51,57,6,11,534,1,0
949,ACGTCGAATCTAGGGA,51,71,20,9,535,6,0
950,ACGTCGAATCTAGGGA,51,55,4,12,539,1,0
951,ACGTCGAATCTAAGGA,51,55,4,10,540,1,0
952,ACGTCGAATCTAGGGA,51,56,5,8,541,1,0
953,ACGTCGAATCTAGGGA,51,57,6,10,542,1,0
954,ACGTCGAATCTAGGGA,51,53,2,11,545,0,0
955,ACGTCGAATCTAGGGA,51,64,13,12,546,4,0
956,ACGTCGAATCTAGGGA,51,51,0,10,550,0,0
957,ACGTCGAATCTAGGGC,51,53,2,11,552,0,0
958,ACGTCGAATCTAGGGA,51,63,12,11,553,3,0
959,ACGTCGAATCTAGGGA,51,68,17,9,556,5,0
960,ACGTCGAATCTAGGGA,51,53,2,10,559,0,0
961,ACGTCGAATCTAGGGA,51,53,2,11,564,0,0
962,ACGTCGAATCTAGGGA,51,51,0,12,570,0,0
963,ACGTCGAATCTAGGGA,51,60,9,12,572,2,0
964,ACGTCGAATCTAGGGA,51,65,14,10,574,4,0
965,ACGTCGAATCTAGGGA,51,90,39,10,576,12,0
966,ACGTCGAATCTAGGGA,51,53,2,10,579,0,0
967,ACGTCGAATCTAGGGA,51,60,9,11,580,2,0
968,ACGTCGAATCTAGGGA,51,56,5,12,582,1,0
969,ACGTCGAATCTAGGGA,51,51,0,11,583,0,0
970,ACGTCGAATCTAGGGA,51,56,5,11,584,1,0
971,ACGTCGAATCTAGGGA,51,53,2,12,585,0,0
972,ACGTCGAATCTAGGGA,51,65,14,13,586,4,0
973,ACGTCGAATCTAGGGA,51,62,11,10,587,3,0
974,ACGTCGAATCTAGGGA,51,54,3,12,588,0,0
975,ACGTCGAATCTAGGGA,51,51,0,11,589,0,0
976,ACGTCGAAGCTAGGAA,51,63,12,12,590,3,0
977,ACGTCGAATCTAGGGA,51,73,22,12,591,7,0
978,ACGTCGAATCTAGGGA,51,52,1,11,593,0,0
979,ACGTCGAATCTAGGGA,51,63,12,16,594,3,0
980,ACGTCGAATCTAGGGA,51,64,13,6,595,4,0
981,ACGTCGAATCTAGGGA,51,77,26,8,596,8,0
982,AAGTCGAATCTAGGGA,51,57,6,9,597,1,0
983,ACGTCGAATCTAGGGA,51,60,9,10,599,2,0
984,ACGTCGAATCTAGGGA,51,74,23,6,600,7,0
985,ACGTCGAATCTAGGGA,51,53,2,7,601,0,0
986,ACGTCGAATCTAGGGA,51,60,9,9,602,2,0
987,ACGTCGAATCTAGGGA,51,52,1,9,603,0,0
988,ACGTCGAATCTAGGGA,51,57,6,12,604,1,0
989,ACGTAGAATCTAGGGA,51,94,43,10,607,14,0
990,ACGTCGAATCTAGGGA,51,60,9,10,608,2,0
991,ACGTCGAATCTAGGGA,51,54,3,10,609,0,0
992,ACGTCGAATCTAGGGA,51,52,1,13,612,0,0
993,ACGTCGAATCTAGGGA,51,52,1,11,614,0,0
994,ACGTCGAATCTAGGGA,51,54,3,7,615,0,0
995,ACATCGAATCTAGCGA,51,59,8,10,618,2,0
996,ACGTCGAATCTAGGGA,51,66,15,9,620,4,0
997,ACGTCGAATCTCGGGA,51,82,31,10,621,10,0
998,ACGTCGAATCTAGGGA,51,53,2,9,625,0,0
999,ACGTCGAATCTAGGGA,51,59,8,11,627,2,0
1000,ACGTCGAATCTAGGGC,51,51,0,8,628,0,0
1001,ACGTCGAATCTAGGGA,51,57,6,9,629,1,0
1002,ACGTCGAATCTAGGGA,51,71,20,9,630,6,0
1003,ACGTCGAATCTAGGGA,51,55,4,11,632,1,0
1004,ACGTCGAATCTAGGGA,51,57,6,10,633,1,0
1005,ACGTCGAATCTAGGGA,51,67,16,11,634,5,0
1006,ACGTCGAATCTAGGGA,51,83,32,9,635,10,0
1007,ACGTCGAATCTAGGGA,51,63,12,9,640,3,0
1008,ACGTCGAATCTAGGGA,51,53,2,10,641,0,0
1009,ACGTCGAATCTAGGGA,51,64,13,10,642,4,0
1010,ACGTCGAATCTAGGGA,51,53,2,10,645,0,0
1011,ACGTCGAATCTAGGGA,51,51,0,9,646,0,0
1012,ACGTCGAATCTAGGGA,51,69,18,11,647,5,0
1013,ACGTCGAATCTAGGGA,51,64,13,12,648,4,0
1014,ACGTCGAATCTAGGGA,51,65,14,9,649,4,0
1015,ACGTCGAATCTAGGGA,51,59,8,6,652,2,0
1016,ACGTCGAATCTAGGGA,51,54,3,9,653,0,0
1017,ACGTCGAATCTAGGGA,51,54,3,9,654,0,0
1018,ACGTCGAATCTAGGGA,51,63,12,11,657,3,0
1019,ACGTCGAATCTAGGGA,51,81,30,9,659,9,0
1020,ACGTCGAATCTAGGGA,51,66,15,9,662,4,0
1021,ACGTCGAATCTAGGGA,51,57,6,10,663,1,0
1022,ACGTCGAATCTAGGGA,51,63,12,10,665,3,0
1023,ACGTCGAATCTAGGGA,51,63,12,11,666,3,0
1024,ACGTCGAATCTAGGGA,51,59,8,12,669,2,0
1025,ACGTCGAATCTAGGGA,51,53,2,9,673,0,0
1026,ACGTCGAATCTAGGGA,51,54,3,11,674,0,0
1027,ACGTCGAATCTAGGGA,51,61,10,12,675,3,0
1028,ACGTCGAATCTAGGGA,51,69,18,10,676,5,0
1029,ACGTCGAATATAGGGA,51,68,17,12,677,5,0
1030,ACGTCGAATCTAGGGA,51,66,15,11,678,4,0
1031,ACGTCGAATCTAGGGA,51,64,13,10,681,4,0
1032,ACGTCGAATCTAGGGA,51,62,11,10,682,3,0
1033,ACGTCGAATCTAGGGA,51,53,2,10,683,0,0
1034,ACGTCGAATCTAGGGA,51,52,1,12,684,0,0
1035,ACGTCGAATCTAGGGA,51,54,3,10,686,0,0
1036,ACGTCGAATCTAGGGA,51,55,4,11,687,1,0
1037,ACGTCGAATCTAGGGA,51,63,12,10,689,3,0
1038,ACGTCGAATCTAGGGA,51,56,5,11,692,1,0
1039,ACGTCGAATCTAGGGA,51,53,2,11,695,0,0
1040,AGGTCGAATCTAGTGA,51,75,24,10,696,7,0
1041,ACGTCGAATCTAGGGA,51,55,4,10,698,1,0
1042,ACGTCGAATCTAGGGA,51,54,3,12,701,0,0
1043,ACGTCGAAGCTAGGAA,51,51,0,12,703,0,0
1044,ACGTCGAATCTAGGGA,51,53,2,12,704,0,0
1045,ACGTCGAATCTAGGGA,51,69,18,11,705,5,0
1046,ACGTCGAATCTAGGGA,51,85,34,16,706,11,0
1047,ACGTCGAATCTAGGGA,51,53,2,7,708,0,0
1048,ACGTCGAATCTAGGGA,51,70,19,10,709,6,0
1049,ACGTCGAATCTAGGGA,51,63,12,8,714,3,0
1050,ACGTCGAATCTAGGGA,51,90,39,10,715,12,0
1051,ACGTCGAATCTAGGGA,51,57,6,10,716,1,0
1052,ACGTCGAATCTAGGGA,51,79,28,13,717,9,0
1053,ACGTCGAATCTAGGGA,51,52,1,9,718,0,0
1054,ACGTCGAATCTAGGGA,51,52,1,10,719,0,0
1055,ACGTCGAATCTAGGGA,51,53,2,11,721,0,0
1056,ACGTCGATTCTAGGGA,51,63,12,11,724,3,0
1057,ACGTCGAATCTAGGGA,51,55,4,14,726,1,0
1058,ACGTCGAATCTAGGGA,51,71,20,9,727,6,0
1059,ACGTCGAATCTAGGGA,51,61,10,12,728,3,0
1060,ACGTCGAATCTAGTGA,51,58,7,10,730,2,0
1061,ACGTCGAATCTAGGGA,51,61,10,9,731,3,0
1062,ACGTCGAATCTAGGGA,51,109,58,12,732,19,0
1063,ACGTCGAATCTAGGGA,51,56,5,12,733,1,0
1064,ACGTCGAATCTAGGGA,51,52,1,11,735,0,0
1065,ACGTCGAATCTAGGGA,51,64,13,10,736,4,0
1066,ACGTCGAATCTAGGGA,51,58,7,11,737,2,0
1067,ACGTCGAATCTAGGGA,51,52,1,10,739,0,0
1068,ACGTCGAATCTAGGGA,51,72,21,10,741,6,0
1069,ACGTCGAATCTAGGGC,51,53,2,9,742,0,0
1070,ACGTCGAATCTAGGGA,51,51,0,9,743,0,0
1071,ACGTCGAATCTAGGGA,51,51,0,11,744,0,0
1072,ACGTCGAATCTAGGGA,51,74,23,11,745,7,0
1073,ACGTCGAATCTAGGGA,51,51,0,10,746,0,0
1074,ACGTCGAATCTAGGGA,51,69,18,12,749,5,0
1075,ACGTCGAATCTAGGGA,51,97,46,10,750,15,0
1076,ACGTCGAATCTAGGGA,51,57,6,10,751,1,0
1077,ACGTCGAATCTAGGGA,51,52,1,12,752,0,0
1078,ACGTCGAATCTAGGGA,51,62,11,15,753,3,0
1079,ACGTCGAATCTAGGGA,51,57,6,10,754,1,0
1080,ACGTCGAATCTAGGGA,51,55,4,10,755,1,0
1081,ACGTCGAATCTAGGGA,51,64,13,11,756,4,0
1082,ACGTCGAATCTAGGGA,51,53,2,12,757,0,0
1083,ACGTCGAATCTAGGGA,51,79,28,11,758,9,0
1084,ACGTCGAATCTAGGGA,51,51,0,11,759,0,0
1085,ACGTCGAATCTAGGGA,51,59,8,10,760,2,0
1086,ACGTCGAATCTAGGGA,51,89,38,12,761,12,0
1087,ACGTCGAATCTAGGGA,51,54,3,16,764,0,0
1088,ACGTCGAATCTAGGGA,51,61,10,10,767,3,0
1089,ACGTCGAATCTAGGGA,51,62,11,11,768,3,0
1090,ACGTCGAATCTAGGGA,51,51,0,9,769,0,0
1091,ACGTCGAATCTAGGGA,51,54,3,8,770,0,0
1092,ACGTCGAATCTAGGGA,51,57,6,9,772,1,0
1093,ACCTCGAATCTAGGGA,51,53,2,11,773,0,0
1094,ACGTCGAATCTAGGGA,51,58,7,10,774,2,0
1095,ACGTCGAATCTAGGGA,51,84,33,11,776,10,0
1096,ACGTCGAATCTAGGGA,51,59,8,12,778,2,0
1097,ACGTCGAATCTAGGGA,51,71,20,11,779,6,0
1098,ACGTCGAATCTAGGGA,51,55,4,10,780,1,0
1099,ACGTCGAATCTAGGGA,51,75,24,10,781,7,0
1100,ACGTCGAATCTAGGGA,51,55,4,10,783,1,0
1101,ACGTCGAATCTAGGGA,51,51,0,11,785,0,0
1102,ACGTCGAATCTAGGGA,51,60,9,9,786,2,0
1103,ACGTCGAATCTAGGGA,51,54,3,13,790,0,0
1104,ACGTCGAATCTAGGGA,51,52,1,11,791,0,0
1105,ACGTCGAATCTAGGGA,51,55,4,12,793,1,0
1106,ACGTCGAATCTAGGGA,51,53,2,10,794,0,0
1107,ACGTCGAATCTAGGGA,51,58,7,13,798,2,0
1108,ACGTCGAATCTAGGGA,51,60,9,11,799,2,0
1109,ACGTCGAATCTGGGGA,51,57,6,11,800,1,0
1110,ACGTCGAATCTAGGGA,51,51,0,11,802,0,0
1111,ACGTCGAATCTAGGGA,51,51,0,13,803,0,0
1112,ACGTCGAATCTAGGGA,51,82,31,13,804,10,0
1113,ACGTCGAATCTAGGGA,51,67,16,11,805,5,0
1114,ACGTCGAATCTAGGGA,51,71,20,11,806,6,0
1115,ACGTCGAATCTAGGGA,51,57,6,11,807,1,0
1116,ACGTCGAATCTAGGGA,51,52,1,12,808,0,0
1117,ACGTCGAATCTAGGGA,51,62,11,12,809,3,0
1118,ACGTCGAATCTAGGGA,51,52,1,12,811,0,0
1119,ACGTCGAATCTAGGGA,51,57,6,12,812,1,0
1120,ACGTCGAATCTAGGGA,51,60,9,13,813,2,0
1121,ACGTCGAATCTAGGGA,51,64,13,14,814,4,0
1122,ACGTCGAATCTAGGGA,51,82,31,13,816,10,0
1123,ACGTCGAATCTAGGGA,51,60,9,13,819,2,0
1124,ACGTCGAATCTAGGGA,51,58,7,12,820,2,0
1125,ACGTCGAATCTAGGGA,54,70,16,5,37,5,0
1126,ACGTCGAATCTAGGGA,54,59,5,7,38,1,0
1127,ACGTCGAATCTAGGGA,54,66,12,6,57,3,0
1128,ACGTCGAATCTAGGGA,54,73,19,6,86,6,0
1129,ACGTCGAATCTAGGGA,54,59,5,8,93,1,0
1130,ACGTCGAATCTAGGCA,54,64,10,8,94,3,0
1131,ACGTCGAATCTAGGGA,54,55,1,11,100,0,0
1132,ACGTCGAATCTAGGGA,54,93,39,7,107,12,0
1133,ACGTCGAATCTAGGGA,54,64,10,8,110,3,0
1134,ACGTCGAATCTAGGGA,54,62,8,7,134,2,0
1135,ACGTCGAATCTAGGGA,54,62,8,6,170,2,0
1136,ACGTCGAGTCTAGGGA,54,87,33,8,176,10,0
1137,ACGTCGAATCTAGGGA,54,58,4,9,211,1,0
1138,ACGTCGAATCTAGGGA,54,56,2,13,220,0,0
1139,ACGTCGAATCTAGGGA,54,58,4,7,222,1,0
1140,ACGTCGAATCTAGGGA,54,60,6,7,223,1,0
1141,ACGTCGAATCTAGGGA,54,59,5,8,225,1,0
1142,ACGTCGAATCTAGGGA,54,67,13,8,228,4,0
1143,ACGTCGAATCTAGGGC,54,54,0,7,236,0,0
1144,ACGTCGAATCTAGGGA,54,67,13,8,249,4,0
1145,ACGTCGAATCTAGGGA,54,68,14,8,251,4,0
1146,ACGTCGAATCTAGGGA,54,60,6,10,258,1,0
1147,ACGTCGAATCTAGGGA,54,58,4,8,266,1,0
1148,ACGTCGAATCTAGGGA,54,58,4,8,275,1,0
1149,ACGTCGAATCTAGGGA,54,55,1,8,276,0,0
1150,ACGTCGAATCTAGGGA,54,55,1,9,279,0,0
1151,ACGTCGAATCTAGGGA,54,63,9,9,289,2,0
1152,ACGTCGAATCTAGGGA,54,58,4,9,290,1,0
1153,ACGTCGAATCTAGGGA,54,55,1,8,291,0,0
1154,ACGTCGAATCTAGGGA,54,73,19,8,294,6,0
1155,ACGTCGAATCTAGGGA,54,63,9,5,313,2,0
1156,ACGTCGAATCTAGGGA,54,69,15,8,319,4,0
1157,ACGTCGAATCTAGGGA,54,55,1,10,320,0,0
1158,ACGTCGAATCTAGGGA,54,74,20,8,324,6,0
1159,ACGTCGAATCTAGGGA,54,55,1,9,331,0,0
1160,ACGTCGAATCTAGGGA,54,67,13,8,332,4,0
1161,ACGTCGAATCTAGGGA,54,65,11,9,335,3,0
1162,ACGTCGAATCTAGGGA,54,73,19,11,338,6,0
1163,ACGTCGAATCTAGGGA,54,76,22,8,345,7,0
1164,ACGTCGAATCTAGGGA,54,72,18,11,352,5,0
1165,ACGTCGAATCTAGGGA,54,61,7,9,353,2,0
1166,ACGTCGAATCTAGGGA,54,54,0,7,354,0,0
1167,ACGTCGAATCTAGGGA,54,72,18,9,356,5,0
1168,ACGTCGAATCTAGGGA,54,56,2,14,372,0,0
1169,ACGTCGAATCTAGGGA,54,64,10,8,373,3,0
1170,ACGTCGAATCTAGGGA,54,71,17,9,375,5,0
1171,ACGTCGAATCTAGGGA,54,66,12,9,376,3,0
1172,ACGTCGAATCTAGGGC,54,61,7,8,380,2,0
1173,ACGTCGAATCTAGGGA,54,63,9,10,386,2,0
1174,ACGTCGAATCTAGGGA,54,80,26,13,389,8,0
1175,AAGTCGAATCTAGGGA,54,58,4,10,392,1,0
1176,ACGTCGAATCTAGGGA,54,56,2,11,393,0,0
1177,ACGTCGAATCTAGGGA,54,54,0,10,394,0,0
1178,ACGTCGAATCTAGGGA,54,75,21,10,399,6,0
1179,ACGTCGAATCTAGGGA,54,62,8,9,407,2,0
1180,ACGTCGAAGCTAGGAA,54,61,7,11,420,2,0
1181,ACGTCGAATCTAGGGA,54,56,2,11,422,0,0
1182,ACGTCGAATCTAGGGA,54,60,6,10,432,1,0
1183,GCGTCGAATCTAGGGA,54,63,9,8,435,2,0
1184,ACGTCGAATCTAGGGA,54,76,22,7,436,7,0
1185,ACGTCGAATCTAGGGA,54,62,8,9,437,2,0
1186,ACGTCGAATCTAGGGA,54,66,12,9,438,3,0
1187,ACGTCGAATCTAGGGA,54,93,39,12,440,12,0
1188,ACGTCGAATCTAGGGA,54,54,0,8,441,0,0
1189,ACGTCGAATCTAGGGA,54,57,3,9,442,0,0
1190,ACGTAGAATCTAGGGA,54,62,8,10,443,2,0
1191,ACGTCGAATCTAGGGA,54,61,7,10,444,2,0
1192,ACGTCGAATCTAGGGA,54,63,9,8,454,2,0
1193,ACGTCGAATCTAGGGA,54,94,40,7,458,13,0
1194,ACGTCGAATCTAGGGA,54,55,1,8,460,0,0
1195,ACGTCGAATCTAGGGA,54,54,0,11,461,0,0
1196,ACGTCGAATCTAGGGA,54,67,13,10,465,4,0
1197,ACGTCGAATCTAGGGA,54,55,1,9,467,0,0
1198,ACGTCGAATCTAGGGA,54,72,18,9,470,5,0
1199,ACGTCGAATCTAGGGA,54,56,2,9,471,0,0
1200,ACGTCGAATCTAGGGA,54,73,19,8,473,6,0
1201,ACGTCGAATCTAGGGA,54,59,5,9,475,1,0
1202,ACGTCGAATCTAGGGA,54,55,1,8,481,0,0
1203,ACGTCGAATCTAGGGA,54,82,28,9,484,9,0
1204,ACGTCGAATCTAGGGA,54,74,20,10,489,6,0
1205,ACGTCGAATCTAGGGA,54,61,7,9,492,2,0
1206,ACGTCGAATCTAGGGA,54,54,0,11,494,0,0
1207,ACGTCGAATCTAGGGA,54,79,25,9,496,8,0
1208,ACGTCGAATCTAGGGA,54,59,5,9,497,1,0
1209,ACGTCGAATCTAGGGA,54,80,26,10,499,8,0
1210,ACGTCGAATCTAGGGA,54,58,4,10,501,1,0
1211,ACGTCGAATCTAGGGA,54,66,12,12,505,3,0
1212,ACGTCGAATCTAGGGA,54,63,9,15,510,2,0
1213,ACGTCGAATCTAGGGA,54,58,4,6,511,1,0
1214,ACGTCGAATCTAGGGA,54,56,2,8,515,0,0
1215,ACGTCGAATCTAGGGA,54,61,7,9,519,2,0
1216,ACGTCGAATCTAGGGA,54,55,1,8,520,0,0
1217,ACGTCGAATCTAGGGA,54,75,21,10,521,6,0
1218,ACGTCGAATCTAGGGA,54,56,2,9,524,0,0
1219,ACGTCGAATCTAGGGA,54,73,19,10,531,6,0
1220,ACGTCGAATCTAGGGA,54,56,2,9,532,0,0
1221,ACGTCGAATCTAGGGA,54,61,7,9,533,2,0
1222,ACGTCGAATCTAGGGA,54,78,24,11,534,7,0
1223,ACGTCGAATCTAGGGA,54,67,13,9,535,4,0
1224,ACGTCGAATCTAGGGA,54,56,2,12,539,0,0
1225,ACGTCGAATCTAGGGA,54,73,19,8,541,6,0
1226,ACGTCGAATCTAGGGA,54,56,2,10,542,0,0
1227,ACGTCGAATCTAGGGA,54,56,2,11,545,0,0
1228,ACGTCGAATCTAGGGA,54,74,20,12,546,6,0
1229,ACGTCGAATCTAGGGA,54,56,2,10,550,0,0
1230,ACGTCGAATCTAGGGC,54,76,22,11,552,7,0
1231,ACGTCGAATCTAGGGA,54,56,2,10,559,0,0
1232,ACGTCGAATCTAGGGA,54,60,6,12,570,1,0
1233,ACGTCGAATCTAGGGA,54,60,6,10,574,1,0
1234,ACGTCGAATCTAGGGA,54,73,19,10,576,6,0
1235,ACGTCGAATCTAGGGA,54,54,0,10,579,0,0
1236,ACGTCGAATCTAGGGA,54,63,9,11,580,2,0
1237,ACGTCGAATCTAGGGA,54,59,5,12,582,1,0
1238,ACGTCGAATCTAGGGA,54,94,40,11,583,13,0
1239,ACGTCGAATCTAGGGA,54,59,5,13,586,1,0
1240,ACGTCGAATCTAGGGA,54,54,0,10,587,0,0
1241,ACGTCGAATCTAGGGA,54,54,0,12,588,0,0
1242,ACGTCGAATCTAGGGA,54,55,1,11,589,0,0
1243,ACGTCGAATCTAGGGA,54,54,0,12,591,0,0
1244,ACGTCGAATCTAGGGA,54,77,23,11,593,7,0
1245,AAGTCGAATCTAGGGA,54,58,4,9,597,1,0
1246,ACGTCGAATCTAGGGA,54,58,4,10,599,1,0
1247,ACGTCGAATCTAGGGA,54,61,7,6,600,2,0
1248,ACGTCGAATCTAGGGA,54,77,23,9,602,7,0
1249,ACGTCGAATCTTGGGA,54,59,5,13,612,1,0
1250,ACGTCGAATCTAGGGA,54,54,0,7,615,0,0
1251,ACGTCGAATCTAGGGA,54,57,3,9,620,0,0
1252,ACGTCGAATCTAGGGA,54,60,6,10,621,1,0
1253,ACGTCGAATCTAGGGA,54,54,0,11,627,0,0
1254,ACGTCGAATCTAGGGA,54,58,4,9,630,1,0
1255,ACGTCGAATCTAGGGA,54,60,6,11,632,1,0
1256,ACGTCGAATCTAGGGA,54,70,16,11,634,5,0
1257,ACGTCGAATCTAGGGA,54,56,2,9,635,0,0
1258,ACGTCGAATCTAGGGA,54,54,0,9,640,0,0
1259,ACGTCGAGTCTAGGGA,54,60,6,10,642,1,0
1260,ACGTCGAATCTAGGGA,54,65,11,9,646,3,0
1261,ACGTCGAATCTAGGGA,54,61,7,11,647,2,0
1262,ACGTCGAATCTAGGGA,54,57,3,9,649,0,0
1263,ACGTCGAATCTAGGGA,54,57,3,6,652,0,0
1264,ACGTCGAATCTAGGGA,54,59,5,9,653,1,0
1265,ACGTCGAATCTAGGGA,54,74,20,9,654,6,0
1266,ACGTCGAATCTAGGGA,54,66,12,11,657,3,0
1267,ACGTCGAATCTAGGGA,54,54,0,9,659,0,0
1268,ACGTCGAATCTAGGGA,54,56,2,9,662,0,0
1269,ACGTCGAATCTAGGGA,54,60,6,10,663,1,0
1270,ACGTCGAATCTAGGGA,54,57,3,10,665,0,0
1271,ACGTCGAATCTAGGGA,54,71,17,11,666,5,0
1272,ACGTCGAATCTAGGGA,54,54,0,12,669,0,0
1273,ACGTCGAATCTAGGGA,54,57,3,9,673,0,0
1274,ACGTCGAATCTAGGGA,54,57,3,11,674,0,0
1275,ACGTCGAATCTAGGGA,54,54,0,12,675,0,0
1276,ACGTCGAATATAGGGA,54,63,9,12,677,2,0
1277,ACGTCGAATCTAGGGA,54,64,10,10,681,3,0
1278,ACGTCGAATCTAGGGA,54,58,4,10,682,1,0
1279,ACGTCGAATCTAGGGA,54,63,9,10,683,2,0
1280,ACGTCGAATCTAGGGA,54,69,15,10,686,4,0
1281,ACGTCGAATATAGGGA,54,54,0,11,687,0,0
1282,ACGTCGAATCTAGGGA,54,63,9,10,689,2,0
1283,ACGTCGAATCTAGGGA,54,55,1,11,692,0,0
1284,ACGTCGAATCTAGGGA,54,68,14,10,698,4,0
1285,ACGTCGAATCTAGGGA,54,60,6,12,701,1,0
1286,ACGTCGAATCTAGGGA,54,56,2,11,705,0,0
1287,ACGTCGAATCTAGGGA,54,55,1,10,709,0,0
1288,ACGTCGAATCTAGGGA,54,90,36,8,714,11,0
1289,ACGTCGAATCTAGGGA,54,54,0,10,716,0,0
1290,ACGTCGAATCTAGGGA,54,61,7,13,717,2,0
1291,ACGTCGAATCTAGGGA,54,54,0,9,718,0,0
1292,ACGTCGAATCTAGGGA,54,60,6,11,721,1,0
1293,ACGTCGAATCTAGGGA,54,55,1,9,727,0,0
1294,ACGTCGAATCTAGGGA,54,54,0,12,728,0,0
1295,ACGTCGAATCTAGTGA,54,54,0,10,730,0,0
1296,ACGTCGAATCTAGGGA,54,67,13,12,732,4,0
1297,ACGTCGAATCTAGGGA,54,54,0,12,733,0,0
1298,ACGTCGAATCTAGGGA,54,66,12,11,735,3,0
1299,ACGTCGAATCTAGGGA,54,58,4,10,736,1,0
1300,ACGTCGAATCTAGGGA,54,68,14,10,739,4,0
1301,ACGTCGAATCTAGGGA,54,54,0,10,741,0,0
1302,ACGTCGAATCTAGGGA,54,62,8,9,743,2,0
1303,ACGTCGAATCTAGGGA,54,66,12,11,744,3,0
1304,ACGTCGAATCTAGGGA,54,70,16,11,745,5,0
1305,ACGTCGAATCTAGGGA,54,58,4,10,746,1,0
1306,ACGTCGAATCTAGGGA,54,60,6,12,749,1,0
1307,ACGTCGAATCTAGGGA,54,54,0,10,750,0,0
1308,ACGTCGAATCTAGGGA,54,72,18,10,751,5,0
1309,ACGTCGAATCTAGGGA,54,59,5,12,752,1,0
1310,ACGTCGAATCTAGGGA,54,71,17,15,753,5,0
1311,ACGTCGAATCTAGGGA,54,54,0,10,754,0,0
1312,ACGTCGAATCTAGGGA,54,57,3,10,755,0,0
1313,ACGTCGAATCTAGGGA,54,66,12,11,756,3,0
1314,ACGTCGAATCTAGGGA,54,62,8,11,758,2,0
1315,ACGTCGAATCTAGGGA,54,60,6,11,759,1,0
1316,ACGTCGAATCTAGGGA,54,79,25,10,760,8,0
1317,ACGTCGAATCTAGGGA,54,55,1,12,761,0,0
1318,ACGTCGAATCTAGGGA,54,57,3,9,769,0,0
1319,ACGTCGAATCTAGGGA,54,86,32,8,770,10,0
1320,ACGTCGAATCTAGGGA,54,66,12,9,772,3,0
1321,ACGTCGAATCTAGGGA,54,68,14,11,773,4,0
1322,ACGTCGAATCTAGGGA,54,63,9,11,776,2,0
1323,ACGTCGAATCTAGGGA,54,60,6,12,778,1,0
1324,ACGTCGAATCTAGGGA,54,75,21,11,779,6,0
1325,ACGTCGAATCTAGGGA,54,56,2,10,780,0,0
1326,ACGTCGAATCTAGGGA,54,56,2,10,781,0,0
1327,ACGTCGAATCTAGGGA,54,54,0,11,785,0,0
1328,ACGTCGAATCTAGGGA,54,57,3,9,786,0,0
1329,ACGTCGAATCTAGGGA,54,61,7,11,791,2,0
1330,ACGTCGAATCTAGGGA,54,63,9,10,794,2,0
1331,ACGTCGAATCTAGGGA,54,67,13,13,798,4,0
1332,ACGTCGAATCTAGGGA,54,63,9,11,799,2,0
1333,ACGTCGAAACTGGGGA,54,54,0,11,800,0,0
1334,ACGTCGAATCTAGGGA,54,60,6,11,802,1,0
1335,ACGTCGAATCTAGGGA,54,55,1,13,803,0,0
1336,ACGTCGAATCTAGGGA,54,62,8,11,805,2,0
1337,ACGTCGAATCTAGGGA,54,96,42,11,806,13,0
1338,ACGTCGAATCTAGGGA,54,59,5,11,807,1,0
1339,ACGTCGAATCTAGGGA,54,68,14,12,811,4,0
1340,ACGTCGAATCTAGGGA,54,54,0,12,812,0,0
1341,ACGTCGAATCTAGGGA,54,65,11,13,813,3,0
1342,ACGTCGAATCTAGGGA,54,59,5,12,820,1,0
1343,ACGTCGAATCTAGGGA,54,69,15,6,822,4,0
1344,ACGTCGAATCTAGGGA,54,56,2,9,824,0,0
1345,ACGTCGAATCTAGGGA,54,64,10,6,826,3,0
1346,ACGTCGAATCTAGGGA,54,58,4,9,828,1,0
1347,ACGTCGAATCTAGGGA,54,58,4,9,829,1,0
1348,ACGCCGAATCTAGGGA,54,57,3,12,830,0,0
1349,ACGTCGAATCTAGGGA,54,58,4,8,831,1,0
1350,ACGTCGAATCTAGGGA,54,62,8,9,832,2,0
1351,ACGTCGAATCTAGGGA,54,76,22,10,833,7,0
1352,ACGTCGAATCTAGGGA,54,68,14,8,836,4,0
1353,ACGTCGAATCTAGGGA,54,66,12,10,841,3,0
1354,ACGTCGAATCTAGGGA,54,63,9,14,842,2,0
1355,ACGTCGAATCTAGGGA,54,55,1,8,843,0,0
1356,ACGTCGAATCTAGGGA,54,55,1,8,844,0,0
1357,ACGTCGAATCTAGGGA,54,72,18,9,845,5,0
1358,ACGTCGAATCTAGGGA,54,56,2,9,846,0,0
1359,ACGTCGAATCTAGGGC,54,58,4,8,847,1,0
1360,ACGTCGAATCTAGGGA,54,62,8,9,848,2,0
1361,ACGTCGAATCTAGGGA,54,76,22,11,850,7,0
1362,ACGTCGAATCTAGGGA,54,55,1,11,852,0,0
1363,ACGTCGAATCTAGGGA,54,62,8,9,854,2,0
1364,ACGTCGAATCTAGGGA,54,74,20,10,855,6,0
1365,ACGTCGAATCTAGGGA,54,69,15,10,856,4,0
1366,ACGTCGAATCTAGGGA,54,59,5,10,857,1,0
1367,ACGTCGAATCTAGGGA,54,62,8,10,858,2,0
1368,ACGTCGAATCTAGGGA,54,56,2,9,860,0,0
1369,ACGTCGAAGCTAGGAA,54,55,1,11,861,0,0
1370,ACGTCGAATCTAGGGA,54,58,4,6,862,1,0
1371,ACGTCGAATCTAGGGA,54,62,8,9,863,2,0
1372,ACGTCGAATCTAGGGA,54,70,16,9,864,5,0
1373,ACGTCGAATCTAGGGA,54,63,9,9,867,2,0
1374,ACGTCGAATCTAGGGA,54,64,10,10,868,3,0
1375,ACGTCGAATCTAGGGA,54,54,0,10,870,0,0
1376,ACGTCGAATCTAGGGA,54,81,27,12,871,8,0
1377,ACGTCGAATCTAGGGA,54,56,2,9,872,0,0
1378,ACGTCGAATCTCGGGA,54,63,9,12,873,2,0
1379,ACGTCGAATCTAGGGA,54,62,8,10,874,2,0
1380,ACGTCGAATCTAGGGA,54,68,14,8,875,4,0
1381,ACGTCGAATCTAGGGA,54,61,7,10,876,2,0
1382,ACGTCGAATCTAGGGA,54,68,14,15,879,4,0
1383,ACGTCGAATCTAGGGA,54,57,3,9,880,0,0
1384,ACGTCGAATCTAGGGC,54,66,12,9,883,3,0
1385,ACGTCGAATCTAGGGA,54,57,3,11,884,0,0
1386,ACGTCGAATCTAGGGA,54,56,2,10,886,0,0
1387,ACGTCGAATCTAGGGA,54,64,10,14,887,3,0
1388,ACGTCGAATCTAGGGA,54,66,12,11,889,3,0
1389,ACGTCGAATCTAGGGA,54,58,4,12,890,1,0
1390,ACGTCGAATCTAGGGA,54,59,5,11,892,1,0
1391,ACGTCGAATCTAGGGA,54,68,14,12,895,4,0
1392,ACGTCGAATCTAGGGA,54,58,4,12,898,1,0
1393,ACGTCGAATCTAGGGA,54,60,6,8,902,1,0
1394,ACGTCGAATCTAGGGA,54,57,3,10,903,0,0
1395,ACGTCGAATCTAGGGA,54,76,22,10,904,7,0
1396,ACGTCGTATCTAGGGA,54,66,12,13,905,3,0
1397,ACGTCGAATCTAGGGA,54,68,14,9,906,4,0
1398,ACGTCGAATCTAGGGA,54,54,0,10,907,0,0
1399,ACGTAGAATCTAGGGA,54,60,6,11,908,1,0
1400,ACGTCGAATCTAGGGA,54,68,14,11,909,4,0
1401,ACGTCGAATCTAGGGA,54,56,2,9,911,0,0
1402,ACGTCGAATCTAGGGA,54,60,6,8,912,1,0
1403,ACGTCGAATCTAGGGA,54,66,12,9,914,3,0
1404,ACGTCGAATCTAGGGA,54,58,4,12,915,1,0
1405,ACGTCGAATCTAGGGA,54,60,6,10,917,1,0
1406,ACGTCGAATCTAGGGA,54,55,1,9,920,0,0
1407,ACGTCGAATCTAGGGA,54,56,2,10,921,0,0
1408,ACGTCGAATCTAGGGC,54,55,1,9,922,0,0
1409,ACGTCGAATCTAGGGA,54,59,5,11,924,1,0
1410,ACGTCGAATCTAGGGA,54,54,0,10,925,0,0
1411,ACGTCGAATCTAGGGA,54,96,42,10,929,13,0
1412,ACGTCGAATCTAGGGA,54,62,8,10,930,2,0
1413,ACGTCGAATCTAGGGA,54,56,2,11,931,0,0
1414,ACGTCGAATCTAGGGA,54,70,16,13,935,5,0
1415,ACGTCGAATCTAGGGA,54,57,3,10,938,0,0
1416,ACGTCGAATCTAGGGA,54,72,18,9,939,5,0
1417,ACGTCGAATCTAGGGA,54,66,12,8,940,3,0
1418,ACGTCGAATCTAGGGA,54,76,22,10,941,7,0
1419,ACGTCGAATCTAGGGA,54,67,13,9,942,3,0
1420,ACGTCGAATCTAGGGA,54,58,4,11,943,1,0
1421,ACGTCGAATCTAGGGA,54,54,0,10,944,0,0
1422,ACGTCGAATCTAGGGA,54,62,8,11,945,2,0
1423,ACGTCGAATCTAGGGA,54,66,12,12,948,3,0
1424,ACGTCGAATCTAGGGA,54,77,23,10,949,6,0
1425,ACGTCGAATCTAGGGA,54,56,2,13,950,0,0
1426,ACGTCGAATCTTAGGA,54,55,1,11,951,0,0
1427,ACGTCGAATCTAGGGA,54,84,30,9,952,9,0
1428,ACGTCGAATCTAGGGA,54,66,12,11,953,3,0
1429,ACGTCGAATCTAGGGA,54,54,0,13,955,0,0
1430,ACGTCGAATCTAGGGA,54,86,32,12,958,9,0
1431,ACGTCGAATCTAGGGA,54,54,0,10,959,0,0
1432,ACGTCGAATCTAGGGA,54,55,1,13,963,0,0
1433,ACGTCGAATCTAGGGA,54,56,2,11,964,0,0
1434,ACGTCGAATCTAGGGA,54,62,8,11,965,2,0
1435,ACGTCGAATCTAGGGA,54,58,4,12,967,1,0
1436,ACGTCGAATCTAGGGA,54,61,7,13,968,2,0
1437,ACGTCGAATCTAGGGA,54,55,1,12,970,0,0
1438,ACGTCGAATCTAGGGA,54,59,5,14,972,1,0
1439,ACGTCGAATCTAGGGA,54,58,4,11,973,1,0
1440,ACGTCGAAGCTAGGAA,54,61,7,13,976,2,0
1441,ACGTCGAATCTAGGGA,54,54,0,13,977,0,0
1442,ACGTCGAATCTAGGGA,54,61,7,17,979,2,0
1443,ACGTCGAATCTAGGGA,54,57,3,7,980,0,0
1444,ACGTCGAATCTAGGGA,54,60,6,9,981,1,0
1445,AAGTCGAATCTAGGGA,54,72,18,10,982,5,0
1446,ACGTCGAATCTAGGGA,54,71,17,11,983,4,0
1447,ACGTCGAATCTAGGGA,54,57,3,7,984,0,0
1448,ACGTCGAATCTAGGGA,54,79,25,10,986,7,0
1449,ACGTCGAATCTAGGGA,54,63,9,13,988,2,0
1450,ACGTAGAATCTAGGGA,54,62,8,11,989,2,0
1451,ACGTCGAATCTAGGGA,54,75,21,11,990,6,0
1452,ACATCGAATCTAGCGA,54,57,3,11,995,0,0
1453,ACGTCGAATCTAGGGA,54,61,7,10,996,2,0
1454,ACGTCGAATCTCGGGA,54,65,11,11,997,3,0
1455,ACGTTGAATCTAGGGA,54,58,4,12,999,1,0
1456,ACGTCGAATCTAGGGA,54,55,1,10,1001,0,0
1457,ACGTCGAATATAGGGA,54,77,23,10,1002,6,0
1458,ACGTCGAATCTAGGGA,54,56,2,12,1003,0,0
1459,ACGTCGAATCTAGGGA,54,56,2,11,1004,0,0
1460,ACGTCGAATCTAGGGA,54,60,6,12,1005,1,0
1461,ACGTCGAATCTAGGGA,54,75,21,10,1006,6,0
1462,ACGTCGAATCTAGGGA,54,65,11,10,1007,3,0
1463,ACGTCGAATCTAGGGA,54,56,2,11,1009,0,0
1464,ACGTCGAATCTAGGGA,54,55,1,12,1012,0,0
1465,ACGTCGAATCTAGGGA,54,67,13,13,1013,3,0
1466,ACGTCGAATCTAGGGA,54,70,16,10,1014,4,0
1467,ACGTCGAATCTAGGGA,54,125,71,7,1015,22,0
1468,ACGTCGAATCTAGGGA,54,54,0,12,1018,0,0
1469,ACGTCGAATCTAGGGA,54,55,1,10,1019,0,0
1470,ACGTCGAATCTAGGGA,54,74,20,10,1020,5,0
1471,ACGTCGAATCTAGGGA,54,100,46,11,1021,14,0
1472,ACGTCGAATCTAGGGA,54,56,2,11,1022,0,0
1473,ACGTCGAATCTAGGGA,54,60,6,12,1023,1,0
1474,ACGTCGAATCTAGGGA,54,74,20,13,1024,5,0
1475,ACGTCGAATCTAGGGA,54,59,5,13,1027,1,0
1476,ACGTCGAATCTAGGGA,54,112,58,11,1028,17,0
1477,ACGTCGAATATAGGGA,54,69,15,13,1029,3,0
1478,ACGTCGAATCTAGGGA,54,86,32,12,1030,9,0
1479,ACGTCGAATCTAGGGA,54,68,14,11,1031,3,0
1480,ACGTCTAATCTAGGGA,54,56,2,11,1032,0,0
1481,ACGTCGAATCTAGGGA,54,62,8,12,1036,2,0
1482,ACGTCGAATCTAGGGA,54,63,9,11,1037,2,0
1483,ACGTCGAATCTAGGGA,54,61,7,12,1038,2,0
1484,AGGTCGAATCTAGTGA,54,54,0,11,1040,0,0
1485,ACGTCGAATCTAGGGA,54,66,12,11,1041,3,0
1486,ACGTCGAATCTAGGGA,54,67,13,12,1045,3,0
1487,ACGTCGAATCTAGGGA,54,54,0,17,1046,0,0
1488,ACGTCGAATCTAGGGA,54,60,6,11,1048,1,0
1489,ACGTCGAATCTAGGGA,54,56,2,9,1049,0,0
1490,ACGTCGAATCTAGGGA,54,77,23,11,1050,6,0
1491,ACGTCGAATCTAGGGA,54,55,1,11,1051,0,0
1492,ACGTCGAATCTAGGGA,54,61,7,14,1052,2,0
1493,ACGTCGATTCTAGGGA,54,73,19,12,1056,4,0
1494,ACGTCGAATCTAGGGA,54,54,0,15,1057,0,0
1495,ACGTCGAATCTAGGGA,54,60,6,10,1058,1,0
1496,ACGTCGAATCTAGGGA,54,80,26,13,1059,7,0
1497,ACGTCGAATCTAGTGA,54,58,4,11,1060,1,0
1498,ACGTCGAATCTAGGGA,54,54,0,10,1061,0,0
1499,ACGTCGAATCTAGGGA,54,61,7,13,1062,2,0
1500,ACGTCGAATCTAGGGA,54,58,4,13,1063,1,0
1501,ACGTCGAATCTAGGGA,54,54,0,11,1065,0,0
1502,ACGTCGAATCTAGGGA,54,56,2,12,1066,0,0
1503,ACGTCGAATCTAGGGA,54,54,0,11,1068,0,0
1504,ACGTCGAATCTAGGGA,54,81,27,12,1072,7,0
1505,ACGTCGAATCTAGGGA,54,57,3,13,1074,0,0
1506,ACGTCGAATCTAGGGA,54,103,49,11,1075,14,0
1507,ACGTCGAATCTAGGGA,54,58,4,11,1076,1,0
1508,ACGTCGAATCTAGGGA,54,69,15,16,1078,3,0
1509,ACGTCGAATCTAGGGA,54,64,10,11,1079,3,0
1510,ACGTCGAATCTAGGGA,54,72,18,11,1080,4,0
1511,ACGTCGAATCTAGGGA,54,56,2,12,1081,0,0
1512,ACGTCGAATCTAGGGA,54,55,1,12,1083,0,0
1513,ACGTCGAATCTAGGGA,54,65,11,11,1085,3,0
1514,ACGTCGAATCTAGGGA,54,55,1,13,1086,0,0
1515,ACGTCGAATCTAGGGA,54,54,0,11,1088,0,0
1516,ACGTCGAATCTAGGGA,54,57,3,12,1089,0,0
1517,ACGTCGAATCTAGGGA,54,55,1,10,1092,0,0
1518,ACGTCGAATCTAGGGA,54,58,4,11,1094,1,0
1519,ACGTCGAATCTAGGGA,54,103,49,12,1095,14,0
1520,ACGTCGAATCTAGGGA,54,54,0,13,1096,0,0
1521,ACGTCGAATCTAGGGA,54,80,26,12,1097,7,0
1522,ACGTCGAATCTAGGGA,54,54,0,11,1098,0,0
1523,ACGTCGAATCTAGGGA,54,62,8,11,1099,2,0
1524,ACGTCGAATCTAGGGA,54,54,0,11,1100,0,0
1525,ACGTCGACTCTAGGGA,54,66,12,10,1102,3,0
1526,ACGTCGAATCTAGGGA,54,79,25,13,1105,6,0
1527,ACGTCGAATCTAGGGA,54,55,1,14,1107,0,0
1528,ACGTCGAATCTAGGGA,54,57,3,12,1108,0,0
1529,ACGTCGAATCTGGGGA,54,54,0,12,1109,0,0
1530,ACGTCGAATCTAGGGA,54,72,18,14,1112,4,0
1531,ACGTCGAATCTAGGGA,54,67,13,12,1113,3,0
1532,ACGTCGAATCTAGGGA,54,56,2,12,1114,0,0
1533,ACGTCGAATCTAGGGA,54,71,17,12,1115,4,0
1534,ACGTCGAATCTAGGGA,54,59,5,13,1117,1,0
1535,ACGTCGAATCTAGGGA,54,56,2,13,1119,0,0
1536,ACGTCGAATCTAGGGA,54,65,11,14,1120,3,0
1537,ACGTCGAATCTAGGGA,54,65,11,15,1121,3,0
1538,ACGTCGAATCTAGGGA,54,60,6,14,1122,1,0
1539,ACGTCGAATCTAGGGA,54,68,14,14,1123,3,0
1540,ACGTCGAATCTAGGGA,54,56,2,13,1124,0,0
1541,ACGTCGAATCTAGGGA,57,68,11,5,37,2,0
1542,ACGTCGAATCTAGGGA,57,64,7,7,38,2,0
1543,ACGTCGAATCTAGGGA,57,57,0,6,57,0,0
1544,ACGTCGAATCTAGGGA,57,63,6,6,86,1,0
1545,ACGTCGAATCTAGGGA,57,59,2,8,93,0,0
1546,ACGTCGAATCTAGGGA,57,57,0,8,94,0,0
1547,ACGTCGAATCTAGGGA,57,75,18,11,100,4,0
1548,ACGTCGAATCTAGGGA,57,58,1,8,110,0,0
1549,ACGTCGAATCTAGGGA,57,60,3,7,134,0,0
1550,ACGTCGAATCTAGGGA,57,76,19,6,170,4,0
1551,ACGTCGAATCTAGGGA,57,80,23,8,176,6,0
1552,ACGTCGAATCTAGGGA,57,74,17,9,211,4,0
1553,ACGTCGAATCTAGGGA,57,92,35,13,220,10,0
1554,ACGTCGAATCTAGGGA,57,57,0,8,228,0,0
1555,ACGTCGAATCTAGGGA,57,61,4,8,249,1,0
1556,ACGTCGAATCTAGGGA,57,63,6,8,251,1,0
1557,ACGTCGAATCTAGGGA,57,91,34,10,258,9,0
1558,ACGTCGAATCTAGGGA,57,57,0,8,275,0,0
1559,ACGTCGAATCTAGGGA,57,57,0,9,279,0,0
1560,ACGTCGAATCTAGGGA,57,64,7,9,289,2,0
1561,ACGTCGAATCTAGGGA,57,87,30,9,290,7,0
1562,ACGTCGAATCTAGGGA,57,102,45,8,291,12,0
1563,ACGTCGAATCTAGGGA,57,65,8,8,294,2,0
1564,ACGTCGAATCTAGGGA,57,70,13,5,313,2,0
1565,ACGTCGAATCTAGGGA,57,59,2,8,319,0,0
1566,ACGTCGAATCTAGGGA,57,71,14,10,320,2,0
1567,ACGTCGAATCTAGGGA,57,85,28,8,324,7,0
1568,ACGTCGAATCTAGGGA,57,74,17,8,332,3,0
1569,ACGTCGAATCTAGGGA,57,71,14,11,338,2,0
1570,ACGTCGAATCTAGGGA,57,90,33,8,345,8,0
1571,ACGTCGAATCTAGGGA,57,61,4,11,352,1,0
1572,ACGTCGAATCTAGGGA,57,62,5,9,353,1,0
1573,ACGTCGAATCTAGGGA,57,60,3,9,356,0,0
1574,ACGTCGAATCTAGAGA,57,61,4,14,372,1,0
1575,ACGTCGAATCTAGGGA,57,61,4,8,373,1,0
1576,ACGTCGAATCTAGGGA,57,64,7,9,376,2,0
1577,ACGTCGAATCTAGGGA,57,67,10,13,389,2,0
1578,ACGTCGAATCTAGGGA,57,63,6,10,392,1,0
1579,ACGTCGAATCTAGGGA,57,65,8,10,399,2,0
1580,ACGTCGAATCTAGGGA,57,60,3,9,407,0,0
1581,ACGTCGAAGCTAGGAA,57,61,4,11,420,1,0
1582,ACGTCGAATCTAGGGA,57,57,0,11,422,0,0
1583,GCGTCGAATCTAGGGA,57,84,27,8,435,6,0
1584,ACGTCGAATCTAGGGA,57,63,6,9,438,1,0
1585,ACGTCGAATCTAGGGA,57,59,2,12,440,0,0
1586,ACGTCGAATCTAGGGA,57,64,7,8,441,2,0
1587,ACGTCGAATCTAGGGA,57,59,2,9,442,0,0
1588,ACGTCGAATCTAGGGA,57,60,3,10,444,0,0
1589,ACGTCGAATCTAGGGA,57,80,23,8,454,5,0
1590,ACGTCGAATCTAGGGA,57,57,0,7,458,0,0
1591,ACGTCGAATCTAGGGA,57,70,13,8,460,2,0
1592,ACGTCGAATCTAGGGA,57,71,14,9,467,2,0
1593,ACGTCGAATCTAGGGA,57,76,19,9,470,4,0
1594,ACGTCGAATCTAGGGA,57,61,4,9,471,1,0
1595,ACGTCGAATCTAGGGA,57,63,6,8,473,1,0
1596,ACGTCGAATCTAGGGA,57,68,11,9,475,2,0
1597,ACGTCGAATCTAGGGA,57,67,10,8,481,2,0
1598,ACGTCGAATCTAGGGA,57,57,0,9,484,0,0
1599,ACGTCGAATCTAGGGA,57,62,5,10,489,1,0
1600,ACGTCGAATCTAGGGA,57,78,21,9,492,4,0
1601,ACGTCGAATCTAGGGA,57,69,12,11,494,2,0
1602,ACGTCGAATCTAGGGA,57,58,1,9,496,0,0
1603,ACGTCGAATCTAGGGA,57,60,3,10,499,0,0
1604,ATGTCGAATCTAGGGA,57,86,29,10,501,7,0
1605,ACGTCGAATCTAGGGA,57,66,9,12,505,2,0
1606,ACGTCGAATCTAGGGA,57,70,13,15,510,2,0
1607,ACGTCGAATCTAGGGA,57,58,1,6,511,0,0
1608,ACGTCGAATCTAGGGA,57,60,3,9,519,0,0
1609,ACGTCGAATCTAGGGA,57,72,15,8,520,2,0
1610,ACGTCGAATCTAGGGA,57,70,13,10,521,2,0
1611,ACGTCGAATCTAGGGA,57,64,7,9,524,2,0
1612,ACGTCGAATCTAGGGA,57,57,0,10,531,0,0
1613,ACGTCGAATCTAGGGA,57,58,1,9,533,0,0
1614,ACGTCGAATCTAGGGA,57,68,11,11,534,2,0
1615,ACGTCGAATCTAGGGA,57,57,0,9,535,0,0
1616,ACGTCGAATCTAGGGA,57,59,2,12,539,0,0
1617,ACGTCGAATCTAGGGA,57,58,1,8,541,0,0
1618,ACGTCGAATCTAGGGA,57,73,16,10,542,3,0
1619,ACGTCGAATCTAGGGA,57,64,7,11,545,2,0
1620,ACGTCGAATCTAGGGA,57,67,10,12,546,2,0
1621,ACGTCGAATCTAGGGA,57,69,12,10,550,2,0
1622,ACGTCGAATCTAGGGC,57,71,14,11,552,2,0
1623,ACGTCGAATCTAGGGA,57,76,19,10,559,4,0
1624,ACGTCGAATCTAGGGA,57,59,2,12,570,0,0
1625,ACGTCGAATCTAGGGA,57,62,5,10,574,1,0
1626,ACGTCGAATCTAGGGA,57,57,0,10,576,0,0
1627,ACGTCGAATCTAGGGA,57,94,37,12,582,10,0
1628,ACGTCGAATCTAGGGA,57,71,14,11,583,2,0
1629,ACGTCGAATCTAGGGA,57,93,36,10,587,9,0
1630,ACGTCGAATCTAGGGA,57,57,0,11,589,0,0
1631,ACGTCGAATCTAGGGA,57,62,5,12,591,1,0
1632,AAGTCGAATCTAGGGA,57,57,0,9,597,0,0
1633,ACGTCGAATCTAGGGA,57,79,22,10,599,5,0
1634,ACGTCGAATCTAGGGA,57,58,1,6,600,0,0
1635,ACGTCGAATCTAGGGA,57,59,2,9,602,0,0
1636,ACGTCGAATCTAGGGA,57,57,0,13,612,0,0
1637,ACGTCGAATCTAGGGA,57,58,1,11,632,0,0
1638,ACGTCGAATCTAGGGA,57,66,9,9,640,2,0
1639,ACGTCGAATCTAGGGA,57,63,6,10,642,1,0
1640,ACGTCGAATCTAGGGA,57,103,46,11,647,13,0
1641,ACGTCGAATCTAGGGA,57,63,6,9,649,1,0
1642,ACGTCGAATCTAGGGA,57,75,18,6,652,3,0
1643,ACGTCGAATCTAGGGA,57,70,13,9,653,2,0
1644,ACGTCGAATCTAGGGA,57,58,1,9,654,0,0
1645,ACGTCGAATCTAGGGA,57,60,3,11,657,0,0
1646,ACGTCGAATCTAGGGA,57,82,25,9,659,6,0
1647,ACGTCGAATCTAGGGA,57,59,2,9,662,0,0
1648,ACGTCGAATCTAGGGA,57,59,2,10,663,0,0
1649,ACGTCGAATCTAGGGA,57,58,1,10,665,0,0
1650,ACGTCGAATCTAGGGA,57,67,10,11,666,2,0
1651,ACGTCGAATCTAGGGA,57,85,28,12,669,7,0
1652,ACGTCGAATCTAGGGA,57,61,4,9,673,1,0
1653,ACGTCGAATCTAGGGA,57,76,19,11,674,4,0
1654,ACGTCGAATCTAGGGA,57,58,1,12,675,0,0
1655,ACGTCGAATCTAGGGA,57,84,27,10,681,6,0
1656,ACGTCGAATCTAGGGA,57,70,13,10,682,2,0
1657,ACGTCGAATCTAGGGA,57,67,10,10,683,2,0
1658,ACGTCGAATCTAGGGA,57,69,12,10,686,2,0
1659,ACGTCGAATCTAGGGA,57,80,23,11,687,5,0
1660,ACGTCGAATCTAGGGA,57,57,0,10,689,0,0
1661,ACGTCGAATCTAGGGA,57,62,5,11,692,1,0
1662,ACGTCGAATCTAGGGA,57,57,0,10,698,0,0
1663,ACGTCGAATCTAGGGA,57,60,3,12,701,0,0
1664,ACGTCGAATCTAGGGA,57,62,5,11,705,1,0
1665,ACGTCGAATCTAGGGA,57,73,16,10,709,3,0
1666,ACGTCGGATCTAGGGA,57,69,12,8,714,2,0
1667,ACGTCGAATCTAGGGA,57,71,14,11,721,2,0
1668,ACGTCGAATCTAGGGA,57,67,10,12,728,2,0
1669,ACGTCGAATCTAGTGA,57,62,5,10,730,1,0
1670,ACGTCGAATCTAGGGA,57,72,15,12,732,2,0
1671,ACGTCGAATCTAGGGA,57,62,5,12,733,1,0
1672,ACGTCGAATCTAGGGA,57,64,7,11,735,2,0
1673,ACGTCGAATCTAGGGA,57,60,3,10,736,0,0
1674,ACGTCGAATCTAGGGA,57,63,6,10,739,1,0
1675,ACGTCGAATCTAGGGA,57,58,1,10,741,0,0
1676,ACGTCGAATCTAGGGA,57,61,4,9,743,1,0
1677,ACGTCGAATCTAGGGA,57,64,7,11,744,2,0
1678,ACGTCGAATCTAGGGA,57,65,8,11,745,2,0
1679,ACGTCGAATCTAGGGA,57,99,42,10,746,11,0
1680,ACGTCGAATCTAGGGA,57,59,2,12,749,0,0
1681,ACGTCGAATCTAGGGA,57,69,12,12,752,2,0
1682,ACGTCGAATCTAGGGA,57,68,11,10,754,2,0
1683,ACGTCGAATCTAGGGA,57,59,2,10,755,0,0
1684,ACGTCGAATCTAGGGA,57,70,13,11,756,2,0
1685,ACGTCGAATCTAGGGA,57,59,2,11,758,0,0
1686,ACGTCGAATCTAGGGA,57,76,19,11,759,4,0
1687,ACGTCGAATCTAGGGA,57,86,29,12,761,7,0
1688,ACGTCGAATCTAGGGA,57,89,32,9,769,8,0
1689,ACGTCGAATCTAGGGA,57,65,8,8,770,2,0
1690,ACGTCGAATCTAGGGA,57,61,4,11,776,1,0
1691,ACGTCGAATCTAGGGA,57,64,7,12,778,2,0
1692,ACGTCGAATCTAGGGA,57,69,12,11,779,2,0
1693,ACGTCGAATCTAGGGA,57,59,2,10,780,0,0
1694,ACGTCGAATCTAGGGA,57,61,4,10,781,1,0
1695,ACGTCGAATCTAGGGA,57,70,13,11,785,2,0
1696,ACGTCGAATCTAGGGA,57,63,6,11,791,1,0
1697,ACGTCGAATCTAGGGA,57,66,9,10,794,2,0
1698,ACGTCGAATCTAGGGA,57,57,0,13,798,0,0
1699,ACGTCGAATCTGGGGA,57,59,2,11,800,0,0
1700,ACGTCGAATCTAGGGA,57,73,16,11,802,3,0
1701,ACGTCGAATCTAGGGA,57,60,3,13,803,0,0
1702,ACGTCGAATCTAGGGA,57,72,15,11,805,2,0
1703,ACGTCGAATCTAGGGA,57,58,1,13,813,0,0
1704,ACGTCGAATCTAGGGA,57,71,14,6,826,2,0
1705,ACGCCGAATCTAGGGA,57,62,5,12,830,1,0
1706,ACGTCGAATCTAGGGA,57,73,16,8,831,3,0
1707,ACGTCGAATCTAGGGA,57,62,5,9,832,1,0
1708,ACGTCGAATCTAGGGA,57,69,12,10,833,2,0
1709,ACGTCGAATCTAGGGA,57,63,6,8,836,1,0
1710,ACGTCGAACCTAGGGA,57,65,8,10,841,2,0
1711,ACGTCGAATCTAGGGA,57,60,3,14,842,0,0
1712,ACGTCGAATCTAGGGA,57,64,7,8,843,2,0
1713,ACGTCGAATCTAGGGA,57,81,24,8,844,5,0
1714,ACGTCGAATCTAGGGT,57,72,15,9,846,2,0
1715,ACGTCGAATCTAGGGC,57,59,2,8,847,0,0
1716,ACGTCGAATCTAGGGA,57,59,2,9,848,0,0
1717,ACGTCGAATCTAGGGA,57,62,5,11,850,1,0
1718,ACGTCGAATCTAGGGA,57,59,2,9,854,0,0
1719,ACGTCGAATCTAGGGA,57,59,2,10,855,0,0
1720,ACGTCGAATCTAGGGA,57,62,5,10,857,1,0
1721,ACGTCGAATCTAGGGA,57,68,11,10,858,2,0
1722,ACGTCGAATCTAGGGA,57,66,9,9,860,2,0
1723,ACGTCGAAGCTAGGAA,57,58,1,11,861,0,0
1724,ACGTCGAATCTAGGGA,57,71,14,9,863,2,0
1725,ACGTCGAATCTAGGGA,57,62,5,9,864,1,0
1726,ACGTCGAATCTAGGGA,57,59,2,9,867,0,0
1727,ACGTCGAATCTAGGGA,57,57,0,10,868,0,0
1728,ACGTCGAATCTAGGGA,57,58,1,10,870,0,0
1729,ACGTCGAATCTAGGGA,57,63,6,12,871,1,0
1730,ACGACGAATCTAGGGA,57,59,2,9,872,0,0
1731,ACGTCGAATCTAGGGA,57,77,20,12,873,4,0
1732,ACGTCGAATCTAGGGA,57,62,5,8,875,1,0
1733,ACGTCGAATCTAGGGA,57,59,2,15,879,0,0
1734,ACGTCGAATCTAGGGA,57,68,11,9,880,2,0
1735,ACGTCGAATCTAGGGC,57,57,0,9,883,0,0
1736,ACGTCGAATCTAGGGA,57,59,2,11,884,0,0
1737,ACGTCGAATCTAGGGA,57,58,1,10,886,0,0
1738,ACGTCGAATCTAGGGA,57,59,2,14,887,0,0
1739,AAGTCGAATCTAGGGA,57,64,7,11,889,2,0
1740,ACGTCGAATCTAGGGA,57,61,4,11,892,1,0
1741,ACGTCGAATCTAGGGA,57,92,35,12,895,9,0
1742,ACGTCGAATCTAGGGA,57,57,0,12,898,0,0
1743,ACGTCGAATCTAGGGA,57,65,8,10,904,2,0
1744,ACGTCGAATCTAGGGA,57,66,9,13,905,2,0
1745,ACGTCGAATCTAGGGA,57,65,8,9,906,2,0
1746,ACGTCGAATCTAGGGA,57,62,5,10,907,1,0
1747,ACGTAGAATCTAGGGA,57,64,7,11,908,2,0
1748,ACGTCGAATCTAGGGA,57,57,0,9,911,0,0
1749,ACGTCGAATCTAGGGA,57,78,21,8,912,4,0
1750,ACGTCGAATCTAGGGA,57,58,1,9,920,0,0
1751,ACGTCGAATCTAGGGA,57,57,0,10,921,0,0
1752,ACGTCGAATCTAGGGC,57,61,4,9,922,1,0
1753,ACGTCGAATCTAGGGA,57,72,15,11,924,2,0
1754,ACGTCGAATCTAGGGA,57,63,6,10,925,1,0
1755,ACGTCGAATCTAGGGA,57,58,1,10,929,0,0
1756,ACGTCGAATCTAGGGA,57,63,6,10,930,1,0
1757,ACGTCGAATCTAGGGA,57,62,5,11,931,1,0
1758,ACGTCGAATCTAGGGA,57,60,3,13,935,0,0
1759,ACGTCGAATCTAGGGA,57,61,4,9,939,1,0
1760,ACGTCGAATCTAGGGA,57,73,16,10,941,3,0
1761,ACGTCGAATCTAGGGA,57,78,21,9,942,4,0
1762,ACGTCGAATCTAGGGA,57,69,12,11,943,2,0
1763,ACGTCGAATCTAGGGA,57,57,0,10,944,0,0
1764,ACGTCGAATCTAGGGA,57,73,16,10,949,3,0
1765,ACGTCGAATCTAGGGA,57,63,6,13,955,1,0
1766,ACGTCGAATCTAGGGA,57,74,17,12,958,3,0
1767,ACGTCGAATCTAGGGA,57,77,20,10,959,4,0
1768,ACGTCGAATCTAGGGA,57,57,0,13,963,0,0
1769,ACGTCGAATCTAGGGA,57,79,22,11,964,5,0
1770,ACGTCGAATCTAGGGA,57,65,8,11,965,2,0
1771,ACGTCGAATCTAGGGA,57,63,6,12,967,1,0
1772,ACGTCGAATCTAGGGA,57,58,1,14,972,0,0
1773,ACGTCGAATCTAGGGA,57,60,3,11,973,0,0
1774,ACGTCGAAGCTAGGAA,57,90,33,13,976,8,0
1775,ACGTCGAATCTAGGGA,57,61,4,13,977,1,0
1776,CCGTCGAATCTAGGGA,57,84,27,17,979,6,0
1777,ACGTCCAATCTAGGGA,57,59,2,7,980,0,0
1778,ACGTCGAATCTAGGGA,57,58,1,9,981,0,0
1779,ACGTCGAATCTAGGGA,57,62,5,11,983,1,0
1780,ACGTCGAATCTAGGGA,57,92,35,7,984,9,0
1781,ACGTCGAATCTAGGGA,57,64,7,10,986,2,0
1782,ACGTAGAATCTAGGGA,57,66,9,11,989,2,0
1783,ACGTCGAATCTAGGGA,57,72,15,11,990,2,0
1784,ACATCGAATCTAGCGA,57,59,2,11,995,0,0
1785,ACGTCGAATCTAGGGA,57,59,2,10,996,0,0
1786,ACGTCGAATCTCGGGA,57,65,8,11,997,2,0
1787,ACGTCGAATCTAGGGA,57,62,5,12,999,1,0
1788,ACGTCGAATCTAGGGA,57,87,30,10,1002,7,0
1789,ACGTCGAATCTAGGGA,57,59,2,12,1005,0,0
1790,ACGTCGAATCTAGGGA,57,62,5,10,1006,1,0
1791,ACGTCGAATCTAGGGA,57,60,3,10,1007,0,0
1792,ACGTCGAATCTAGGGA,57,60,3,11,1009,0,0
1793,ACGTCGAATCTAGGGA,57,62,5,12,1012,1,0
1794,ACGTCGAATCTAGGGA,57,78,21,13,1013,4,0
1795,ACGTCGAATCTAGGGA,57,58,1,10,1014,0,0
1796,ACGTCGAATCTAGGGA,57,62,5,7,1015,1,0
1797,ACGTCGAATCTAGGGA,57,58,1,12,1018,0,0
1798,ACGTCGAATCTAGGGA,57,59,2,10,1019,0,0
1799,ACGTCGAATCTAGGGA,57,73,16,10,1020,2,0
1800,ACGTCGAATCTAGGGA,57,76,19,11,1022,3,0
1801,ACGTCGAATCTAGGGA,57,64,7,12,1023,2,0
1802,ACGTCGAATCTAGGGA,57,58,1,13,1024,0,0
1803,ACGTCGAATCTAGGGA,57,70,13,13,1027,2,0
1804,ACGTCGAATCTAGGGA,57,57,0,11,1028,0,0
1805,ACGTCGAATATAGGGA,57,60,3,13,1029,0,0
1806,ACGTCGAATCTAGGGA,57,59,2,12,1030,0,0
1807,ACGTCGAATCTAGGGA,57,64,7,11,1031,2,0
1808,ACGTCGAATCTAGGGA,57,65,8,11,1032,2,0
1809,ACGTCGAATCTAGGGA,57,57,0,11,1037,0,0
1810,AGGTCGAATCTAGTGA,57,58,1,11,1040,0,0
1811,ACGTCGAATCTAGGGA,57,65,8,12,1045,2,0
1812,ACGTCGAATCTAGGGA,57,71,14,17,1046,2,0
1813,ACGTCGAATCTAGGGA,57,61,4,11,1048,1,0
1814,ACGTCGAATCTAGGGA,57,65,8,9,1049,2,0
1815,ACGTCGAATCTAGGGA,57,61,4,11,1050,1,0
1816,ACGTCGAAGCTAGGGA,57,62,5,14,1052,1,0
1817,ACGTCGATTCTAGGGA,57,69,12,12,1056,2,0
1818,ACGTCGAATCTAGGGA,57,87,30,10,1058,7,0
1819,ACGTCGAATCTAGGGA,57,68,11,13,1059,2,0
1820,ACGTCGAATCTAGTGA,57,68,11,11,1060,2,0
1821,ACGTCGAATCTAGGGA,57,63,6,10,1061,1,0
1822,ACGTCGAATCTAGGGA,57,82,25,13,1062,5,0
1823,ACGTCGAATCTAGGGA,57,57,0,11,1065,0,0
1824,ACGTCGAATCTAGGGA,57,67,10,12,1066,2,0
1825,ACGTCGAATCTAGGGA,57,62,5,11,1068,1,0
1826,ACGTCGAATCTAGGGA,57,65,8,12,1072,2,0
1827,ACGTCGAATCTAGGGA,57,71,14,13,1074,2,0
1828,ACGACGAATCTAGGGA,57,60,3,11,1075,0,0
1829,ACGTCGAATCTAGGGA,57,70,13,16,1078,2,0
1830,ACGTCGAATCTAGGGA,57,69,12,12,1081,2,0
1831,ACGTCGAATCTAGGGA,57,59,2,12,1083,0,0
1832,ACGTCGAATCTAGGGA,57,58,1,11,1085,0,0
1833,ACGTCGAATCTAGGGA,57,99,42,13,1086,11,0
1834,ACGTCGAATCTAGGGA,57,68,11,11,1088,2,0
1835,ACGTCGAATCTAGGGA,57,65,8,12,1089,2,0
1836,ACGTCGAATCTAGGGA,57,62,5,11,1094,1,0
1837,ACGTCGAATCTAGGGA,57,59,2,12,1095,0,0
1838,ACGTCGAATCTAGGGA,57,63,6,13,1096,1,0
1839,ACGTCGAATCTAGGGA,57,70,13,12,1097,2,0
1840,ACGTCGAATCTAGGGA,57,63,6,11,1099,1,0
1841,ACGTCGAATCTAGGGA,57,58,1,10,1102,0,0
1842,ACGTCGAATCTAGGGA,57,91,34,14,1107,8,0
1843,ACGTCGAATCTAGGGA,57,62,5,12,1108,1,0
1844,ACGTCGAATCTAGGGA,57,67,10,14,1112,2,0
1845,ACGTCGAATCTAGGGA,57,63,6,12,1113,1,0
1846,ACGTCCAATCTAGGGA,57,61,4,12,1114,1,0
1847,ACGTCGAATCTAGGGA,57,60,3,13,1117,0,0
1848,ACGTCGAATCTAGGGA,57,64,7,14,1120,2,0
1849,ACGTCGAATCTAGGGA,57,59,2,15,1121,0,0
1850,ACGTCGAATCTAGGGA,57,72,15,14,1122,2,0
1851,ACGTCGAATCTAGGGA,57,72,15,14,1123,2,0
1852,ACGTCGAATCTAGGGA,57,60,3,13,1124,0,0
1853,ACGTCGAATCTAGGGA,57,71,14,6,1125,2,0
1854,ACGTCGAATCTAGGGA,57,81,24,8,1126,5,0
1855,ACGTCGAATCTAGGGA,57,68,11,7,1127,2,0
1856,ACGTCGAATCTAGGGA,57,61,4,7,1128,1,0
1857,ACGTCGAATCTAGGGA,57,57,0,9,1129,0,0
1858,ACGTCGAATCTAGGCA,57,59,2,9,1130,0,0
1859,ACGTCGAATCTAGGGA,57,57,0,8,1132,0,0
1860,ACGTCGAATCTAGGGA,57,76,19,9,1133,3,0
1861,ACGTCGAATCTAGGGA,57,64,7,8,1134,2,0
1862,ACGTCGAATCTAGGGA,57,72,15,7,1135,2,0
1863,ACGTCGAGTCTAGGGA,57,62,5,9,1136,1,0
1864,ACGTCGAATCTAGGGA,57,62,5,10,1137,1,0
1865,ACGTCGAATCTAGGGA,57,61,4,8,1139,1,0
1866,ACGTCGAATCTAGGGA,57,81,24,8,1140,5,0
1867,ACGTCGAATCTAGGGA,57,58,1,9,1141,0,0
1868,ACGTCGAATCTAGGGA,57,62,5,9,1142,1,0
1869,ACGTCGAATCTAGGGA,57,57,0,9,1144,0,0
1870,ACGTCGAATCTAGGGA,57,59,2,9,1145,0,0
1871,ACGTCGAATCTAGGGA,57,68,11,11,1146,2,0
1872,ACGTCGAATCTAGGGA,57,61,4,9,1147,1,0
1873,ACGTCGAATCTAGGGA,57,57,0,9,1148,0,0
1874,ACGTCGAATCTAGGGA,57,70,13,10,1151,2,0
1875,ACGTCGAATCTAGGGA,57,61,4,10,1152,1,0
1876,ACGTCGAATCTAGGGA,57,62,5,9,1154,1,0
1877,ACGTCGAATCTAGGGA,57,62,5,6,1155,1,0
1878,ACGTCGAATCTAGGGA,57,64,7,9,1156,2,0
1879,ACGTCGAATCTAGGGA,57,63,6,9,1158,1,0
1880,ACGTCGAATCTAGGGA,57,64,7,9,1160,2,0
1881,ACGTCGAATCTAGGGA,57,78,21,10,1161,4,0
1882,ACGTCGAATCTAGGGA,57,70,13,12,1162,2,0
1883,ACGTCGAATCTAGGGA,57,66,9,9,1163,2,0
1884,ACGTCGAATCTAGGGA,57,59,2,12,1164,0,0
1885,ACGTCGAATCTAGGGA,57,63,6,10,1165,1,0
1886,ACGTCGAATCTAGGGA,57,63,6,10,1167,1,0
1887,ACGTCGAATCTAGGGA,57,69,12,9,1169,2,0
1888,ACGTCGAATCTAGGGA,57,58,1,10,1170,0,0
1889,ACGTCGAATCTAGGGA,57,59,2,10,1171,0,0
1890,ACGTCGAATCTAGGGC,57,64,7,9,1172,2,0
1891,ACGTCGATTCTAGGGA,57,59,2,11,1173,0,0
1892,ACGTCGAATCTAGGGA,57,64,7,14,1174,2,0
1893,AAGTCGAATCTAGGGA,57,64,7,11,1175,2,0
1894,ACGTCGAATCTAGGGA,57,64,7,11,1178,2,0
1895,ACGTCGAATCTAGGGA,57,60,3,10,1179,0,0
1896,ACGTCGAAGCTAGGAA,57,62,5,12,1180,1,0
1897,ACGTCGAATCTAGGGA,57,60,3,11,1182,0,0
1898,GCGTCGAATCTAGGGA,57,57,0,9,1183,0,0
1899,ACGTCGAATCTAGGGA,57,67,10,8,1184,2,0
1900,ACGTCGAATCTAGGGA,57,59,2,10,1185,0,0
1901,ACGTCGAATCTAGGGA,57,60,3,10,1186,0,0
1902,ACGTCGAATCTAGGGA,57,71,14,13,1187,2,0
1903,ACGTAGAATCTAGGGA,57,60,3,11,1190,0,0
1904,ACGTCGAATCTAGGGA,57,57,0,11,1191,0,0
1905,ACGTCGAATCTAGGGA,57,64,7,9,1192,2,0
1906,ACGTCGAATCTAGGGA,57,61,4,8,1193,1,0
1907,ACGTCGAATCTAGGGA,57,70,13,11,1196,2,0
1908,ACGTCGAATCTAGGGA,57,60,3,10,1198,0,0
1909,ACGTCGAATCTAGGGA,57,62,5,9,1200,1,0
1910,ACGTCGAATCTAGGGA,57,71,14,10,1201,2,0
1911,ACGTCGAATCTAGGGA,57,59,2,10,1203,0,0
1912,ACGTCGAATCTAGGGA,57,66,9,11,1204,2,0
1913,ACGTCGAATCTAGGGA,57,59,2,10,1205,0,0
1914,ACGTCGAATCTAGGGA,57,58,1,10,1207,0,0
1915,ACGTCGAATCTAGGGA,57,60,3,10,1208,0,0
1916,ACGTCGAATCTAGGGA,57,101,44,11,1209,11,0
1917,ACGTCGAATCTAGGGA,57,67,10,11,1210,2,0
1918,ACGTCGAATCTAGGGA,57,57,0,13,1211,0,0
1919,ACGTCGAATCTAGGGA,57,77,20,16,1212,3,0
1920,ACGTCGAATCTAGGGA,57,58,1,7,1213,0,0
1921,ACGTCGAATCTAGGGA,57,57,0,10,1215,0,0
1922,ACGTCGAATCTAGGGA,57,79,22,11,1217,4,0
1923,ACGTCGAATCTAGGGA,57,57,0,11,1219,0,0
1924,ACGTCGAATCTAGGGA,57,59,2,10,1221,0,0
1925,ACGTCGAATCTAGGGA,57,83,26,12,1222,5,0
1926,ACGTCGAATCTAGGGA,57,64,7,10,1223,2,0
1927,ACGTCGAATCTAGGGA,57,62,5,9,1225,1,0
1928,ACGTCGAATCTAGGGA,57,61,4,13,1228,1,0
1929,ACGTCGAATCTAGGGC,57,58,1,12,1230,0,0
1930,ACGTCGAATCTAGGGA,57,57,0,13,1232,0,0
1931,ACGTCGAATCTAGGGA,57,71,14,11,1233,2,0
1932,ACGTCGAATCTAGGGA,57,61,4,11,1234,1,0
1933,ACGTCGAATCTAGGGA,57,60,3,12,1236,0,0
1934,ACGTCGAATCTAGGGA,57,60,3,13,1237,0,0
1935,ACGTCGAATCTAGGGA,57,85,28,12,1238,6,0
1936,ACGTCGAATCTAGGGA,57,67,10,14,1239,2,0
1937,ACGTCGAATCTAGGGA,57,64,7,12,1244,2,0
1938,AAGTCGAATCTAGGGA,57,78,21,10,1245,4,0
1939,ACGTCGAATCTAGGGA,57,58,1,11,1246,0,0
1940,ACGTCGAATCTAGGGA,57,70,13,7,1247,2,0
1941,ACGTCGAATCTAGGGA,57,61,4,10,1248,1,0
1942,ACGTCGAATCTTGGGA,57,69,12,14,1249,2,0
1943,ACGTCGAATCTAGGGA,57,65,8,11,1252,2,0
1944,ACGTCGAATCTAGGGA,57,58,1,10,1254,0,0
1945,ACGTCGAATCTAGGGA,57,60,3,12,1255,0,0
1946,ACGTCGAATCTAGGGA,57,63,6,12,1256,1,0
1947,ACGTCGAGTCTAGGGA,57,65,8,11,1259,2,0
1948,ACGTCGAATCTAGGGA,57,74,17,10,1260,2,0
1949,ACGTCGAATCTAGGGA,57,79,22,12,1261,3,0
1950,ACGTCGAATCTAGGGA,57,57,0,10,1264,0,0
1951,ACGTCGAATCTAGGGA,57,60,3,10,1265,0,0
1952,ACGTCGAATCTAGGGA,57,59,2,12,1266,0,0
1953,ACGTCGAATCTAGGGA,57,59,2,11,1269,0,0
1954,ACGTCGAATCTAGGGA,57,68,11,12,1271,2,0
1955,ACGTCGAATATAGGGA,57,57,0,13,1276,0,0
1956,ACGTCGAATCTAGGGA,57,57,0,11,1277,0,0
1957,ACGTCGAATCTAGGGA,57,60,3,11,1278,0,0
1958,ACGTCGAATCTAGGGA,57,71,14,11,1279,2,0
1959,ACGTCGAATCTAGGGA,57,57,0,11,1280,0,0
1960,ACGTCGAATCTAGGGA,57,74,17,11,1282,2,0
1961,ACGTCGAATCTAGGGA,57,72,15,11,1284,2,0
1962,ACGTCGAATCTAGGGA,57,69,12,13,1285,2,0
1963,ACGTCGAATCTAGGGA,57,59,2,9,1288,0,0
1964,ACGTCGAATCTAGGGA,57,63,6,14,1290,1,0
1965,ACGTCGAATCTAGGGA,57,58,1,12,1292,0,0
1966,ACGTCGAATCTAGGGA,57,86,29,13,1296,6,0
1967,ACGTCGAATCTAGGGA,57,61,4,12,1298,1,0
1968,ACGTCGAATCTAGGGA,57,106,49,11,1299,12,0
1969,ACGTCGAATCTAGGGA,57,75,18,11,1300,2,0
1970,ACGTCGAATCTAGGGA,57,68,11,10,1302,2,0
1971,ACGTCGAATCTAGGGA,57,58,1,12,1303,0,0
1972,ACGTCGAATCTAGGGA,57,62,5,12,1304,1,0
1973,ACGTCGAATCTAGGGA,57,67,10,11,1305,2,0
1974,ACGTCGAATCTAGGGA,57,82,25,13,1306,4,0
1975,ACGTCGAATCTAGGGA,57,70,13,11,1308,2,0
1976,ACGTCGAATCTAGGGA,57,70,13,13,1309,2,0
1977,ACGTCGAATCTAGGGA,57,90,33,16,1310,7,0
1978,ACGTCGAATCTAGGGA,57,65,8,12,1313,2,0
1979,ACGTCGAATCTAGGGA,57,65,8,12,1314,2,0
1980,ACGTCGAATCTAGGGA,57,66,9,12,1315,2,0
1981,ACGTCGAATCTAGGGA,57,81,24,11,1316,4,0
1982,ACGTCGAATCTAGGGA,57,69,12,9,1319,2,0
1983,ACGTCGAATCTAGGGA,57,78,21,10,1320,3,0
1984,ACGTCGAATCTAGGGA,57,91,34,12,1321,7,0
1985,ACGTCGAATCTAGGGA,57,88,31,12,1322,6,0
1986,ACGTCGAATCTAGGGA,57,67,10,13,1323,2,0
1987,ACGTCGAATCTAGGGA,57,72,15,12,1324,2,0
1988,ACGTCGAATCTAGGGA,57,62,5,12,1329,1,0
1989,ACGTCGAATCTAGGGA,57,72,15,11,1330,2,0
1990,ACGTCGAATCTAGGGA,57,59,2,14,1331,0,0
1991,ACGTCGAATCAAGGGA,57,77,20,12,1332,3,0
1992,ACGTCGAATCTAGGGA,57,70,13,12,1334,2,0
1993,ACGTCGAATCTAGGGA,57,76,19,12,1336,2,0
1994,ACGTCGAATCTAGGGA,57,59,2,12,1337,0,0
1995,ACGTCGAATCTAGGGA,57,57,0,12,1338,0,0
1996,ACGTCGAATCTAGGGA,57,74,17,13,1339,2,0
1997,ACGTCGAATCTAGGGA,57,57,0,14,1341,0,0
1998,ACGTCGAATCTAGGGA,57,67,10,13,1342,2,0
1999,ACGTCGAATCTAGGGA,57,57,0,7,1343,0,0
2000,ACGTCGAATCTAGGGA,57,69,12,7,1345,2,0
2001,ACGTCGAATCTAGGGA,57,67,10,10,1346,2,0
2002,ACGTCGAATCTAGGGA,57,57,0,10,1347,0,0
2003,ACGTCGAATCTAGGGA,57,57,0,9,1349,0,0
2004,ACGTCGAATCTAGGGA,57,58,1,10,1350,0,0
2005,ACGTCGAATCTAGGGA,57,59,2,11,1351,0,0
2006,ACGTCGAATCTAGGGA,57,57,0,9,1352,0,0
2007,ACGTCGAATCTAGGGA,57,58,1,11,1353,0,0
2008,ACGTCGAATCTAGGGA,57,65,8,15,1354,2,0
2009,ACGTCGAATCTAGGGA,57,60,3,10,1357,0,0
2010,ACGTCGAATCTAGGGC,57,69,12,9,1359,2,0
2011,ACGTCGAATCTAGGGA,57,66,9,10,1360,2,0
2012,ACGTCGAATCTAGGGA,57,63,6,12,1361,1,0
2013,ACGTCGAATCTAGGGA,57,64,7,10,1363,2,0
2014,ACGTCGAATCTAGGGA,57,60,3,11,1364,0,0
2015,ACGTCGAATCTAGGGA,57,64,7,11,1365,2,0
2016,ACGTCGAATCTAGGGA,57,65,8,11,1366,2,0
2017,ACGTCGAATCTAGGGA,57,63,6,11,1367,1,0
2018,ACGTCGAATCTAGGGA,57,82,25,7,1370,4,0
2019,ACGTCGAATCTAGGGA,57,62,5,10,1371,1,0
2020,ACGTCGAATCTAGGGA,57,67,10,10,1372,2,0
2021,ACGTCGAATCAAGGGA,57,72,15,10,1373,2,0
2022,ACGTCGAATCTAGGGA,57,60,3,11,1374,0,0
2023,ACGTCGAATCTAGGGA,57,90,33,13,1376,7,0
2024,ACGTCGAATCTCGGGA,57,58,1,13,1378,0,0
2025,ACGTCGAATCTAGGGA,57,61,4,11,1379,1,0
2026,ACGTCGAATCTAGGGA,57,58,1,9,1380,0,0
2027,ACGTCGAATCTAGGGA,57,57,0,11,1381,0,0
2028,ACGTCGAATCTAGGGA,57,74,17,16,1382,2,0
2029,ACGTCGAATCTAGGGC,57,63,6,10,1384,1,0
2030,ACGTCGAATCTAGGGA,57,64,7,15,1387,2,0
2031,ACGTCGAATCTAGGGA,57,69,12,12,1388,2,0
2032,ACGTCGAATCTAGGGA,57,62,5,13,1389,1,0
2033,ACGTCGAATCTAGGGA,57,59,2,12,1390,0,0
2034,ACGTCGAATCTAGGGA,57,67,10,13,1391,2,0
2035,ACGTCGAATCTAGGGA,57,57,0,13,1392,0,0
2036,ACGTCGAATCTAGGGA,57,57,0,9,1393,0,0
2037,ACGTCGAATCTAGGGA,57,57,0,11,1395,0,0
2038,ACGTCGTATCTAGGGA,57,61,4,14,1396,1,0
2039,ACGTCGAATCTAGGGA,57,73,16,10,1397,2,0
2040,ACGTAGAATCTAGGGA,57,74,17,12,1399,2,0
2041,ACGTCGAATCTAGGGA,57,92,35,12,1400,8,0
2042,ACGTCGAATCTAGGGA,57,62,5,9,1402,1,0
2043,ACGTCGAATCTAGGGA,57,60,3,10,1403,0,0
2044,ACGTGGAATCTAGGGA,57,64,7,13,1404,2,0
2045,ACGTCGAATCTAGGGA,57,97,40,11,1405,9,0
2046,ACGTCGAATCTAGGGA,57,63,6,12,1409,1,0
2047,ACGTCGAATCTAGGGA,57,62,5,11,1411,1,0
2048,ACGTCGAATCTAGGGA,57,59,2,11,1412,0,0
2049,ACGTCGAATCTAGGGA,57,58,1,14,1414,0,0
2050,ACGTCGAATCTAGGGA,57,64,7,10,1416,2,0
2051,ACGTCGAATCTAGGGA,57,63,6,9,1417,1,0
2052,ACGTCGAATCTAGGGA,57,63,6,11,1418,1,0
2053,ACGTCGAATCTAGGGA,57,62,5,10,1419,1,0
2054,ACGTCGAATCTAGGGA,57,57,0,12,1420,0,0
2055,ACGTCGAATCTAGGGA,57,60,3,12,1422,0,0
2056,ACGTCGAATCTAGGGA,57,57,0,13,1423,0,0
2057,ACGTCGAATCTAGGGA,57,86,29,11,1424,6,0
2058,ACGTCGAATCTAGGGA,57,73,16,10,1427,2,0
2059,ACGTCGAATCTAGGGA,57,72,15,12,1428,2,0
2060,ACGTCGAATCTAGGGA,57,67,10,13,1430,2,0
2061,ACGTCGAATCTAGGGA,57,72,15,12,1434,2,0
2062,ACGTCGAATCTAGGGA,57,60,3,13,1435,0,0
2063,ACGTCGAATCTAGGGA,57,62,5,14,1436,1,0
2064,ACGTCGAATCTAGGGA,57,64,7,15,1438,2,0
2065,ACGTCGAATCTAGGGA,57,59,2,12,1439,0,0
2066,ACGTCGAAGCTAGGAA,57,62,5,14,1440,1,0
2067,ACGTCGAATCTAGGGA,57,70,13,18,1442,2,0
2068,ACGTCGAATCTAGGGA,57,72,15,10,1444,2,0
2069,AAGTCGAATCTAGGGA,57,59,2,11,1445,0,0
2070,ACGTCGAATCTAGGGA,57,58,1,12,1446,0,0
2071,ACGTCGAATCTAGGGA,57,59,2,11,1448,0,0
2072,ACGTCGAATCTAGGGA,57,58,1,14,1449,0,0
2073,ACGTAGAATCTAGGGA,57,58,1,12,1450,0,0
2074,ACGTCGAATCTAGGGA,57,68,11,12,1451,2,0
2075,ACGTCGAATCTAGGGA,57,72,15,11,1453,2,0
2076,ACGTCGAATCTCGGGA,57,72,15,12,1454,2,0
2077,ACGTTGAATCTAGGGA,57,67,10,13,1455,2,0
2078,ACGTCGAATATAGGGA,57,59,2,11,1457,0,0
2079,ACGTCGAATCTAGGGA,57,71,14,13,1460,2,0
2080,ACGTCGAATCTAGGGA,57,64,7,11,1461,2,0
2081,ACGTCGAATCTAGGGA,57,57,0,11,1462,0,0
2082,ACGTCGAATCTAGGGA,57,72,15,14,1465,2,0
2083,ACGTCGAATCTAGGGA,57,67,10,11,1466,2,0
2084,ACGTCGAATCTAGGGA,57,63,6,8,1467,1,0
2085,ACGTCGAATCTAGGGA,57,72,15,11,1470,2,0
2086,ACGTCGAATCTAGGGA,57,64,7,12,1471,2,0
2087,ACGTCGAATCTAGGGA,57,72,15,13,1473,2,0
2088,ACGTCGAATCTAGGGA,57,72,15,14,1474,2,0
2089,ACGTCGAATCTAGGGA,57,57,0,14,1475,0,0
2090,ACGTCGAATCTAGGGA,57,69,12,12,1476,2,0
2091,ACGTCGAATAGAGGGA,57,62,5,14,1477,1,0
2092,ACGTCGAATCTAGGGA,57,70,13,13,1478,2,0
2093,ACGTCGAATCTAGGGA,57,61,4,12,1479,1,0
2094,ACGTCGAATCTAGGGA,57,57,0,13,1481,0,0
2095,ACGTCGAATCTAGGGA,57,72,15,12,1482,2,0
2096,ACGTCGAATCTAGGGA,57,71,14,13,1483,2,0
2097,ACGTCGAATCTAGGGA,57,60,3,12,1485,0,0
2098,ACGTCGAATCTAGGGA,57,64,7,13,1486,2,0
2099,ACGTCGAATCTAGGGA,57,72,15,12,1488,2,0
2100,ACGTCGAATCTAGGGA,57,66,9,12,1490,2,0
2101,ACGTCGAATCTAGGGA,57,61,4,15,1492,1,0
2102,ACGTCGATTCTAGGGA,57,64,7,13,1493,2,0
2103,ACGTCGAATCTAGGGT,57,60,3,11,1495,0,0
2104,ACGTCGAATCTAGGGA,57,64,7,14,1496,2,0
2105,ACGTCGAATCTAGTGA,57,57,0,12,1497,0,0
2106,ACGTCGAATCTAGGGA,57,64,7,14,1499,2,0
2107,ACGTCGAATCTAGGGA,57,57,0,14,1500,0,0
2108,ACGTCGAATCTAGGGA,57,72,15,13,1504,2,0
2109,ACGTCGAATCTAGGGA,57,72,15,12,1506,2,0
2110,ACGTCGAATCTAGGGA,57,60,3,12,1507,0,0
2111,ACGTCGAATCTAGGGA,57,71,14,17,1508,2,0
2112,ACGTCGAATCTAGGGA,57,70,13,12,1509,2,0
2113,ACGTCGAATCTAGGGA,57,62,5,12,1510,1,0
2114,ACGTCGAATCTAGGGA,57,60,3,12,1513,0,0
2115,ACGTCGAATCTAGGGA,57,59,2,12,1518,0,0
2116,ACGTCGAATCTAGGGA,57,63,6,13,1519,1,0
2117,ACGTCGAATCTAGGGA,57,61,4,13,1521,1,0
2118,ACGTCGAATCTAGGGA,57,58,1,12,1523,0,0
2119,ACGTCGACTCTAGGGA,57,61,4,11,1525,1,0
2120,ACGTCGAATCTAGGGA,57,57,0,14,1526,0,0
2121,ACGTCGAATCTAGGGA,57,60,3,15,1530,0,0
2122,ACGTCGAATCTAGGGA,57,58,1,13,1531,0,0
2123,ACGTCGAATCTAGGGA,57,58,1,13,1533,0,0
2124,ACGTCGAATCTAGGGA,57,72,15,14,1534,2,0
2125,ACGTCGAATCTAGGGA,57,72,15,15,1536,2,0
2126,ACGTCGAATCTAGGGA,57,59,2,16,1537,0,0
2127,ACGTCGAATCTAGGGA,57,65,8,15,1538,2,0
2128,ACGTCGAATCTAGGGA,57,59,2,15,1539,0,0
2129,ACGTCGAATCTAGGGA,60,64,4,5,37,1,0
2130,ACGTCGAATCTAGGGA,60,65,5,6,57,1,0
2131,ACGTCGAATCTAGGGA,60,72,12,6,86,1,0
2132,ACGTCGAATCTAGGGA,60,72,12,8,93,1,0
2133,ACGTCGAATCTAGGGA,60,63,3,8,94,0,0
2134,ACGTCGAATCTAGGGA,60,69,9,11,100,1,0
2135,ACGTCGAATCTAGGGA,60,67,7,8,110,1,0
2136,ACGTCGAATCTAGGGA,60,60,0,7,134,0,0
2137,ACGTCGAATCTAGGGA,60,61,1,8,176,0,0
2138,ACGTCGAATCTAGGGA,60,71,11,9,211,1,0
2139,ACGTCGAATCTAGGGA,60,72,12,13,220,1,0
2140,ACGTCGAATCTAGGGA,60,63,3,8,228,0,0
2141,ACGTCGAATCTAGGGA,60,62,2,8,251,0,0
2142,ACGTCGAATCTAGGGA,60,61,1,8,275,0,0
2143,ACGTCGAATCTAGGGA,60,68,8,9,289,1,0
2144,ACGTCGAATCTAGGGA,60,63,3,9,290,0,0
2145,ACGTCGAATCTAGGGA,60,60,0,8,291,0,0
2146,ACGTCGAATCTAGGGA,60,61,1,8,294,0,0
2147,ACGTCGAATCTAGGGA,60,65,5,5,313,1,0
2148,ACGTCGAATCTAGGGA,60,60,0,8,319,0,0
2149,ACGTCGAATCTAGGGA,60,72,12,10,320,1,0
2150,ACGTCGAATCTAGGGA,60,64,4,8,345,1,0
2151,ACGTCGAATCTAGGGA,60,64,4,11,352,1,0
2152,ACGTCGAATCTAGGGA,60,69,9,9,353,1,0
2153,ACGTCGAATCTAGGGA,60,72,12,9,356,1,0
2154,ACGTCGAATCTAGGGA,60,65,5,14,372,1,0
2155,ACGTCGAATCTAGGGA,60,70,10,8,373,1,0
2156,ACGTCGAATCTAGGGA,60,65,5,9,376,1,0
2157,ACGTCGAATCTAGGGA,60,70,10,10,392,1,0
2158,ACGTCGAATATAGGGA,60,72,12,11,422,1,0
2159,ACGTCGAATCTAGGGA,60,60,0,12,440,0,0
2160,ACGTCGAATCTAGGGA,60,71,11,8,441,1,0
2161,ACGTCGAATCTAGGGA,60,60,0,9,442,0,0
2162,ACGTCGAATCTAGGGA,60,63,3,10,444,0,0
2163,ACGTCGAATCTAGGGA,60,72,12,8,454,1,0
2164,ACGTCGAATCTAGGGA,60,72,12,7,458,1,0
2165,ACGTCGAATCTAGGGA,60,60,0,8,460,0,0
2166,ACGTCGAATCTAGGGA,60,72,12,9,470,1,0
2167,ACGTCGAATCTAGGGA,60,63,3,9,471,0,0
2168,ACGTCGAATCTAGGGA,60,60,0,8,473,0,0
2169,ACGTCGAATCTAGGGA,60,71,11,9,475,1,0
2170,ACGTCGAATCTAGGGA,60,72,12,8,481,1,0
2171,ACGTCGAATCTAGGGA,60,71,11,10,489,1,0
2172,ACGTCGAATCTAGGGA,60,72,12,9,492,1,0
2173,ACGTCGAATCTAGGGA,60,70,10,9,496,1,0
2174,ACGTCGAATCTAGGGA,60,63,3,10,501,0,0
2175,ACGTCGAATCTAGGGA,60,67,7,12,505,1,0
2176,ACGTCGAATCTAGGGA,60,64,4,15,510,1,0
2177,ACGTCGAATCTAGGGA,60,60,0,9,519,0,0
2178,ACGTCGAATCTAGGGA,60,69,9,8,520,1,0
2179,ACGTCGAATCTAGGGA,60,63,3,10,521,0,0
2180,ACGTCGAATCTAGGGA,60,61,1,9,524,0,0
2181,ACGTCGAATCTAGGGA,60,63,3,10,531,0,0
2182,ACGTCGAATCTAGGGA,60,72,12,12,539,1,0
2183,ACGTCGAATCTAGGGA,60,66,6,8,541,1,0
2184,ACGTCGAATCTAGGGA,60,61,1,10,542,0,0
2185,ACGTCGAATCTAGGGA,60,60,0,11,545,0,0
2186,ACGTCGAATCTAGGGA,60,72,12,12,546,1,0
2187,ACGTCGAATCTAGGGA,60,62,2,10,550,0,0
2188,AAGTCGAATCTAGGGC,60,62,2,11,552,0,0
2189,ACGTCGAATCTAGGGA,60,61,1,10,559,0,0
2190,ACGTCGAATCTAGGGA,60,72,12,10,574,1,0
2191,ACGTCGAATCTAGGGA,60,72,12,10,576,1,0
2192,ACGTCGAATCTAGGGA,60,60,0,12,582,0,0
2193,ACGTCGAATCTAGGGA,60,63,3,11,583,0,0
2194,ACGTCGAATCTAGGGA,60,72,12,10,587,1,0
2195,ACGTCGAATCTAGGGA,60,72,12,11,589,1,0
2196,ACGTCGAATCGAGGGA,60,72,12,12,591,1,0
2197,AAGTCGAATCTAGGGA,60,61,1,9,597,0,0
2198,ACGTCGAATCTAGGGA,60,60,0,10,599,0,0
2199,ACGTCGAATCTAGGGA,60,66,6,6,600,1,0
2200,ACGTCGAATCTAGGGA,60,72,12,13,612,1,0
2201,ACGTCGAATCTAGGGA,60,72,12,11,632,1,0
2202,ACGTCGAATCTAGGGA,60,72,12,9,640,1,0
2203,ACGTCGAATCTAGGGA,60,61,1,10,642,0,0
2204,ACGTCGAATCTAGGGA,60,72,12,11,647,1,0
2205,ACGTCGAATCTAGGGA,60,72,12,9,649,1,0
2206,ACGTCGAATCTAGGGA,60,60,0,9,653,0,0
2207,ACGTCGAATCTAGGGA,60,65,5,11,657,1,0
2208,ACGTCGAATCTAGGGA,60,67,7,9,662,1,0
2209,ACGTCGAATCTAGGGA,60,72,12,10,663,1,0
2210,ACGTCGAATCTAGGGA,60,60,0,10,665,0,0
2211,ACGTCGAATCTAGGGA,60,72,12,11,666,1,0
2212,ACGTCGAATCTAGGGA,60,62,2,9,673,0,0
2213,ACGTCGAATCTAGGGA,60,63,3,12,675,0,0
2214,GCGTCGAATCTAGGGA,60,60,0,10,681,0,0
2215,ACGTCGAATCTAGGGA,60,66,6,10,682,1,0
2216,ACGTCGAATCTAGGGA,60,63,3,11,687,0,0
2217,ACGTCGAATCTAGGGA,60,66,6,11,692,1,0
2218,ACGTCGAATCTAGGGA,60,67,7,12,701,1,0
2219,ACGTCGAATCTAGGGA,60,63,3,11,705,0,0
2220,ACGTCGAATCTAGGGA,60,61,1,8,714,0,0
2221,ACGTCGAATCTAGGGA,60,67,7,12,728,1,0
2222,ACGTCGAATCTAGTGA,60,72,12,10,730,1,0
2223,ACGTCGAATCTAGGGA,60,62,2,12,732,0,0
2224,ACGTCGAATCTAGGGA,60,71,11,12,733,1,0
2225,ACGTCGAATCTAGGGA,60,69,9,10,736,1,0
2226,ACGTCGAATCTAGGGA,60,68,8,10,739,1,0
2227,ACGTCGAATCTAGGGA,60,72,12,10,741,1,0
2228,ACGTCGAATCTAGGGA,60,72,12,11,744,1,0
2229,ACGTCGAATCTAGGGA,60,61,1,11,745,0,0
2230,ACGTCGAATCTAGGGA,60,62,2,10,746,0,0
2231,ACGTCGAATCTAGGGA,60,72,12,12,749,1,0
2232,ACGTCGAATCTAGGGA,60,65,5,12,752,1,0
2233,ACGTCGAATCTAGGGA,60,72,12,10,754,1,0
2234,ACGTCGAATCTAGGGA,60,72,12,10,755,1,0
2235,ACGTCGAATCTAGGGA,60,60,0,11,756,0,0
2236,ACGTCGAATCTAGGGA,60,65,5,11,758,1,0
2237,ACGTCGAATCTAGGGA,60,68,8,11,759,1,0
2238,ACGTCGAATCTAGGGA,60,61,1,8,770,0,0
2239,ACGTCGAATCTAGGGA,60,61,1,11,776,0,0
2240,ACGTCAAATCTAGGGA,60,72,12,12,778,1,0
2241,ACGTCGAATCTAGGGA,60,60,0,10,780,0,0
2242,ACGTCGAATCTAGGGA,60,68,8,10,781,1,0
2243,ACGTCGAATCTAGGGA,60,72,12,11,785,1,0
2244,ACGTCGAATCTAGGGA,60,62,2,11,791,0,0
2245,ACGTCGAATCTAGGGG,60,72,12,10,794,1,0
2246,ACGTCGAATCTAGGGA,60,70,10,11,802,1,0
2247,ACGTCGAATCTAGGGA,60,62,2,13,803,0,0
2248,ACGTCGAATCTAGGGA,60,72,12,11,805,1,0
2249,ACGTCGAATCTAGGGA,60,65,5,13,813,1,0
2250,ACGTCGAATCTAGGGA,60,60,0,6,826,0,0
2251,ACGCCGAATCTAGGGA,60,72,12,12,830,1,0
2252,ACGTCGAATCTAGGGA,60,71,11,8,831,1,0
2253,ACGTCGAATCTAGGGA,60,70,10,9,832,1,0
2254,ACGTCGAATCTAGGGA,60,63,3,10,833,0,0
2255,ACGTCGAATCTGGGGA,60,62,2,8,836,0,0
2256,ACGTCGAATCTAGGGA,60,61,1,10,841,0,0
2257,ACGTCGAATCTAGGGA,60,60,0,8,843,0,0
2258,ACGTCGAATCTAGGGC,60,60,0,8,847,0,0
2259,ACGTCGAATCTAGGGA,60,70,10,9,848,1,0
2260,ACGTCGAATCTAGGGA,60,65,5,11,850,1,0
2261,ACGTCGAATCTAGGGA,60,70,10,9,854,1,0
2262,ACGTCGAATCTAGGGA,60,64,4,10,855,1,0
2263,ACGTCGAATCTAGGGA,60,60,0,10,857,0,0
2264,ACGTCGAATCTAGGGA,60,62,2,10,858,0,0
2265,ACGTCGAATCTAGGGA,60,69,9,9,860,1,0
2266,ACGTCGAAGCTAGGAA,60,61,1,11,861,0,0
2267,ACGTCGAATCTAGGGA,60,67,7,9,864,1,0
2268,ACGTCGAATCTAGGGA,60,69,9,9,867,1,0
2269,ACGTCGAATCTAGGGA,60,70,10,10,868,1,0
2270,ACGTCGAATCTAGGGA,60,60,0,12,871,0,0
2271,ACGTCGAATCTAGGGA,60,61,1,9,872,0,0
2272,ACGTCGAATCTAGGGA,60,70,10,12,873,1,0
2273,ACGTCGAATCTAGGGA,60,68,8,8,875,1,0
2274,ACGTCGAATCTAGGGA,60,63,3,9,880,0,0
2275,ACGTCGAATCTAGGGC,60,60,0,9,883,0,0
2276,ACGTCGAATCTAGGGA,60,63,3,11,884,0,0
2277,ACGTCGAATCTAGGGA,60,70,10,10,886,1,0
2278,ACGTCGAATCTAGGGA,60,70,10,14,887,1,0
2279,ACGTCGAATCTAGGGA,60,60,0,11,892,0,0
2280,ACGTCGAATCTAGGGA,60,62,2,12,898,0,0
2281,ACGTCGAATCTAGGGA,60,68,8,13,905,1,0
2282,ACGTCGAATCTAGGGA,60,61,1,9,906,0,0
2283,ACGTCGAATCTAGGGA,60,70,10,10,907,1,0
2284,ACGTAGAATCTAGGGA,60,70,10,11,908,1,0
2285,GCGTCGAATCTAGGGA,60,61,1,9,911,0,0
2286,ACGTCGAATCTAGGGA,60,70,10,9,920,1,0
2287,ACGTCGAATCTAGGGA,60,65,5,10,921,1,0
2288,ACGTCGAATCTAGGGA,60,70,10,11,924,1,0
2289,ACGTCGAATCTAGGGA,60,62,2,10,929,0,0
2290,ACGTCGAATCTAGGGA,60,60,0,10,930,0,0
2291,ACGTCGAATCTAGGGA,60,69,9,11,931,1,0
2292,ACGTCGAATCGAGGGA,60,61,1,13,935,0,0
2293,ACGTCGAATCTAGGGA,60,66,6,9,939,1,0
2294,ACGTCGAATCTAGGGA,60,60,0,9,942,0,0
2295,ACGTCGAATCTAGGGA,60,70,10,11,943,1,0
2296,ACGTCGAATCTAGGGA,60,68,8,10,944,1,0
2297,ACGTCGAATCTAGGGA,60,61,1,10,949,0,0
2298,ACGTCGAATCTAGGGA,60,64,4,13,955,1,0
2299,ACGTCGAATCTAGGGA,60,62,2,12,958,0,0
2300,ACGTCGAATCTAGGGA,60,61,1,10,959,0,0
2301,ACGTCGAATCTAGGGA,60,60,0,11,964,0,0
2302,AGGTCGAATCTAGGGA,60,63,3,11,965,0,0
2303,ACGTCGAATCTAGGGA,60,66,6,14,972,1,0
2304,ACGTCGACTCTAGGGA,60,61,1,11,973,0,0
2305,ACGTCGAAGCTAGGAA,60,66,6,13,976,1,0
2306,ACGTCGAATCTAGGGA,60,61,1,13,977,0,0
2307,ACGTCGAATCTAGGGA,60,70,10,17,979,1,0
2308,ACGTCGAATCTAGGGA,60,63,3,7,980,0,0
2309,ACGTCGAATCTAGGGA,60,61,1,9,981,0,0
2310,ACGTCGAATCTAGGGA,60,65,5,7,984,1,0
2311,ACGTAGAATCTAGGGA,60,70,10,11,989,1,0
2312,ACGTCGAATCTAGGGA,60,70,10,10,996,1,0
2313,ACGTCGAATCTCGGGA,60,70,10,11,997,1,0
2314,ACGTCGAATCTAGGGA,60,62,2,10,1002,0,0
2315,ACGTCGAATCTAGGGA,60,62,2,12,1005,0,0
2316,ACGTCGAATCTAGGGA,60,66,6,10,1006,1,0
2317,ACGTCGAATCTAGGGA,60,70,10,10,1007,1,0
2318,ACGTCGAATCTAGGGA,60,61,1,11,1009,0,0
2319,ACGTCGAATCTAGGGA,60,63,3,12,1012,0,0
2320,ACGTCGAATCTCGGGA,60,63,3,13,1013,0,0
2321,ACGTCGAATCTAGGGA,60,70,10,10,1014,1,0
2322,ACGTCGAATCTAGGGA,60,60,0,12,1018,0,0
2323,ACGTCGAATCTAGGGA,60,60,0,10,1019,0,0
2324,ACGTCGAATCTAGGGA,60,70,10,10,1020,1,0
2325,ACGTCGAATCTAGGGA,60,66,6,11,1022,1,0
2326,ACGTCGAATCTCGGGA,60,69,9,12,1023,1,0
2327,ACGTCGAATCTAGGGA,60,62,2,13,1027,0,0
2328,ACGTCGAATCTAGGGA,60,68,8,11,1028,1,0
2329,ACGTCGAATATAGGGA,60,60,0,13,1029,0,0
2330,ACGTCGAATCTAGGGA,60,63,3,12,1030,0,0
2331,ACGTCGAATCTAGGGA,60,63,3,11,1031,0,0
2332,ACGTCGAATCTAGGGA,60,70,10,11,1032,1,0
2333,ACGTCGAATCTAGGGA,60,64,4,11,1037,1,0
2334,AGGTCGAATCTAGTGA,60,70,10,11,1040,1,0
2335,ACGTCGAATCTGGGGA,60,70,10,12,1045,1,0
2336,ACGTCGAATCTAGGGA,60,63,3,17,1046,0,0
2337,ACGTCGAATCTAGGGA,60,65,5,11,1048,1,0
2338,ACGTCGAATCTAGGGA,60,65,5,9,1049,1,0
2339,ACGTCGAATCTAGGGA,60,70,10,11,1050,1,0
2340,ACGTCGAATCTAGGGA,60,63,3,14,1052,0,0
2341,ACGTCGATTCTAGGGA,60,64,4,12,1056,1,0
2342,ACGTCGAATCTAGGTA,60,70,10,10,1058,1,0
2343,ACGTCGAATCTAGGGA,60,70,10,13,1059,1,0
2344,ACGTCGAATCTAGGGA,60,70,10,10,1061,1,0
2345,ACGTCGAATCTAGGGA,60,70,10,13,1062,1,0
2346,ACGTCGAATCTAGGGA,60,63,3,11,1065,0,0
2347,ACGTCGAATCTAGGGA,60,70,10,11,1068,1,0
2348,ACGTCGAATCTAGGGA,60,61,1,12,1072,0,0
2349,ACGTCGAATCTAGGGA,60,64,4,13,1074,1,0
2350,ACGTCGAATCTAGGGA,60,66,6,11,1075,1,0
2351,ACGTCGAATCTAGGGA,60,63,3,16,1078,0,0
2352,ACGTCGAATCTAGGGA,60,70,10,12,1081,1,0
2353,ACGTCGAATCTAGGGA,60,63,3,12,1083,0,0
2354,ACGTCGAATCTAGGGA,60,61,1,13,1086,0,0
2355,ACGTCGAATCTAGGGA,60,70,10,11,1088,1,0
2356,ACGTCGAATCTAGGGA,60,66,6,12,1089,1,0
2357,ACGTCGAATCTAGGGA,60,63,3,12,1095,0,0
2358,ACGTCGAATCTAGGGA,60,70,10,12,1097,1,0
2359,ACGTCGAATCTAGGGA,60,60,0,11,1099,0,0
2360,ACGTCGAATCTAGGGA,60,70,10,14,1112,1,0
2361,ACGTCGAATCTAGGGA,60,61,1,12,1113,0,0
2362,ACGTCGAATCTAGGGA,60,64,4,12,1114,1,0
2363,ACGTCGAATCTAGGGA,60,62,2,13,1117,0,0
2364,ACGTCGAATCTAGGGA,60,67,7,15,1121,1,0
2365,ACGTCGAATCTAGGGA,60,60,0,14,1122,0,0
2366,ACGTCGAATCTAGGGA,60,67,7,6,1125,1,0
2367,ACGTCGAATCTAGGGA,60,64,4,7,1127,1,0
2368,ACGTCGAATCTAGGGA,60,62,2,7,1128,0,0
2369,ACGTCGAATCTAGGCA,60,70,10,9,1130,1,0
2370,ACGTCGAATCTAGGGA,60,63,3,8,1132,0,0
2371,ACGTCGAATCTAGGGA,60,70,10,9,1133,1,0
2372,ACGTCGAATCTAGGGA,60,70,10,8,1134,1,0
2373,ACGTCGAATCTAGGGA,60,64,4,7,1135,1,0
2374,ACGTCGAGTCTAGGGA,60,67,7,9,1136,1,0
2375,ACGTCGAATCTAGGGA,60,64,4,9,1142,1,0
2376,ACGTCGAATCTAGGGA,60,70,10,9,1144,1,0
2377,ACGTCGAATCTAGGGA,60,69,9,9,1145,1,0
2378,ACGTCGAATCTAGGGA,60,70,10,10,1151,1,0
2379,ACGTCGAATCTAGGGA,60,70,10,9,1154,1,0
2380,ACGTCGAATCTAGGGA,60,62,2,6,1155,0,0
2381,ACGTCGAATCTAGGGA,60,64,4,9,1156,1,0
2382,ACGTCGAATCTAGGGA,60,67,7,9,1158,1,0
2383,ACGTCGAATCTAGGGA,60,70,10,9,1160,1,0
2384,ACGTCGAATCTAGGGA,60,70,10,10,1161,1,0
2385,ACGTCGAATCTAGGGA,60,70,10,12,1162,1,0
2386,ACGTCGAATCTAGGGA,60,70,10,9,1163,1,0
2387,ACGTCGAATCTAGGGA,60,60,0,12,1164,0,0
2388,ACGTCGAATCTAGGGA,60,70,10,10,1165,1,0
2389,ACGTCGAATCTAGGGA,60,60,0,10,1167,0,0
2390,ACGTCGAATCTAGGGA,60,62,2,9,1169,0,0
2391,ACGTCGAATCTAGGGA,60,61,1,10,1170,0,0
2392,ACGTCGAATCTAGGGA,60,68,8,10,1171,1,0
2393,ACGTCGAATCTAGGGC,60,60,0,9,1172,0,0
2394,ACGTCGAATCTAGGGA,60,64,4,11,1173,1,0
2395,ACGTCGAATCTAGGGA,60,70,10,14,1174,1,0
2396,ACGTCGAATCTAGGGA,60,70,10,11,1178,1,0
2397,ACGTCGAATCTAGGGA,60,70,10,10,1179,1,0
2398,ACGTCGAAGCTAGGAA,60,61,1,12,1180,0,0
2399,GCGTCGAATCTAGGGA,60,68,8,9,1183,1,0
2400,ACGTCGAATCTAGGGC,60,62,2,8,1184,0,0
2401,ACGTCGAATCTAGGGA,60,68,8,10,1185,1,0
2402,ACGTCGAATCTAGGGA,60,66,6,10,1186,1,0
2403,ACGTCGAATCTAGGGA,60,70,10,13,1187,1,0
2404,ACGTAGAATCTAGGGA,60,69,9,11,1190,1,0
2405,ACGTCGAATCTAGGGA,60,67,7,11,1191,1,0
2406,ACGTCGAATCTAGGGA,60,66,6,9,1192,1,0
2407,ACGTCGAATCTAGGGA,60,63,3,8,1193,0,0
2408,ACGTCGAATCTAGGGA,60,70,10,11,1196,1,0
2409,ACGTCGAATCTAGGGA,60,61,1,10,1198,0,0
2410,ACGTCGAATCTAGGGA,60,64,4,9,1200,1,0
2411,ACGTCGAATCTAGGGA,60,64,4,10,1203,1,0
2412,ACGTCGAATCTAGGGA,60,60,0,11,1204,0,0
2413,ACGTCGAATCTAGGGA,60,66,6,10,1205,1,0
2414,ACGTCGAATCTAGGGA,60,64,4,10,1207,1,0
2415,ACGTCGAATCTAGGGA,60,60,0,11,1209,0,0
2416,ACGTCGAATCTAGGGA,60,70,10,13,1211,1,0
2417,ACGTCGAATCTAGGGA,60,61,1,16,1212,0,0
2418,ACGTCGAATCTAGGGA,60,61,1,10,1215,0,0
2419,ACGTCGAATCTATGGA,60,63,3,11,1217,0,0
2420,ACGTCGAATCTAGGGA,60,60,0,11,1219,0,0
2421,ACGTCGAATCTAGGCA,60,61,1,10,1221,0,0
2422,ACCTCGAATCTAGGGA,60,70,10,12,1222,1,0
2423,ACGTCGAATCTAGGGA,60,61,1,10,1223,0,0
2424,ACGTCGAATCTAGGGA,60,67,7,9,1225,1,0
2425,ACGTCGAATCTAGGGA,60,66,6,13,1228,1,0
2426,ACGTCGAATCTAGGGC,60,70,10,12,1230,1,0
2427,ACGTCGAATCTAGGGA,60,66,6,11,1234,1,0
2428,ACGTCGAATCTAGGGA,60,70,10,12,1236,1,0
2429,ACGTCGAATCTAGGGA,60,70,10,12,1238,1,0
2430,ACGTCGAATCTAGGGA,60,70,10,12,1244,1,0
2431,ACGTCGAATCTAGGGA,60,70,10,7,1247,1,0
2432,ACGTCGAATCTAGGGA,60,69,9,10,1248,1,0
2433,ACGTCGAATCTAGGGA,60,69,9,12,1256,1,0
2434,ACGTCGAATCTAGGGA,60,70,10,10,1260,1,0
2435,ACGTCGAATCTAGGGA,60,67,7,12,1261,1,0
2436,ACGTCGAATCTAGGGA,60,65,5,10,1265,1,0
2437,ACGTCGAATCTAGGGA,60,70,10,12,1266,1,0
2438,ACGTCGAATCTAGGGA,60,70,10,12,1271,1,0
2439,ACGTCGAATATAGGGA,60,60,0,13,1276,0,0
2440,ACGTCGAATCTAGGGA,60,61,1,11,1277,0,0
2441,ACGTCGAATCTAGGGA,60,63,3,11,1279,0,0
2442,ACGTCGAATCTAGGGA,60,68,8,11,1280,1,0
2443,ACGTCGAATCTAGGGA,60,65,5,11,1282,1,0
2444,ACGTCGGATCTAGGGA,60,60,0,11,1284,0,0
2445,ACGTCGAATCTAGGGA,60,64,4,9,1288,1,0
2446,ACGTCGAATCTAGGGA,60,70,10,14,1290,1,0
2447,ACGTCGAATCTAGGGA,60,70,10,13,1296,1,0
2448,ACGTCGAATCTAGGGA,60,62,2,12,1298,0,0
2449,ACGTCGAATCTAGGGA,60,70,10,11,1300,1,0
2450,ACGTCGAATCTAGGGA,60,70,10,10,1302,1,0
2451,ACGTCGAATCTAGGGA,60,62,2,12,1303,0,0
2452,ACGTCGAATCTAGGGA,60,61,1,12,1304,0,0
2453,ACGTCGAATCTAGGGA,60,61,1,11,1308,0,0
2454,ACGTCGAATCTAGGGA,60,68,8,16,1310,1,0
2455,ACGTCGAATCTAGGGA,60,66,6,12,1313,1,0
2456,ACGTCGAATCTAGGGA,60,61,1,12,1314,0,0
2457,ACGTCGAATCTAGGGA,60,70,10,11,1316,1,0
2458,ACGTTGAATCTAGGGA,60,70,10,9,1319,1,0
2459,ACGTCGAATCTAGGGA,60,64,4,10,1320,1,0
2460,ACGTCGAATCTAGGGA,60,70,10,12,1321,1,0
2461,ACGTCGAATCTAGGGA,60,67,7,12,1322,1,0
2462,ACGTCGAATCTAGGGA,60,61,1,12,1324,0,0
2463,ACGTCGAATCTAGGGA,60,67,7,12,1329,1,0
2464,ACGTCGAATCTAGGGA,60,66,6,11,1330,1,0
2465,ACGTCGAATCTAGGGA,60,63,3,14,1331,0,0
2466,ACGTCGAATCTAGGGA,60,70,10,12,1332,1,0
2467,ACGTCGAATCTAGGGA,60,64,4,12,1336,1,0
2468,ACGTCGAATCTAGGGA,60,70,10,12,1337,1,0
2469,ACGTCGAATCTAGGGA,60,64,4,13,1339,1,0
2470,ACCTCGAATCTAGGGA,60,60,0,14,1341,0,0
2471,ACGTCGAATCTAGGGA,60,62,2,7,1343,0,0
2472,ACGTCGAATCTAGGGA,60,69,9,7,1345,1,0
2473,ACGTCGAATCTAGGGA,60,70,10,10,1350,1,0
2474,ACGTCGAATCTAGGGA,60,70,10,11,1351,1,0
2475,ACGTCGAATCTAGGGA,60,66,6,9,1352,1,0
2476,ACGTCGAATCTAGGGA,60,67,7,11,1353,1,0
2477,ACGTCGAATCTAGGGA,60,70,10,15,1354,1,0
2478,ACGTCGAATCTAGGGA,60,70,10,10,1357,1,0
2479,ACGTCGAATCTAGGGA,60,67,7,10,1360,1,0
2480,ACGTCGAATCTAGGGA,60,62,2,12,1361,0,0
2481,ACGTCGAATCTAGGGA,60,68,8,10,1363,1,0
2482,ACGTCGAATCTAGGGA,60,61,1,11,1364,0,0
2483,ACGTCGAATCTAGGGA,60,63,3,11,1365,0,0
2484,ACGTCGAATCTAGGGA,60,62,2,11,1367,0,0
2485,ACGTCGAATCTAGGGA,60,60,0,10,1371,0,0
2486,ACGTCGAATCTAGGGA,60,70,10,10,1372,1,0
2487,ACGTCGAATCTAGGGA,60,70,10,10,1373,1,0
2488,ACGTCGAATCTAGGGA,60,60,0,11,1374,0,0
2489,ACGTCGAATCTAGGGA,60,67,7,13,1376,1,0
2490,ACGTCGAATCTCGGGA,60,70,10,13,1378,1,0
2491,ACGTCGAATCTAGGGA,60,70,10,11,1379,1,0
2492,ACGTCGAATCTAGGGA,60,70,10,9,1380,1,0
2493,ACGTCGAATCTAGGGA,60,67,7,11,1381,1,0
2494,ACGTCGAATCTAGGGA,60,61,1,16,1382,0,0
2495,ACGTCGAATCTAGGGC,60,70,10,10,1384,1,0
2496,ACGTCGAATCTAGGGA,60,70,10,15,1387,1,0
2497,ACGTCGAATCCAGGGA,60,62,2,12,1388,0,0
2498,ACGTCGAATCTAGGGA,60,70,10,13,1391,1,0
2499,ACGTCGAATCTAGGGA,60,68,8,11,1395,1,0
2500,ACGTCGTATCTAGGGA,60,70,10,14,1396,1,0
2501,ACGTCGAATCTAGGGA,60,63,3,10,1397,0,0
2502,ACGTCGAATCTAGGGA,60,63,3,12,1400,0,0
2503,ACGTCGAATCTAGGGA,60,70,10,10,1403,1,0
2504,ACGTCGAATCTAGGGA,60,70,10,11,1411,1,0
2505,ACGTCGAATCTAGGGA,60,61,1,11,1412,0,0
2506,ACGTCGAATCTAGGGA,60,70,10,14,1414,1,0
2507,ACGTCGAATCTAGGGA,60,62,2,10,1416,0,0
2508,ACGTCGAATCTAGGGA,60,68,8,9,1417,1,0
2509,ACGTCGAATCTAGGGA,60,68,8,11,1418,1,0
2510,ACGTCGAATCTAGGGA,60,68,8,10,1419,1,0
2511,ACGTCGAATCTAGGGA,60,60,0,12,1422,0,0
2512,ACGTCGAATCTAGGGA,60,64,4,13,1423,1,0
2513,ACGTCGAATCTAGGGA,60,70,10,11,1424,1,0
2514,ACGTCGAATCTAGGGA,60,70,10,10,1427,1,0
2515,ACGTCGAATCTAGGGA,60,60,0,12,1428,0,0
2516,ACGTCGAATCTAGGGA,60,69,9,13,1430,1,0
2517,ACGTCGAATCTAGGGA,60,66,6,12,1434,1,0
2518,ACGTCGAATCTAGGGA,60,67,7,14,1436,1,0
2519,ACGTCGAAGCTAGTAA,60,65,5,14,1440,1,0
2520,ACGTCGAATCTAGGGA,60,69,9,18,1442,1,0
2521,AAGTCGAATCTAGGGA,60,70,10,11,1445,1,0
2522,ACGTCGAATCTAGGGA,60,65,5,12,1446,1,0
2523,ACGTCGAATCTAGGGA,60,62,2,11,1448,0,0
2524,ACGTCGAATCTAGGGA,60,60,0,14,1449,0,0
2525,ACGTAGAATCTAGGGA,60,70,10,12,1450,1,0
2526,ACGTCGAATCTAGGGA,60,60,0,12,1451,0,0
2527,ACGTCGAATCTAGGGA,60,69,9,11,1453,1,0
2528,ACGTCGAATCTCGGGA,60,67,7,12,1454,1,0
2529,ACGTCGAATATAGGGA,60,68,8,11,1457,1,0
2530,ACGTCGAATCTAGGGA,60,62,2,11,1461,0,0
2531,ACGTCGAATCTAGGGA,60,70,10,11,1462,1,0
2532,ACGTCGAATCTAGGGA,60,64,4,14,1465,1,0
2533,ACGTCGAATCTAGGGA,60,70,10,11,1466,1,0
2534,ACGTCGAATCTAGGGA,60,61,1,8,1467,0,0
2535,ACGTCGAATCTAGGGA,60,60,0,11,1470,0,0
2536,ACGTCGAATCTAGGGA,60,67,7,12,1471,1,0
2537,ACGTCGAATCTAGGGA,60,62,2,14,1474,0,0
2538,ACGTCGAATCTAGGGA,60,68,8,12,1476,1,0
2539,ACGTCGAATATAGGGA,60,64,4,14,1477,1,0
2540,ACGTCGAATCTAGGGA,60,70,10,13,1478,1,0
2541,ACGTCGAATCTAGGGA,60,63,3,12,1479,0,0
2542,ACGTCGAATCTAGGGA,60,65,5,13,1481,1,0
2543,ACGTCGAATCTAGGGA,60,70,10,12,1482,1,0
2544,ACGTCGAATCTAGGGA,60,60,0,13,1483,0,0
2545,ACGTCGAATCTAGGGA,60,68,8,12,1485,1,0
2546,ACGTCGAATCTAGGGA,60,70,10,13,1486,1,0
2547,ACGTCGAATCTAGGGA,60,63,3,12,1490,0,0
2548,ACGTCGAATCTAGGGA,60,62,2,15,1492,0,0
2549,ACGTCGATTCTAGGGA,60,65,5,13,1493,1,0
2550,ACGTCGAATCTAGGGA,60,70,10,14,1496,1,0
2551,ACGTCGAATCTAGGGA,60,62,2,14,1499,0,0
2552,ACGTCGAATCTAGGGA,60,70,10,13,1504,1,0
2553,ACGTCGAATCTAGGGA,60,62,2,12,1506,0,0
2554,ACGTCGAATCTAGGGA,60,69,9,17,1508,1,0
2555,ACGTCGAATCTAGGGA,60,69,9,12,1509,1,0
2556,ACGTCGAATCTAGGGA,60,61,1,12,1510,0,0
2557,ACGTCGAATCTAGGGA,60,70,10,12,1513,1,0
2558,ACGTCGAATCTAGGGA,60,70,10,13,1519,1,0
2559,ACGTCGAATCTAGGGA,60,60,0,13,1521,0,0
2560,ACGTCGAATCTAGGGA,60,69,9,12,1523,1,0
2561,ACGTCGACTCTAGGGA,60,63,3,11,1525,0,0
2562,ACGTCGAATCTAGGGA,60,66,6,14,1526,1,0
2563,ACGTCGAATCTTGGGA,60,63,3,15,1530,0,0
2564,ACGTCGAATCTAGGGA,60,63,3,13,1531,0,0
2565,ACGTCGAATCTAGGGA,60,67,7,13,1533,1,0
2566,ACGTCGAATCTAGGGA,60,60,0,15,1536,0,0
2567,ACGTCGAATCTAGGGA,60,70,10,16,1537,1,0
2568,ACGTCGAATCTAGGGA,60,70,10,15,1539,1,0
2569,ACGTCGAATCTAGGGA,60,70,10,6,1541,1,0
2570,ACGTCGAATCTAGGGA,60,70,10,8,1542,1,0
2571,ACGTCGAATCTAGGGA,60,69,9,7,1544,1,0
2572,ACGTCGAATCTAGGGA,60,70,10,12,1547,1,0
2573,ACGTCGAATCTAGGGA,60,66,6,7,1550,1,0
2574,ACGTCGAATCTAGGGA,60,61,1,9,1551,0,0
2575,ACGTCGAATCTAGGGA,60,70,10,10,1552,1,0
2576,ACGTCGAATCTAGGGA,60,63,3,14,1553,0,0
2577,ACGTCGAATCTAGGGA,60,60,0,9,1555,0,0
2578,ACGTCGAATCTAGGGA,60,60,0,9,1556,0,0
2579,ACGTCGAAACTAGGGA,60,60,0,11,1557,0,0
2580,ACGTCGAATCTAGGGA,60,70,10,10,1560,1,0
2581,ACGTCGAATCTAGGGA,60,63,3,10,1561,0,0
2582,ACGTCGAATCTAGGGA,60,61,1,9,1562,0,0
2583,ACGTCGAATCTAGGGA,60,65,5,9,1563,1,0
2584,ACGTCGAATCTAGGGA,60,62,2,6,1564,0,0
2585,ACGTCGAATCTAGGGA,60,60,0,11,1566,0,0
2586,ACGTCGAATCTAGGGA,60,70,10,9,1567,1,0
2587,ACGTCGAATCTAGGGA,60,70,10,9,1568,1,0
2588,ACGTCGAATCTAGGGA,60,68,8,12,1569,1,0
2589,ACGTCGAATCTAGGGA,60,70,10,9,1570,1,0
2590,ACGTCGAATCTAGGGA,60,60,0,12,1571,0,0
2591,ACGTCGAATCTAGGGA,60,70,10,10,1572,1,0
2592,ACGTCGAATCTAGAGA,60,67,7,15,1574,1,0
2593,ACGTCGAATCTAGGGA,60,64,4,9,1575,1,0
2594,ACGTCGAATCTAGGGA,60,70,10,10,1576,1,0
2595,ACGTCGAATCTAGGGA,60,67,7,14,1577,1,0
2596,ACGTCGAATCTAGGGA,60,67,7,11,1578,1,0
2597,ACGTCGAATCTAGGGA,60,61,1,11,1579,0,0
2598,ACGTCGAAGCTAGGAA,60,66,6,12,1581,1,0
2599,GCGTCGAATCTAGGGA,60,66,6,9,1583,1,0
2600,ACGTCGAATCTAGGGA,60,60,0,10,1584,0,0
2601,ACGTCGAATCTAGGGA,60,70,10,9,1586,1,0
2602,ACGTCGAATCTAGGGA,60,70,10,9,1589,1,0
2603,ACGTCGAATCTAGGGA,60,70,10,9,1591,1,0
2604,ACGTCGAATCTAGGGA,60,70,10,10,1592,1,0
2605,ACGTCGAATCTAGGGA,60,70,10,10,1593,1,0
2606,ACGTCGAATCTAGGGA,60,70,10,10,1594,1,0
2607,ACGTCGAATCTAGGGA,60,70,10,9,1595,1,0
2608,ACGTCGAATCTAGGGA,60,61,1,10,1596,0,0
2609,ACGTCGAATCTAGGGA,60,62,2,9,1597,0,0
2610,ACGTCGATTCTAGGGA,60,69,9,11,1599,1,0
2611,ACGTCGAATCTAGGGA,60,68,8,10,1600,1,0
2612,ACGTCGAATCTAGGGA,60,65,5,12,1601,1,0
2613,ATGTCGAATCTAGGGA,60,70,10,11,1604,1,0
2614,ACGTCGAATCTAGGGA,60,61,1,13,1605,0,0
2615,ACGTCGAATCTAGGGA,60,64,4,16,1606,1,0
2616,ACGTCGAATCTAGGGA,60,62,2,9,1609,0,0
2617,ACGTCGAATCTAGGGA,60,67,7,11,1610,1,0
2618,ACGTCGAATCTAGGGA,60,60,0,10,1611,0,0
2619,ACGTCGAATCTAGGGA,60,60,0,12,1614,0,0
2620,ACGTCGAATCTAGGGA,60,62,2,11,1618,0,0
2621,ACGTCGAATCGAGGGA,60,65,5,12,1619,1,0
2622,ACGTCGAATCTAGGGA,60,64,4,13,1620,1,0
2623,ACGTCGAATCTAGGGA,60,65,5,11,1621,1,0
2624,ACGTCGAATCTAGGGC,60,60,0,12,1622,0,0
2625,ACGTCGAATCTAGGGA,60,64,4,11,1623,1,0
2626,ACGTCGAATCTAGGGA,60,70,10,11,1625,1,0
2627,ACGTCGAATCTAGGGA,60,63,3,13,1627,0,0
2628,ACGTCGAATCTAGGGA,60,70,10,12,1628,1,0
2629,ACGTCGAGTCTAGGGA,60,64,4,11,1629,1,0
2630,ACGTCGAATCTAGGGA,60,68,8,13,1631,1,0
2631,ACGTCGAATCTAGGGA,60,60,0,11,1633,0,0
2632,ACGTCGAATCTAGGGA,60,62,2,10,1638,0,0
2633,ACGTCGAATCTAGGGA,60,68,8,11,1639,1,0
2634,ACGTCGAATCTAGGGA,60,70,10,12,1640,1,0
2635,ACGTCGAATCTAGGGA,60,63,3,10,1641,0,0
2636,ACGTCGAATCTAGGGA,60,61,1,7,1642,0,0
2637,ACGTCGAATCTCGGGA,60,70,10,10,1643,1,0
2638,ACGTCGAATCTTGGGA,60,63,3,10,1646,0,0
2639,ACGTCGAATCTAGGGA,60,70,10,12,1650,1,0
2640,ACGTCGAATCTAGGGA,60,70,10,13,1651,1,0
2641,ACGTCGAATCTAGGGA,60,67,7,10,1652,1,0
2642,ACGTCGAATCTAGGGA,60,65,5,12,1653,1,0
2643,ACGTCGAATCTAGGGA,60,64,4,11,1655,1,0
2644,ACGTCGAATCTAGGGA,60,66,6,11,1656,1,0
2645,ACGTCGAATCTAGGGA,60,61,1,11,1657,0,0
2646,ACGTCGAATCTAGGGA,60,67,7,11,1658,1,0
2647,ACGTCGAATCTAGGGA,60,65,5,12,1659,1,0
2648,ACGTCGAATCTAGGGA,60,60,0,12,1661,0,0
2649,ACGTCGAATCTAGGGA,60,64,4,12,1664,1,0
2650,ACGTCGAATCTAGGGA,60,70,10,11,1665,1,0
2651,ACGTCGGATCTAGGGA,60,65,5,9,1666,1,0
2652,ACGTCGAATCTAGGGA,60,63,3,12,1667,0,0
2653,ACGTCGAATCTAGGGA,60,70,10,13,1668,1,0
2654,ACGTCGAATCTAGTGA,60,66,6,11,1669,1,0
2655,ACGTCGAATCTAGGGA,60,70,10,13,1670,1,0
2656,ACGTCGAATCTAGGGA,60,60,0,13,1671,0,0
2657,ACGTCGAATCTAGGGA,60,60,0,12,1672,0,0
2658,ACGTCGAATCTAGGGA,60,61,1,11,1674,0,0
2659,ACGTCGAATCTAGGGA,60,70,10,10,1676,1,0
2660,ACGTCGAATCTAGGGA,60,70,10,12,1677,1,0
2661,ACGTCGAATCTAGGGA,60,62,2,12,1678,0,0
2662,ACGTCGAATCTAGGGA,60,70,10,11,1679,1,0
2663,ACGTCGAATCTAGGGA,60,65,5,13,1681,1,0
2664,ACGTCGAATCTAGGGA,60,69,9,11,1682,1,0
2665,ACGTCGAATCTAGGGA,60,62,2,12,1684,0,0
2666,ACGTCGAATCTAGGGA,60,70,10,12,1686,1,0
2667,ACGTCGAATCTAGGGA,60,60,0,13,1687,0,0
2668,ACGTCGAATCTAGGGA,60,70,10,10,1688,1,0
2669,ACGTCGAATCTAGGGA,60,62,2,9,1689,0,0
2670,ACGTCGAATCTAGGGA,60,70,10,12,1690,1,0
2671,ACGTCGAATCTAGGGA,60,65,5,13,1691,1,0
2672,ACGTCGAATCTAGGGA,60,60,0,12,1692,0,0
2673,ACGTCGAATCTAGGGA,60,62,2,11,1694,0,0
2674,ACGTCGAATCTAGGGA,60,70,10,12,1695,1,0
2675,ACGTCGAATCTAGGGA,60,62,2,12,1696,0,0
2676,ACGTCGAATCTAGGGA,60,61,1,11,1697,0,0
2677,ACGTCGAATCTAGGGA,60,61,1,12,1700,0,0
2678,ACGTCGAATCTAGGGA,60,64,4,12,1702,1,0
2679,CCGTCGAATCTAGGGA,60,62,2,7,1704,0,0
2680,ACGCCGAATCTAGGGA,60,67,7,13,1705,1,0
2681,ACGTCGAATCTAGGGA,60,60,0,9,1706,0,0
2682,ACGTCGAATCTAGGGA,60,70,10,10,1707,1,0
2683,ACGTCGAATCCAGGGA,60,60,0,11,1708,0,0
2684,ACGTCGAATCTAGGGA,60,61,1,9,1709,0,0
2685,ACGTCGAACCTAGGGA,60,66,6,11,1710,1,0
2686,ACGTCGAATCTAGGGA,60,66,6,9,1712,1,0
2687,ACGTCGAATCTAGGGA,60,64,4,9,1713,1,0
2688,ACGTCGAATCTAGGGT,60,63,3,10,1714,0,0
2689,ACGTCGAATCTAGGGA,60,60,0,12,1717,0,0
2690,ACGTCGAATCTAGGGA,60,68,8,11,1720,1,0
2691,ACGTCGAATCTAGGGA,60,65,5,11,1721,1,0
2692,ACGTCGAATCTAGGGA,60,68,8,10,1722,1,0
2693,ACGTCGAATCTAGGGA,60,61,1,10,1724,0,0
2694,ACGTCGAATCTAGGGA,60,70,10,10,1725,1,0
2695,ACGTCGAATCTAGGGA,60,62,2,13,1729,0,0
2696,ACGTCGAATCTAGGGA,60,70,10,13,1731,1,0
2697,ACGTCGAATCTAGGGA,60,61,1,9,1732,0,0
2698,ACGTCGAATCTAGGGA,60,66,6,10,1734,1,0
2699,AAGTCGAATCTAGGGA,60,69,9,12,1739,1,0
2700,ACGTCGAATCTAGGGA,60,65,5,12,1740,1,0
2701,ACGTCGAATCTAGGGA,60,65,5,13,1741,1,0
2702,ACGTCGAATCTAGGGA,60,70,10,11,1743,1,0
2703,ACGTCGAATCTAGGGA,60,64,4,14,1744,1,0
2704,ACGTCGAATCTAGGGA,60,69,9,10,1745,1,0
2705,ACGTCGAATCTAGGGA,60,64,4,11,1746,1,0
2706,ACGTAGAATCTAGGGA,60,70,10,12,1747,1,0
2707,ACGTCGAATCTAGGGA,60,62,2,9,1749,0,0
2708,ACGTCGAATCTAGGGC,60,62,2,10,1752,0,0
2709,ACGTCGAATCTAGGGA,60,68,8,12,1753,1,0
2710,ACGTCGAATCTAGGGA,60,70,10,11,1754,1,0
2711,ACGTCGAATCTAGGGA,60,64,4,11,1756,1,0
2712,ACGTCGAATCTAGGGA,60,70,10,12,1757,1,0
2713,ACGTGGAATCTAGGGA,60,65,5,10,1759,1,0
2714,ACGTCGCATCTAGGGA,60,70,10,11,1760,1,0
2715,ACGTCGAATCTAGGGA,60,62,2,10,1761,0,0
2716,ACGTCGAATCTAGGGA,60,66,6,12,1762,1,0
2717,ACGTCGAATCTAGGGA,60,65,5,11,1764,1,0
2718,ACGTCGAATCTAGGGA,60,60,0,14,1765,0,0
2719,ACGTCGAATCTAGGGA,60,62,2,13,1766,0,0
2720,ACGTCGAATCTAGGGA,60,65,5,11,1767,1,0
2721,ACGTCGAATCTAGGGA,60,60,0,12,1769,0,0
2722,ACGTCGAATCTAGGGA,60,62,2,12,1770,0,0
2723,ACGTCGAATCTAGGGA,60,70,10,13,1771,1,0
2724,ACGTCGAAGCTAGGAA,60,60,0,14,1774,0,0
2725,ACGTCGAATCTAGGGA,60,68,8,14,1775,1,0
2726,CCGTCGAATCTAGGGA,60,65,5,18,1776,1,0
2727,ACGTCGAATCTAGGGA,60,65,5,12,1779,1,0
2728,ACGTCGAATCTAGGGA,60,70,10,8,1780,1,0
2729,ACGTCGAATCTAGGTA,60,60,0,11,1781,0,0
2730,ACGTAGAATCTAGGGA,60,67,7,12,1782,1,0
2731,ACGTCGAATCTAGGGA,60,67,7,12,1783,1,0
2732,ACGTCGAATCTCGGGA,60,60,0,12,1786,0,0
2733,ACGTCGAATCTAGGGA,60,70,10,13,1787,1,0
2734,ACGTCGAATCTAGGGA,60,68,8,11,1788,1,0
2735,ACGTCGAATCTAGGGA,60,64,4,11,1790,1,0
2736,ACGTCGAATCTAGGGA,60,70,10,13,1793,1,0
2737,ACGTCGAATCTAGGGA,60,70,10,14,1794,1,0
2738,ACGTCGAATCTAGGGA,60,69,9,8,1796,1,0
2739,ACGTCGAATCTAGGGA,60,66,6,11,1799,1,0
2740,ACGTCGAATCTAGGGA,60,62,2,12,1800,0,0
2741,ACGTCGAATCTAGGGA,60,68,8,13,1801,1,0
2742,ACGTCGAATCTAGGGA,60,67,7,14,1803,1,0
2743,ACGTCGAATCTAGGGA,60,70,10,12,1807,1,0
2744,ACGTCGAATCTAGGGA,60,64,4,12,1808,1,0
2745,ACGTCGAATCTAGGGA,60,63,3,13,1811,0,0
2746,ACGTCGAATCTAGGGA,60,61,1,18,1812,0,0
2747,ACGTCGAATCTAGAGA,60,70,10,12,1813,1,0
2748,ACGTCGAATCTAGGGA,60,65,5,10,1814,1,0
2749,ACGTCGAATCTAGGGA,60,66,6,12,1815,1,0
2750,ACGTCGAAGCTAGGGA,60,60,0,15,1816,0,0
2751,ACGTCGATTCTAGGGA,60,70,10,13,1817,1,0
2752,ACGTCGAATCTAGGGA,60,64,4,11,1818,1,0
2753,ACGTCGAATCTAGGGA,60,70,10,14,1819,1,0
2754,ACGTCGAATCTAGTGA,60,62,2,12,1820,0,0
2755,ACGTCGAATCTAGGGA,60,62,2,11,1821,0,0
2756,ACGTCGAATCTAGGGA,60,65,5,14,1822,1,0
2757,ACGTCGAATCTAGGGA,60,70,10,13,1824,1,0
2758,ACATCGAATCTAGGGA,60,63,3,12,1825,0,0
2759,ACGTCGAATCTAGGGA,60,70,10,13,1826,1,0
2760,ACGTCGAATCTAGGGA,60,68,8,14,1827,1,0
2761,ACGTCGAATCTAGGGA,60,62,2,17,1829,0,0
2762,ACGTCGAATCTAGGGA,60,70,10,13,1830,1,0
2763,ACGTCGAATCTAGGGA,60,60,0,14,1833,0,0
2764,ACGTCGAATCTAGGGA,60,70,10,12,1834,1,0
2765,ACGTCGAATCTAGGGA,60,60,0,13,1835,0,0
2766,ACGTCGAATCTAGGGA,60,67,7,12,1836,1,0
2767,ACGTCGAATCTAGGGA,60,70,10,14,1838,1,0
2768,ACGTCGAATCTAGGGA,60,61,1,13,1839,0,0
2769,ACGTCGAATCTAGGGA,60,70,10,12,1840,1,0
2770,ACGTCGAATCTAGGGA,60,63,3,15,1842,0,0
2771,ACGTCGAATCTAGGGA,60,70,10,13,1843,1,0
2772,ACGTCGAATCTAGGGA,60,63,3,15,1844,0,0
2773,ACGTCGAATCTAGGGA,60,60,0,13,1845,0,0
2774,ACGTCCAATCTAGGGA,60,61,1,13,1846,0,0
2775,ACGTCGAATCTAGGGA,60,64,4,15,1848,1,0
2776,ACGTCGAATCTAGGGA,60,67,7,15,1850,1,0
2777,ACGTCGAATCTAGGGA,60,64,4,15,1851,1,0
2778,ACGTCGAATCTAGGGA,60,70,10,7,1853,1,0
2779,ACGTCGAATCTAGGGA,60,66,6,9,1854,1,0
2780,ACGTCGAATCTAGGGA,60,70,10,8,1855,1,0
2781,ACGTCGAATCTAGGGA,60,70,10,8,1856,1,0
2782,ACGTCGAATCTAGGGA,60,70,10,10,1860,1,0
2783,ACGTCGAATCTAGGGA,60,70,10,9,1861,1,0
2784,ACGTCGAATCTAGGGA,60,70,10,8,1862,1,0
2785,ACGTCGAGTCTAGGGA,60,69,9,10,1863,1,0
2786,ACGTCGAATCTAGGGA,60,70,10,11,1864,1,0
2787,ACGTCGAATCTAGGGA,60,70,10,9,1865,1,0
2788,ACGTCGAATCTAGGGA,60,67,7,9,1866,1,0
2789,ACGTCGAATCTAGGGA,60,70,10,10,1868,1,0
2790,ACGTCGAATCTAGGGA,60,62,2,12,1871,0,0
2791,ACGTCGAATCTAGGGA,60,60,0,10,1872,0,0
2792,ACGTCGAATCTAGGGA,60,70,10,11,1874,1,0
2793,ACGTCGAATCTAGGGA,60,60,0,11,1875,0,0
2794,ACGTCGAATCTAGGGA,60,61,1,10,1876,0,0
2795,ACGTCGAATCTAGGGA,60,68,8,7,1877,1,0
2796,ACGTCGAATCTAGGGA,60,62,2,10,1878,0,0
2797,ACGTCGAATCTAGGGA,60,60,0,10,1879,0,0
2798,ACGTCGAATCTAGGGA,60,65,5,10,1880,1,0
2799,ACGTCGAATCTAGGGA,60,65,5,11,1881,1,0
2800,ACGTCGAATCTAGGGA,60,70,10,13,1882,1,0
2801,ACGTCGAATCTAGGGA,60,68,8,10,1883,1,0
2802,ACGTCGAATCTAGGGA,60,64,4,11,1885,1,0
2803,ACGTCGAATCTAGGGA,60,70,10,11,1886,1,0
2804,ACGTCGAATCTAGGGA,60,65,5,10,1887,1,0
2805,ACGTCGAATCTAGGGC,60,60,0,10,1890,0,0
2806,ACGTCGAATCTAGGGA,60,60,0,15,1892,0,0
2807,AAGTCGAATCTAGGGA,60,70,10,12,1893,1,0
2808,ACGTCGAATCTAGGGA,60,60,0,12,1894,0,0
2809,ACGTCGAAGCTAGGAA,60,69,9,13,1896,1,0
2810,ACGTCGAATCTAGGGA,60,61,1,9,1899,0,0
2811,ACGTCGAATCTAGGGA,60,70,10,14,1902,1,0
2812,ACGTCGAATCTAGGGA,60,61,1,10,1905,0,0
2813,ACGACGAATCTAGGGA,60,66,6,9,1906,1,0
2814,ACGTCGAATCTAGGGA,60,70,10,12,1907,1,0
2815,ACGTCGAATCTAGGGA,60,70,10,10,1909,1,0
2816,ACGTCGAATCTAGGGA,60,60,0,11,1910,0,0
2817,ACGTCGAATCTAGGGA,60,70,10,12,1912,1,0
2818,ACGTCGAATCTAGGGA,60,70,10,12,1916,1,0
2819,ACGTCGAATCTAGGGA,60,62,2,12,1917,0,0
2820,ACGTCGAATCTAGGGA,60,62,2,17,1919,0,0
2821,ACGTCGAATCTAGGGA,60,67,7,12,1922,1,0
2822,ACGTCGAATCTAGGGA,60,62,2,13,1925,0,0
2823,ACGTCGAATCTAGGGA,60,68,8,11,1926,1,0
2824,ACGTCGAATCTAGGGA,60,63,3,10,1927,0,0
2825,ACGTCGAATCTAGGGA,60,60,0,14,1928,0,0
2826,ACGTCGAATCTAGGGA,60,62,2,12,1931,0,0
2827,ACGTCGAATCTAGGGA,60,63,3,12,1932,0,0
2828,ACGTCGAATCTAGGGA,60,60,0,13,1935,0,0
2829,ACGTCGAATCTAGGGA,60,70,10,15,1936,1,0
2830,ACGTCGAATCTAGGGA,60,65,5,13,1937,1,0
2831,AAGTCGAATCTAGGGA,60,70,10,11,1938,1,0
2832,ACGTCGAATCTAGGGA,60,60,0,8,1940,0,0
2833,ACGTCGAATCTAGGGA,60,62,2,11,1941,0,0
2834,ACGTCGAATCTTGGGA,60,64,4,15,1942,1,0
2835,ACGTCGAATCTAGGGA,60,70,10,12,1943,1,0
2836,ACGTCGAATCTAGGGA,60,65,5,13,1946,1,0
2837,ACGTCGAGTCTAGGGA,60,70,10,12,1947,1,0
2838,ACGTCGAATCTAGGGA,60,61,1,11,1948,0,0
2839,ACGTCGAATCTAGGGA,60,67,7,13,1949,1,0
2840,ACGTCGAATCTAGGGA,60,70,10,13,1954,1,0
2841,ACGTCGAATCTAGGGA,60,60,0,12,1958,0,0
2842,ACGTCGAATCTAGGGA,60,61,1,12,1960,0,0
2843,ACGTCGAATCAAGGGA,60,70,10,12,1961,1,0
2844,ACGTCGAATCTAGGGA,60,70,10,14,1962,1,0
2845,ACGTCGAATCTAGGGA,60,70,10,15,1964,1,0
2846,ACGTCGAATCTAGGGA,60,61,1,14,1966,0,0
2847,ACGTCGAATCTAGGGA,60,65,5,13,1967,1,0
2848,ACGTCGAATCTAGGGA,60,70,10,12,1968,1,0
2849,ACGTCGAATCTAGGGA,60,68,8,12,1969,1,0
2850,ACGTCGAATCTAGGGA,60,67,7,11,1970,1,0
2851,ACGTCGAATCTAGGGA,60,70,10,13,1972,0,0
2852,ACGTCGAATCTAGGGA,60,67,7,12,1973,0,0
2853,ACGTCGAATCTAGGGA,60,87,27,14,1974,4,0
2854,ACGTCGAATCTAGGGA,60,63,3,12,1975,0,0
2855,ACGTCGAATCTAGGGA,60,82,22,14,1976,2,0
2856,ACGTCGAATCTAGGGA,60,75,15,17,1977,0,0
2857,ACGTCGAATCTAGGGA,60,63,3,13,1978,0,0
2858,ACGTCGAATCTAGGGA,60,75,15,13,1979,0,0
2859,ACGTCGAATCTAGGGA,60,93,33,13,1980,6,0
2860,ACGTCGAATCTAGGGA,60,61,1,12,1981,0,0
2861,ACGTCGAATCTAGGGA,60,77,17,10,1982,0,0
2862,ACGTCGAATCTAGGGA,60,63,3,11,1983,0,0
2863,ACGTCGAATCTAGGGA,60,91,31,13,1984,5,0
2864,ACGTCGAATCTAGGGA,60,95,35,13,1985,6,0
2865,ACGTCGAATCTAGGGA,60,63,3,14,1986,0,0
2866,ACGTCGAATCTAGGGA,60,61,1,13,1987,0,0
2867,ACGTCGAATCTAGGGA,60,69,9,13,1988,0,0
2868,ACGTCGAATCTAGGGA,60,82,22,12,1989,2,0
2869,ACGTCGAATCAAGGGA,60,64,4,13,1991,0,0
2870,ACGTCGAATCTAGGGA,60,71,11,13,1992,0,0
2871,ACGTCGAATCTAGGGA,60,73,13,13,1993,0,0
2872,ACGTCGAATCTAGGGA,60,69,9,14,1996,0,0
2873,ACGTCGAATCTAGGGA,60,67,7,14,1998,0,0
2874,ACGTCGAATCTAGGGA,60,62,2,8,2000,0,0
2875,ACGTCGAATCTAGGGA,60,61,1,11,2001,0,0
2876,ACGTCGAATCTAGGGA,60,60,0,16,2008,0,0
2877,ACGTCGAATCTAGGGC,60,67,7,10,2010,0,0
2878,ACGTCGAATCTAGGGA,60,65,5,11,2011,0,0
2879,ACGTCGAATCTAGGGA,60,77,17,13,2012,0,0
2880,ACGTCGAATCTAGGGA,60,60,0,11,2013,0,0
2881,ACGTCGAATCTAGGGA,60,64,4,12,2015,0,0
2882,ACGTCGAATCTAGGGA,60,68,8,12,2016,0,0
2883,ACGTCGAATCTAGGGA,60,62,2,12,2017,0,0
2884,ACGTCGAATCTAGGGA,60,72,12,8,2018,0,0
2885,ACGTCGAATCTAGGGA,60,69,9,11,2019,0,0
2886,ACGTCGAATCTAGGGA,60,70,10,11,2020,0,0
2887,ACGTCGAATCAAGGGA,60,60,0,11,2021,0,0
2888,ACGTCGAATCTAGGGA,60,71,11,14,2023,0,0
2889,ACGTCGAATCTAGGGA,60,64,4,12,2025,0,0
2890,ACGTCGAATCTAGGGA,60,83,23,17,2028,2,0
2891,ACGTCGAATCTAGGGC,60,61,1,11,2029,0,0
2892,ACGTCGAATCTAGGGA,60,81,21,16,2030,2,0
2893,ACGTCGAATCTAGGGA,60,65,5,13,2031,0,0
2894,ACGTCGAATCTAGGGA,60,62,2,14,2032,0,0
2895,ACGTCGAATCTAGGGA,60,106,46,14,2034,10,0
2896,ACGTCGTATCTAGGGA,60,67,7,15,2038,0,0
2897,ACGTCGAATCTAGGGA,60,66,6,11,2039,0,0
2898,ACGTAGAATCTAGGGA,60,72,12,13,2040,0,0
2899,ACGTCGAATCTAGGGA,60,64,4,13,2041,0,0
2900,ACGTCGAATCTAGGGA,60,64,4,10,2042,0,0
2901,ACGTGGAATCTAGGGT,60,63,3,14,2044,0,0
2902,ACGTCGAATCTAGGGA,60,62,2,12,2045,0,0
2903,ACGTCGAATCTAGGGA,60,64,4,13,2046,0,0
2904,ACGTCGAATCTAGGGA,60,61,1,12,2047,0,0
2905,ACGTCGAATCTAGGGA,60,63,3,11,2050,0,0
2906,ACGTCGAATCTAGGCA,60,62,2,10,2051,0,0
2907,ACGTCGAATCTAGGGA,60,74,14,12,2052,0,0
2908,ACGTCGAATCTAGGGA,60,78,18,11,2053,1,0
2909,ACGTCGAATCTAGGGA,60,62,2,12,2057,0,0
2910,ACGTCGAATCTAGGGA,60,95,35,11,2058,6,0
2911,ACGTCGAATCTAGGGA,60,60,0,13,2059,0,0
2912,ACGTCGAATCTAGGGA,60,67,7,14,2060,0,0
2913,ACGTCGAATCTAGGGA,60,72,12,13,2061,0,0
2914,ACGTCGAATCTAGGGA,60,73,13,15,2063,0,0
2915,ACGTCGAATCTAGGGA,60,64,4,16,2064,0,0
2916,ACGTCGAAGCTAGGAA,60,99,39,15,2066,8,0
2917,ACGTCGAATCTAGGGA,60,72,12,19,2067,0,0
2918,ACGTCGAATCTAGGGA,60,83,23,11,2068,2,0
2919,ACGTCGAATCTAGGGA,60,60,0,13,2074,0,0
2920,ACGTCGAATCTAGGGA,60,68,8,12,2075,0,0
2921,ACGTCGAATCTCGGGA,60,68,8,13,2076,0,0
2922,ACGTTGAATCTAGGGA,60,61,1,14,2077,0,0
2923,ACGTCGAATCTAGGGA,60,64,4,14,2079,0,0
2924,ACGTCGAATCTAGGGA,60,81,21,12,2080,2,0
2925,ACGTCGAATCTAGGGA,60,67,7,15,2082,0,0
2926,ACGTCGAATCTAGGGA,60,77,17,12,2083,0,0
2927,ACGTCGAATCTAGGGA,60,64,4,9,2084,0,0
2928,CCGTCGAATCTAGGGA,60,61,1,12,2085,0,0
2929,ACGTCGAATCTAGGGA,60,60,0,13,2086,0,0
2930,ACGTCGAATCTAGGGA,60,69,9,14,2087,0,0
2931,ACGTCGAATCTAGGGA,60,60,0,15,2088,0,0
2932,ACGTCGAATCTAGGGA,60,68,8,13,2090,0,0
2933,ACGTCGAATAGAGGGA,60,82,22,15,2091,2,0
2934,ACGTCGAATCTAGGGA,60,75,15,14,2092,0,0
2935,ACGTCGAATCTAGGGA,60,68,8,13,2093,0,0
2936,ACGTCGAATCTAGGGA,60,67,7,13,2095,0,0
2937,ACGTCGAATCTAGGGA,60,65,5,14,2096,0,0
2938,ACGTCGAATCTAGGGA,60,64,4,14,2098,0,0
2939,ACGTCGAATCTAGGGA,60,65,5,13,2099,0,0
2940,ACGTCGAATCTAGGGA,60,60,0,13,2100,0,0
2941,ACGTCGAATCTAGGGA,60,63,3,16,2101,0,0
2942,ACGTCGATTCTAGGGA,60,65,5,14,2102,0,0
2943,ACGTCGAATCTAGGGA,60,62,2,15,2104,0,0
2944,ACGTCGAATCTAGGGA,60,62,2,15,2106,0,0
2945,ACGTCGAATCTAGGGA,60,67,7,14,2108,0,0
2946,ACGTCGAATCTAGGGA,60,68,8,13,2109,0,0
2947,ACGTCGAATCTAGGGA,60,71,11,18,2111,0,0
2948,ACGTCGAATCTAGGGA,60,70,10,13,2112,0,0
2949,ACGTCGAATCTAGGGA,60,60,0,13,2113,0,0
2950,ACGTCGAATCTAGGGA,60,63,3,14,2116,0,0
2951,ACGTCGAATCTAGGGA,60,69,9,14,2117,0,0
2952,ACGTCGACTCTAGGGA,60,60,0,12,2119,0,0
2953,ACGTCGAATCTAGGGA,60,83,23,15,2124,2,0
2954,ACGTCGAATCTAGGGA,60,63,3,16,2125,0,0
2955,ACGTCGAATCTAGGGA,60,65,5,16,2127,0,0
2956,ACGTCGAATCTAGGGA,63,66,3,5,37,0,0
2957,ACGTCGAATCTAGGGA,63,63,0,6,57,0,0
2958,ACGTCGAATCTAGGGA,63,66,3,6,86,0,0
2959,ACGTCGAATCTAGGGA,63,64,1,8,94,0,0
2960,ACGTCGAATCTAGGGA,63,66,3,8,110,0,0
2961,ACGTCGAATCTAGGGA,63,66,3,7,134,0,0
2962,ACGTCGAATCTAGGGA,63,66,3,8,176,0,0
2963,ACGTCGAATCTAGGGA,63,63,0,9,211,0,0
2964,ACGTCGAATCTAGGGA,63,66,3,13,220,0,0
2965,ACGTCGAATCTAGGGA,63,63,0,8,228,0,0
2966,ACGTCGAATCTAGGGA,63,66,3,8,251,0,0
2967,ACGTCGAATCTAGGGA,63,66,3,9,290,0,0
2968,ACGTCGAATCTAGGGA,63,66,3,8,291,0,0
2969,ACGTCGAATCTAGGGA,63,66,3,8,294,0,0
2970,ACGTCGAATCTAGGGA,63,65,2,8,319,0,0
2971,ACGTCGAATCTAGGGA,63,66,3,11,352,0,0
2972,ACGTCGAATCTAGGGA,63,66,3,9,353,0,0
2973,ACGTCGAATCTAGGGA,63,66,3,9,356,0,0
2974,ACGTCGAATCTAGGGA,63,66,3,14,372,0,0
2975,ACGTCGAATCTAGGGA,63,66,3,8,373,0,0
2976,ACGTCGAATCTAGGGA,63,66,3,9,376,0,0
2977,ACGTCGAATCTAGGGA,63,66,3,11,422,0,0
2978,ACGTCGATTCTAGGGA,63,63,0,8,441,0,0
2979,ACGTCGAATCTAGGGA,63,66,3,10,444,0,0
2980,ACGTCGAATCTAGGAA,63,66,3,8,454,0,0
2981,ACGTCGAATCTAGGGA,63,66,3,7,458,0,0
2982,ACGTCGAATCTAGGGA,63,66,3,8,460,0,0
2983,ACGTCGAATCTAGGGA,63,64,1,9,470,0,0
2984,ACGTCGAATCTAGGGA,63,66,3,9,471,0,0
2985,ACGTCGAATCTAGGGA,63,66,3,9,475,0,0
2986,ACGTCGAATCTAGGGA,63,66,3,8,481,0,0
2987,ACGTCGAATCTAGGGA,63,64,1,9,492,0,0
2988,ACGTCGAATCTAGGGA,63,66,3,9,496,0,0
2989,ACGTCGAATCTAGGGA,63,66,3,15,510,0,0
2990,ACGTCGAATCTAGGGA,63,66,3,9,519,0,0
2991,ACGTCGAATCTAGGGA,63,64,1,8,520,0,0
2992,ACGTCGAATCTAGGGA,63,66,3,10,521,0,0
2993,ACGTCGAATCTAGGGA,63,66,3,9,524,0,0
2994,ACGTCGAATCTAGGGA,63,64,1,10,531,0,0
2995,ACGTCGAATCTAGGGA,63,63,0,12,539,0,0
2996,ACGTCGAATCTAGGGA,63,66,3,8,541,0,0
2997,ACGTCGAATCTAGGGA,63,63,0,12,546,0,0
2998,ACGTCGAATCTAGGGA,63,65,2,10,550,0,0
2999,ACGTCGAATCTAGGGC,63,66,3,11,552,0,0
3000,ACGTCGAATCTAGGGA,63,66,3,10,559,0,0
3001,ACGTCGAATCTAGGGA,63,64,1,10,574,0,0
3002,ACGTTGAATCTAGGGA,63,66,3,11,589,0,0
3003,ACGTCGAATCTAGGGA,63,66,3,12,591,0,0
3004,AAGTCGAATCTAGGGA,63,66,3,9,597,0,0
3005,ACGTCGAATCTAGGGA,63,64,1,10,599,0,0
3006,ACGTCGAATCTAGGGA,63,66,3,13,612,0,0
3007,ACGTCGAATCTAGGGC,63,66,3,11,632,0,0
3008,ACGTCGAATCTAGGGA,63,63,0,9,640,0,0
3009,ACGTCGAATCTAGGGA,63,66,3,9,653,0,0
3010,ACGTCGAATCTAGGGA,63,66,3,11,657,0,0
3011,ACGTCGAATCTAGGGA,63,65,2,9,662,0,0
3012,ACGTCGAATCTAGGGA,63,64,1,10,663,0,0
3013,ACGTCGAATCTAGGGA,63,66,3,10,665,0,0
3014,ACGTCGAATCTAGGGA,63,63,0,11,666,0,0
3015,ACGTCGAATCTAGGGA,63,65,2,9,673,0,0
3016,ACGTCGAATCTAGGGA,63,66,3,12,675,0,0
3017,ACGTCGAATCTAGGGA,63,66,3,10,681,0,0
3018,ACGTCGAATCTAGGGA,63,63,0,12,701,0,0
3019,ACGTCGAATCTAGGGA,63,66,3,8,714,0,0
3020,ACGTCGAATCTAGGGA,63,66,3,12,728,0,0
3021,ACGTCAAATCTAGTGA,63,64,1,10,730,0,0
3022,ACGTCGAATCTAGGGA,63,66,3,12,732,0,0
3023,ACGTCGAATCTAGGGA,63,66,3,12,733,0,0
3024,ACGTCGAATCTAGGGA,63,66,3,10,736,0,0
3025,ACGTCGAATCTAGGGA,63,66,3,10,739,0,0
3026,ACGTCGAATCTAGGGA,63,64,1,10,741,0,0
3027,ACGTCGAATCTAGGGA,63,66,3,11,744,0,0
3028,ACGTCGAATCTAGGGA,63,64,1,11,745,0,0
3029,ACGTCGAATCTAGGGA,63,66,3,10,746,0,0
3030,ACGTCGAATCTAGGGA,63,65,2,12,749,0,0
3031,ACGTCGAATCTAGGGA,63,66,3,12,752,0,0
3032,ACGTCGAATCTAGGGA,63,66,3,10,754,0,0
3033,ACGTCGAATCTAGGGA,63,66,3,10,755,0,0
3034,ACGTCGAATCTAGGGA,63,66,3,11,756,0,0
3035,ACGTCGAATCTAGGGA,63,66,3,11,758,0,0
3036,ACGTCGAATCTAGGGA,63,66,3,11,759,0,0
3037,ACGTCGAATCTAGGGA,63,66,3,8,770,0,0
3038,ACGTCGAATCTAGGGA,63,63,0,11,776,0,0
3039,ACGTCGAATCTAGGGA,63,66,3,10,781,0,0
3040,ACGTCGAATCTAGGGA,63,66,3,11,785,0,0
3041,ACGTCGAATCTAGGGA,63,66,3,11,791,0,0
3042,ACGTCGAATCTAGGGA,63,66,3,11,802,0,0
3043,ACGTCGAATCTAGGGA,63,66,3,13,803,0,0
3044,ACGTCGAATCTAGGGA,63,66,3,13,813,0,0
3045,ACGCCGAATCTAGGGA,63,63,0,12,830,0,0
3046,ACGTCGAATCTAGGGA,63,66,3,8,831,0,0
3047,ACGTCGAATCTAGGGA,63,66,3,9,832,0,0
3048,ACGTCGAATCTAGGGA,63,66,3,10,833,0,0
3049,ACGTCGAATCTAGGGA,63,66,3,8,843,0,0
3050,ACGTCGAATCTAGGGC,63,66,3,8,847,0,0
3051,ACGTCGAATCTAGGGA,63,65,2,9,848,0,0
3052,ACGTCGAATCTAGGGA,63,66,3,11,850,0,0
3053,ACGTCGAAACTAGGGA,63,66,3,9,854,0,0
3054,ACGTCGAATCTAGGGA,63,66,3,10,858,0,0
3055,ACGTCGAATCTAGGGA,63,66,3,9,860,0,0
3056,ACGTCGAAGCTAGGAA,63,66,3,11,861,0,0
3057,ACGTCGAATCTAGGGA,63,64,1,9,864,0,0
3058,CCGTCGAATCTAGGGA,63,66,3,9,867,0,0
3059,ACGTCGAATCTAGGGA,63,66,3,10,868,0,0
3060,ACGTCGAATCTAGGGA,63,66,3,12,871,0,0
3061,ACGTCGAATCTAGGGA,63,64,1,9,872,0,0
3062,ACGTCGAATCTAGGGA,63,66,3,12,873,0,0
3063,ACGTCGAATCTAGGGA,63,64,1,11,884,0,0
3064,ACGTCGAATCTAGGGA,63,63,0,11,892,0,0
3065,ACGTCGAATCTAGGGA,63,66,3,12,898,0,0
3066,ACGTCGAATCTAGGGA,63,66,3,13,905,0,0
3067,ACGTCGAATCTAGGGA,63,66,3,9,906,0,0
3068,ACGTAGAATCTAGGGA,63,64,1,11,908,0,0
3069,ACGTCGAATCTAGGGA,63,66,3,9,911,0,0
3070,ACGTCGAATCTAGGGA,63,66,3,9,920,0,0
3071,ACGTCGAATCTAGGGA,63,66,3,10,921,0,0
3072,ACGTCGAATCTAGGGA,63,66,3,11,924,0,0
3073,ACGTCGAATCTAGGGA,63,66,3,10,929,0,0
3074,ACGTCGAATCTAGGGA,63,66,3,10,930,0,0
3075,ACGTCGAATCTAGGGA,63,63,0,11,931,0,0
3076,ACGTCGAATCTAGGGA,63,66,3,13,935,0,0
3077,ACGTCGAATCTAGGGA,63,66,3,9,939,0,0
3078,ACGTCGAATCTAGGGA,63,66,3,9,942,0,0
3079,ACGTCGAATCTAGGGA,63,66,3,11,943,0,0
3080,ACGTCGAATCTAGGGA,63,66,3,10,944,0,0
3081,ACGTCGAATCTAGGGA,63,63,0,10,949,0,0
3082,ACGTAGAATCTAGGGA,63,66,3,13,955,0,0
3083,ACGTCGAATCTAGGGA,63,66,3,10,959,0,0
3084,ACGTCGAATCTAGGGA,63,64,1,11,964,0,0
3085,ACGTCGAATCTAGGGA,63,65,2,11,965,0,0
3086,ACGTCGAATCTAGGGA,63,66,3,14,972,0,0
3087,ACGTCGAATCTAGGGA,63,66,3,13,977,0,0
3088,ACGTCGAATCTAGGGA,63,66,3,7,980,0,0
3089,ACGTCGAATCTAGGGA,63,63,0,9,981,0,0
3090,ACGTCGAATCTAGGGA,63,66,3,7,984,0,0
3091,ACGTAGAATCTAGGGA,63,66,3,11,989,0,0
3092,ACGTCGAATCTAGGGA,63,66,3,10,996,0,0
3093,ACGTCGAATCTCGGGA,63,66,3,11,997,0,0
3094,ACGTCGAATCTAGGGA,63,66,3,10,1002,0,0
3095,ACGTCGAATCTAGGGA,63,66,3,12,1005,0,0
3096,ACGTCGAATCTAGGGA,63,66,3,10,1006,0,0
3097,ACGTCGAATCTAGGGA,63,65,2,11,1009,0,0
3098,ACGTCGAATCTAGGGA,63,66,3,12,1012,0,0
3099,ACGTCGAATCTAGGGA,63,66,3,13,1013,0,0
3100,ACGTCGAATCTAGGGA,63,66,3,10,1014,0,0
3101,ACGTCGAATCTAGGGA,63,66,3,10,1019,0,0
3102,ACGTCGAATCTAGGGA,63,66,3,10,1020,0,0
3103,ACGTCGAATCTAGGGA,63,63,0,11,1028,0,0
3104,ACGTCGAATATAGGGA,63,65,2,13,1029,0,0
3105,ACGTCGAATCTAGGGA,63,66,3,12,1030,0,0
3106,ACGTCGAATCTAGGGA,63,63,0,11,1031,0,0
3107,AGGTCGAATCTAGTGA,63,66,3,11,1040,0,0
3108,ACGTCGAATCTAGGGA,63,66,3,12,1045,0,0
3109,ACGTCGAATCTAGGGA,63,66,3,17,1046,0,0
3110,ACGTCGAATCTAGGGA,63,63,0,11,1048,0,0
3111,ACGTCGAATCTAGGGA,63,64,1,11,1050,0,0
3112,ACGTCGAATCTAGGGA,63,66,3,14,1052,0,0
3113,ACGTCGAATCTAGGGA,63,66,3,10,1058,0,0
3114,ACGTCGAATCTAGGGA,63,66,3,13,1062,0,0
3115,ACGTCGAATCTAGGGA,63,66,3,11,1065,0,0
3116,ACGTCGAATCTAGGGA,63,66,3,11,1068,0,0
3117,ACGTCGAATCTAGGGA,63,63,0,12,1072,0,0
3118,ACGTCGAATCTAGGGA,63,63,0,13,1074,0,0
3119,ACGTCGAATCTAGGGA,63,66,3,11,1075,0,0
3120,ACGTCGAATCTAGGGA,63,65,2,12,1081,0,0
3121,ACGTCGAATCTAGGGA,63,64,1,12,1083,0,0
3122,ACGTCGAATCTAGGGA,63,66,3,13,1086,0,0
3123,ACGTCGAATCTAGGGA,63,66,3,12,1095,0,0
3124,ACGTCGAATCTAGGGA,63,66,3,12,1097,0,0
3125,ACGTCGAATCTAGGGA,63,66,3,11,1099,0,0
3126,ACGTCGAATCTAGGGA,63,66,3,14,1112,0,0
3127,ACGTCGAATCTAGGGA,63,65,2,12,1113,0,0
3128,ACGTCGAATCTAGGGA,63,66,3,12,1114,0,0
3129,ACGTCGAATCTAGGGA,63,63,0,15,1121,0,0
3130,ACGTCGAATCTAGGGA,63,66,3,14,1122,0,0
3131,ACGTCGAATCTAGGGA,63,64,1,6,1125,0,0
3132,ACGTCGAATCTAGGGA,63,66,3,7,1127,0,0
3133,ACGTCGAATCTAGGGA,63,66,3,7,1128,0,0
3134,ACGTCGAATCTAGGCA,63,66,3,9,1130,0,0
3135,ACGTCGAATCTAGGGA,63,66,3,8,1132,0,0
3136,ACGTCGAATCTAGGGA,63,66,3,9,1133,0,0
3137,ACGTCGAGTCTAGGGA,63,66,3,9,1136,0,0
3138,ACGTCGAATCTAGGGA,63,63,0,9,1142,0,0
3139,ACGTCGAATCTAGGGA,63,66,3,9,1144,0,0
3140,ACGTCGAATCTAGGGA,63,66,3,9,1145,0,0
3141,ACGTCGAATCTAGGGA,63,66,3,9,1154,0,0
3142,ACGTCGAATCTAGGGA,63,66,3,9,1156,0,0
3143,ACGTCGAATCTAGGGA,63,63,0,9,1158,0,0
3144,ACGTCGAATCTAGGGA,63,66,3,9,1160,0,0
3145,ACGTCGAATCTAGGGA,63,65,2,10,1161,0,0
3146,ACGTCGAATCTAGGGA,63,63,0,12,1162,0,0
3147,ACGTCGAATCTAGGGA,63,66,3,9,1163,0,0
3148,ACGTCGAATCTAGGGA,63,66,3,12,1164,0,0
3149,ACGTCGAATCTAGGGA,63,65,2,10,1167,0,0
3150,ACGTCGAATCTAGGGA,63,66,3,9,1169,0,0
3151,ACGTCGAATCTAGGGA,63,66,3,10,1170,0,0
3152,ACGTCGAATCTAGGGA,63,66,3,10,1171,0,0
3153,ACGTCGAATCTAGGGA,63,63,0,14,1174,0,0
3154,ACGTCGAATCTAGGGA,63,66,3,11,1178,0,0
3155,ACGTCGAATCTAGGGA,63,66,3,8,1184,0,0
3156,ACGTCGAATCTAGGGA,63,66,3,10,1186,0,0
3157,ACGTCGAATCTAGGGA,63,66,3,13,1187,0,0
3158,ACGTCGAATCTAGGGA,63,63,0,8,1193,0,0
3159,ACGTCGAATCTAGGGA,63,66,3,11,1196,0,0
3160,ACGTCGAATCTAGGGA,63,66,3,10,1198,0,0
3161,ACGTCGAATCTAGGGA,63,63,0,9,1200,0,0
3162,ACGTCGAATCTAGGGA,63,66,3,10,1203,0,0
3163,ACGTCGAATCTAGGGA,63,66,3,11,1204,0,0
3164,ACGTCGAATCTAGGGA,63,66,3,10,1207,0,0
3165,ACGTCGAATCTAGGGA,63,66,3,11,1209,0,0
3166,ACGTCGAATCTAGGGA,63,66,3,13,1211,0,0
3167,ACGTCGAATCTAGGGA,63,66,3,11,1217,0,0
3168,ACGTCGAATCTAGGGA,63,66,3,11,1219,0,0
3169,ACGTCGAATCTAGGGA,63,66,3,12,1222,0,0
3170,ACGTCGAATCTAGGGA,63,66,3,10,1223,0,0
3171,ACGTCGAATCTAGGGA,63,66,3,9,1225,0,0
3172,ACGTCGAATCTAGGGA,63,66,3,13,1228,0,0
3173,ACGTCGAATCTAGGGC,63,64,1,12,1230,0,0
3174,ACGTCGAATCTAGGGA,63,66,3,11,1234,0,0
3175,ACGTCGAATCTAGGGA,63,63,0,12,1238,0,0
3176,ACGTCGAATCTAGGGA,63,65,2,12,1244,0,0
3177,ACGTCGAATCTAGGGA,63,66,3,10,1248,0,0
3178,ACGTCGAATCTAGGGA,63,64,1,12,1256,0,0
3179,ACGTCGAATCTAGGGA,63,66,3,10,1260,0,0
3180,ACGTCGAATCTAGGGA,63,66,3,10,1265,0,0
3181,ACGTCGAATCTAGGGA,63,65,2,12,1266,0,0
3182,ACGTCGAATCTAGGGA,63,66,3,12,1271,0,0
3183,ACGTCGAATCTAGGGA,63,65,2,11,1277,0,0
3184,ACGTCGAATCTAGGGA,63,64,1,11,1280,0,0
3185,ACGTCGAATCTAGGGA,63,66,3,11,1284,0,0
3186,ACGTCGAATCTAGGGA,63,65,2,9,1288,0,0
3187,ACGTCGAATCTAGGGA,63,66,3,13,1296,0,0
3188,ACGTCGAATCTAGGGA,63,66,3,12,1298,0,0
3189,ACGTCGAATCTAGGGA,63,64,1,11,1300,0,0
3190,ACGTCGAATCTAGGGA,63,66,3,12,1303,0,0
3191,ACGTCGAATCTAGGGA,63,66,3,12,1304,0,0
3192,ACGTCGAATCTAGGGA,63,65,2,11,1308,0,0
3193,ACGTCGAATCTAGGGA,63,66,3,16,1310,0,0
3194,ACGTCGAATCTAGGGA,63,66,3,12,1313,0,0
3195,ACGTCGAATCTAGGGA,63,63,0,11,1316,0,0
3196,ACGTCGAATCTAGGGA,63,66,3,9,1319,0,0
3197,ACGTCGAATCTAGGGA,63,66,3,10,1320,0,0
3198,ACGTCGAATCTAGGGA,63,66,3,12,1321,0,0
3199,ACGTCGAATCTAGGGA,63,66,3,12,1324,0,0
3200,ACGTCGAATCTAGGGA,63,66,3,14,1331,0,0
3201,ACGTCGAATCTAGGGA,63,66,3,12,1337,0,0
3202,ACGTCGAATCTAGGGA,63,66,3,13,1339,0,0
3203,ACGTCGAATCTAGGGA,63,66,3,14,1341,0,0
3204,ACGTCGAATCTAGGGA,63,64,1,7,1343,0,0
3205,ACGTCGAATCTAGGGA,63,66,3,7,1345,0,0
3206,ACGTCGAATCTAGGGA,63,63,0,11,1351,0,0
3207,ACGTCGAATCTAGGGA,63,66,3,9,1352,0,0
3208,ACGTCGAATCTAGGGA,63,66,3,11,1353,0,0
3209,ACGTCGAATCTAGGGA,63,65,2,10,1357,0,0
3210,ACGTCGAATCTAGGGA,63,66,3,12,1361,0,0
3211,ACGTCGAATCTAGGGA,63,66,3,11,1364,0,0
3212,ACGTCGAATCTAGGGA,63,66,3,11,1365,0,0
3213,ACGTCGAATCTAGGGA,63,63,0,10,1372,0,0
3214,ACGTCGAATCTAGGGA,63,66,3,11,1374,0,0
3215,ACGTCGAATCTAGGGA,63,66,3,13,1376,0,0
3216,ACGTCGAATCTAGGGA,63,65,2,9,1380,0,0
3217,ACGTCGAATCTAGGGA,63,63,0,16,1382,0,0
3218,ACGTCGAATCTAGGGC,63,66,3,10,1384,0,0
3219,ACGTCGAATCTAGGGA,63,66,3,15,1387,0,0
3220,ACGTCGAATCTAGGGA,63,66,3,12,1388,0,0
3221,ACGTCGAATCTAGGGA,63,64,1,13,1391,0,0
3222,ACGTCGAATCTAGGGA,63,66,3,11,1395,0,0
3223,ACGTCGTATCTAGGGA,63,66,3,14,1396,0,0
3224,ACGTCGAATCTAGGGA,63,66,3,10,1397,0,0
3225,ACGTCGAATCTAGGGA,63,66,3,12,1400,0,0
3226,ACGTCGAATCTAGGGA,63,66,3,10,1403,0,0
3227,ACGTCGAATCTAGGGA,63,66,3,11,1411,0,0
3228,ACGTCGAATCTAGGGA,63,66,3,14,1414,0,0
3229,ACGTCGAATCTAGGGA,63,66,3,10,1416,0,0
3230,ACGTCGAATCTAGGGA,63,66,3,9,1417,0,0
3231,ACGTCGAATCTAGGGA,63,64,1,11,1418,0,0
3232,ACGTCGAATCTAGGGA,63,66,3,10,1419,0,0
3233,ACGTCGAATCTAGGGA,63,66,3,13,1423,0,0
3234,ACGTCGAATCTAGGGA,63,66,3,11,1424,0,0
3235,ACGTCGAATCGAGGGA,63,66,3,10,1427,0,0
3236,ACGTCGAATCTAGGGA,63,66,3,12,1428,0,0
3237,ACGTCGAATCTAGGGA,63,66,3,13,1430,0,0
3238,AAGTCGAATCTAGGGA,63,66,3,11,1445,0,0
3239,ACGTCGAATCTAGGGA,63,66,3,12,1446,0,0
3240,ACGTCGAATCTAGGGA,63,66,3,11,1448,0,0
3241,ACGTCGAATCTAGGGA,63,64,1,12,1451,0,0
3242,ACGTCGAATCTCGGGA,63,66,3,12,1454,0,0
3243,ACGTCGAATATAGGGA,63,65,2,11,1457,0,0
3244,ACGTCGAATCTAGGGA,63,66,3,11,1461,0,0
3245,ACGTCGAAACTAGGGA,63,63,0,11,1462,0,0
3246,ACGTCGAATCTAGGGA,63,66,3,14,1465,0,0
3247,ACGTCGAATCTAGGGA,63,66,3,11,1466,0,0
3248,ACGTCGAATCTAGGGA,63,66,3,8,1467,0,0
3249,ACGTCGAATCTAGGGA,63,63,0,11,1470,0,0
3250,ACGTCGAATCTAGGGA,63,66,3,12,1471,0,0
3251,ACGTCGAACCTAGGGA,63,66,3,14,1474,0,0
3252,ACGTCGAATCTAGGGA,63,64,1,12,1476,0,0
3253,ACGTCGAATATAGGGA,63,66,3,14,1477,0,0
3254,ACGTCGAATCTAGGGA,63,66,3,13,1478,0,0
3255,ACGTCGAATCTAGGGA,63,66,3,12,1479,0,0
3256,ACGTCGAATCTAGGGA,63,64,1,12,1485,0,0
3257,ACGTCGAATCTAGGGA,63,66,3,13,1486,0,0
3258,ACGTCGAATCTAGGGA,63,66,3,12,1490,0,0
3259,ACGTCGATTCTAGGGA,63,63,0,13,1493,0,0
3260,ACGTCGAATCTAGGGA,63,66,3,14,1496,0,0
3261,ACGTCGAATCTAGGGA,63,65,2,13,1504,0,0
3262,ACGTCGAATCTAGGGA,63,63,0,12,1506,0,0
3263,ACGTCGAATCTAGGGA,63,66,3,17,1508,0,0
3264,ACGTCGAATCTAGGGA,63,66,3,12,1509,0,0
3265,ACGTCGAATCTAGGGA,63,64,1,12,1510,0,0
3266,ACGTCGAATCTAGGGA,63,66,3,12,1513,0,0
3267,ACGTCGAATCTAGGGC,63,66,3,13,1519,0,0
3268,ACGTCGAATCTAGGGA,63,66,3,13,1521,0,0
3269,ACGTCGACTCTAGGGA,63,63,0,11,1525,0,0
3270,ACGTCGAATCTAGGGA,63,66,3,14,1526,0,0
3271,ACGTCGAATCTAGGGA,63,63,0,15,1530,0,0
3272,ACGTCGAATCTAGGGA,63,66,3,13,1531,0,0
3273,ACGTCGAATCTAGGGA,63,63,0,13,1533,0,0
3274,ACGTCGAATCTAGGGA,63,66,3,15,1536,0,0
3275,ACGTCGAATCTAGGGA,63,66,3,16,1537,0,0
3276,ACGTCGAATCTAGGGA,63,66,3,15,1539,0,0
3277,ACGTCGAATCTAGGGA,63,66,3,6,1541,0,0
3278,ACGTCGAATCTAGGGA,63,66,3,8,1542,0,0
3279,ACGTCGAATCTAGGGA,63,66,3,12,1547,0,0
3280,ACGTCGAATCTAGGGA,63,66,3,7,1550,0,0
3281,ACGTCGAATCTAGGGA,63,66,3,9,1551,0,0
3282,ACGTCGAATCTAGGGA,63,66,3,10,1552,0,0
3283,ACGTCGAATCTAGGGA,63,66,3,14,1553,0,0
3284,ACGTCGAATCTAGGGA,63,66,3,11,1557,0,0
3285,ACGTCGAATCTAGGGA,63,66,3,10,1560,0,0
3286,ACGTCGAATCTAGGGA,63,66,3,10,1561,0,0
3287,ACGTCGAATCTAGGGA,63,66,3,9,1562,0,0
3288,ACGTCGAATCTAGGGA,63,66,3,9,1563,0,0
3289,ACGTCGAATCTAGGGA,63,66,3,6,1564,0,0
3290,ACGTCGAATCTAGGGA,63,66,3,11,1566,0,0
3291,ACGTCGAATCTAGGGA,63,66,3,9,1567,0,0
3292,ACGTCGAATCTAGGGA,63,66,3,9,1568,0,0
3293,ACGTCGAATCTAGGGA,63,66,3,12,1569,0,0
3294,ACGTCGAATCTAGGGA,63,63,0,9,1570,0,0
3295,ACGTCGAATCTAGGGA,63,66,3,10,1576,0,0
3296,ACGTCGAATCTAGGGA,63,66,3,14,1577,0,0
3297,ACGTCGAATCTAGGGA,63,63,0,11,1579,0,0
3298,GCGTCGAATCTAGGGA,63,66,3,9,1583,0,0
3299,ACGTCGAATCTAGGGA,63,66,3,9,1586,0,0
3300,ACGTCGAATCTAGGGA,63,66,3,9,1589,0,0
3301,ACGTCGAATCTAGGGA,63,66,3,9,1591,0,0
3302,ACGTCGAATCTAGGGA,63,66,3,10,1592,0,0
3303,ACGTCGAATCTAGGGA,63,66,3,10,1593,0,0
3304,ACGTCGAATCTAGGGA,63,63,0,10,1596,0,0
3305,ACGTCGAATCTAGGGA,63,66,3,9,1597,0,0
3306,ACGTCGAATCTAGGGA,63,66,3,10,1600,0,0
3307,ACGTCGAATCTAGGGA,63,66,3,12,1601,0,0
3308,ATGTCGAATCTAGGGA,63,63,0,11,1604,0,0
3309,ACGTCGAATCTAGGGA,63,65,2,13,1605,0,0
3310,ACGTCGAATCGAGGGA,63,65,2,16,1606,0,0
3311,ACGTCGAATCTAGGGA,63,66,3,9,1609,0,0
3312,ACGTCGAATCTAGGGA,63,66,3,11,1610,0,0
3313,ACGTCGAATCTAGGGA,63,66,3,10,1611,0,0
3314,ACGTCGAATCTAGGGA,63,66,3,12,1614,0,0
3315,ACGTCGAATCTAGGGA,63,66,3,11,1618,0,0
3316,ACGTCGAATCTAGGGA,63,65,2,12,1619,0,0
3317,ACGTCGAATCTAGGGA,63,66,3,13,1620,0,0
3318,ACGTCGAATCTAGGGA,63,66,3,11,1621,0,0
3319,ACGTCGAATCTAGGGC,63,63,0,12,1622,0,0
3320,ACGTCGAATCTAGGGA,63,66,3,11,1623,0,0
3321,ACGTCGAATCTAGGGA,63,66,3,13,1627,0,0
3322,ACGTCGAATCTAGGGA,63,64,1,12,1628,0,0
3323,ACGTCGAATCTAGGGA,63,66,3,11,1629,0,0
3324,ACGTCGAATCTAGGGA,63,66,3,11,1633,0,0
3325,ACGTCGAATCTAGGGA,63,65,2,10,1638,0,0
3326,ACGTCGAATCTAGGGA,63,66,3,12,1640,0,0
3327,ACGTCGAATCTAGGGA,63,66,3,7,1642,0,0
3328,ACGTCGAATCTAGGGA,63,63,0,10,1643,0,0
3329,ACGTCGAATCTAGGGA,63,63,0,10,1646,0,0
3330,ACGTCGAATCTAGGGA,63,66,3,12,1650,0,0
3331,ACGTCGAATCTAGGGA,63,66,3,13,1651,0,0
3332,ACGTCGAATCTAGGGA,63,66,3,12,1653,0,0
3333,ACGTCGAATCTAGGGA,63,63,0,11,1655,0,0
3334,ACGTCGAATCTAGGGA,63,66,3,11,1656,0,0
3335,ACGTCGAATCTAGGGA,63,66,3,11,1657,0,0
3336,ACGTCGAATCTAGGGA,63,66,3,11,1658,0,0
3337,ACGTCGAATCTACGGA,63,66,3,12,1659,0,0
3338,ACGTCGAATCTAGGGA,63,63,0,11,1665,0,0
3339,ACGTCGGATCTAGGGA,63,64,1,9,1666,0,0
3340,ACGTCGAATCTAGGGA,63,66,3,12,1667,0,0
3341,ACGTCGAATCTAGGGA,63,66,3,13,1668,0,0
3342,ACGTCGAATCTAGGGA,63,66,3,13,1670,0,0
3343,ACGTCGAATCTAGGGA,63,66,3,12,1672,0,0
3344,ACGTCGAATCTAGGGA,63,66,3,12,1677,0,0
3345,ACGTCGAATCTAGGGA,63,66,3,12,1678,0,0
3346,ACGTCGAATCTAGGGA,63,66,3,11,1679,0,0
3347,ACGTCGAATCTAGGGA,63,66,3,13,1681,0,0
3348,ACGTCGAATCTAGGGA,63,66,3,11,1682,0,0
3349,ACGTCGAATCTAGGGA,63,66,3,12,1684,0,0
3350,ACGTCGAATCTAGGGA,63,66,3,12,1686,0,0
3351,ACGTCGAATCTAGGGA,63,64,1,13,1687,0,0
3352,ACGTCGAATCTAGGGA,63,66,3,10,1688,0,0
3353,ACGTCGAATCTAGGGA,63,66,3,9,1689,0,0
3354,ACGTCGAATCTAGGGA,63,66,3,13,1691,0,0
3355,ACGTCGAATCTAGGGA,63,66,3,12,1692,0,0
3356,ACGTCGAATCTAGGGA,63,66,3,12,1695,0,0
3357,ACGTCGAATCTAGGGA,63,63,0,11,1697,0,0
3358,ACGTCGAATCTAGGGA,63,66,3,12,1700,0,0
3359,ACGTCGAATCTAGGGA,63,66,3,12,1702,0,0
3360,ACGTCGAATCTAGGGA,63,66,3,7,1704,0,0
3361,ACGTCGAATCTAGGGA,63,63,0,9,1706,0,0
3362,ACGTCGAATCTAGGGA,63,66,3,11,1708,0,0
3363,ACGTCGAACCTAGGGA,63,66,3,11,1710,0,0
3364,ACGTCGAATCTAGGGA,63,66,3,9,1712,0,0
3365,ACGTCGAATCTAGGGA,63,66,3,9,1713,0,0
3366,ACGTCGAATCTAGGGT,63,66,3,10,1714,0,0
3367,ACGTCGAATCTAGGGA,63,66,3,11,1721,0,0
3368,ACGTCGAATCTAGGGA,63,66,3,10,1722,0,0
3369,ACGTCGAATCTAGGGA,63,66,3,10,1724,0,0
3370,ACGTCGAATCTAGGGA,63,66,3,13,1731,0,0
3371,ACGTCGAATCTAGGGA,63,66,3,10,1734,0,0
3372,AAGTCGAATCTAGGGA,63,66,3,12,1739,0,0
3373,ACGTCGAATCTAGGGA,63,66,3,13,1741,0,0
3374,ACGTCGAATCTAGGGA,63,66,3,11,1743,0,0
3375,ACGTCGAATCTAGGGA,63,66,3,14,1744,0,0
3376,ACGTCGAATCTAGGGA,63,63,0,10,1745,0,0
3377,ACGTAGAATCTAGGGA,63,64,1,12,1747,0,0
3378,ACGTCGAATCTAGGGA,63,66,3,9,1749,0,0
3379,ACGTCGAATCTAGGGA,63,66,3,12,1753,0,0
3380,CCGTCGAATCTAGGGA,63,66,3,11,1760,0,0
3381,ACGTCGAATCTAGGGA,63,66,3,10,1761,0,0
3382,ACGTCGAATCTAGGGA,63,66,3,12,1762,0,0
3383,ACGTCGAATCTAGGGA,63,66,3,11,1764,0,0
3384,ACGTCGAATCTAGGGA,63,66,3,13,1766,0,0
3385,ACGTCGAATCTAGGGA,63,66,3,11,1767,0,0
3386,ACGTCGAATCTAGGGA,63,66,3,12,1769,0,0
3387,ACGTCGAATCTAGGGA,63,66,3,12,1770,0,0
3388,ACGTCGAAGCTAGGAA,63,66,3,14,1774,0,0
3389,CCGTCGAATCTAGGGA,63,66,3,18,1776,0,0
3390,ACGTCGAATCTAGGGA,63,66,3,8,1780,0,0
3391,ACGTCGAATCTAGGGA,63,66,3,11,1781,0,0
3392,ACGTAGAATCTAGGGA,63,66,3,12,1782,0,0
3393,ACGTCGAATCTAGGGA,63,63,0,12,1783,0,0
3394,ACGTCGAATCTCGGGA,63,66,3,12,1786,0,0
3395,ACGTCGAATCTAGGGA,63,66,3,11,1788,0,0
3396,ACGTCGAATCTAGGGA,63,66,3,14,1794,0,0
3397,ACGTCGAATCTAGGGA,63,64,1,11,1799,0,0
3398,ACGTCGAATCTAGGGA,63,66,3,12,1800,0,0
3399,ACGTCGAATCTAGGGA,63,66,3,13,1801,0,0
3400,ACGTCGAATCTAGGGA,63,65,2,14,1803,0,0
3401,ACGTCGAATCTAGGGA,63,66,3,12,1807,0,0
3402,ACGTCGAATCTAGGGA,63,64,1,12,1808,0,0
3403,ACGTCGAATCCAGGGA,63,66,3,13,1811,0,0
3404,ACGTCGAATCTAGGGA,63,64,1,18,1812,0,0
3405,ACGTCGAATCTAGGGA,63,66,3,10,1814,0,0
3406,ACGTCGATTCTAGGGA,63,66,3,13,1817,0,0
3407,ACGTCGAATCTAGGGA,63,66,3,11,1818,0,0
3408,ACGTCGAATCTAGGGA,63,66,3,14,1819,0,0
3409,ACGTCGAATCTAGTGA,63,66,3,12,1820,0,0
3410,ACGTCGAATCTAGGGA,63,66,3,14,1822,0,0
3411,ACGTCGAATCTAGGGA,63,66,3,13,1824,0,0
3412,ACGTCGAATCTAGGGA,63,66,3,13,1826,0,0
3413,ACGTCGAATCTAGGGA,63,63,0,14,1827,0,0
3414,ACGTCGAATCTAGGGA,63,66,3,17,1829,0,0
3415,ACGTCGAATCTAGGGA,63,66,3,13,1830,0,0
3416,ACGCCGAATCTAGGGA,63,66,3,14,1833,0,0
3417,ACGTCGAATCTAGGGA,63,66,3,12,1834,0,0
3418,ACGTCGAATCTAGGGA,63,66,3,13,1835,0,0
3419,ACGTCGAATCTAGGGA,63,66,3,13,1839,0,0
3420,ACGTCGAATCTAGGGA,63,66,3,15,1842,0,0
3421,ACGTCGAATCTAGGGA,63,66,3,15,1844,0,0
3422,ACGTCGAATCTAGGGA,63,66,3,15,1848,0,0
3423,ACGTCGAATCTAGGGA,63,63,0,15,1850,0,0
3424,ACGTCGAATCTAGGGA,63,66,3,15,1851,0,0
3425,ACGTCGAATCTAGGGA,63,66,3,7,1853,0,0
3426,ACGTCGAATCTAGGGA,63,66,3,9,1854,0,0
3427,ACGTCGAATCTAGGGA,63,66,3,8,1855,0,0
3428,ACGTCGAATCTAGGGA,63,66,3,10,1860,0,0
3429,ACGTCGAATCTAGGGA,63,66,3,9,1861,0,0
3430,ACGTCGAATCTAGGGA,63,66,3,8,1862,0,0
3431,ACGTCGAATCTAGGGA,63,66,3,9,1866,0,0
3432,ACGTCGAATCTAGGGA,63,63,0,12,1871,0,0
3433,ACGTCGAATCTAGGGA,63,66,3,11,1874,0,0
3434,ACGTCGAATCTAGGGA,63,66,3,10,1878,0,0
3435,ACGTCGAATCTAGGGA,63,64,1,10,1880,0,0
3436,ACGTCGAATCTAGGGA,63,63,0,11,1881,0,0
3437,ACGTCGAATCTAGGGA,63,66,3,13,1882,0,0
3438,ACGTCGAGTCTAGGGA,63,66,3,10,1883,0,0
3439,ACGTCGAATCTAGGGA,63,66,3,10,1887,0,0
3440,ACGTCGAATCTAGGGC,63,66,3,10,1890,0,0
3441,ACGTCGAATCTAGGGA,63,66,3,15,1892,0,0
3442,AAGTCGAATCTAGGGA,63,66,3,12,1893,0,0
3443,ACGTCGAATCTAGGGA,63,66,3,12,1894,0,0
3444,ACGTCGATTCTAGGGA,63,65,2,9,1899,0,0
3445,ACGTCGAATCTAGGGA,63,66,3,14,1902,0,0
3446,ACGTCGAATCTAGGGA,63,64,1,10,1905,0,0
3447,ACGTCGAATCTAGGGA,63,65,2,12,1907,0,0
3448,ACGTCGAATCTAGGGA,63,66,3,11,1910,0,0
3449,ACGTCGAATCTAGGGA,63,66,3,12,1912,0,0
3450,ACGTCGAATCTAGGGA,63,63,0,12,1916,0,0
3451,ACGTCGAATCTAGGGA,63,66,3,12,1917,0,0
3452,ACGTCGAATCTAGGGA,63,66,3,17,1919,0,0
3453,ACGTCGAATCTAGGGA,63,66,3,12,1922,0,0
3454,ACGTCGAATCTAGGGA,63,66,3,13,1925,0,0
3455,ACGTCGAATCTAGGGA,63,66,3,11,1926,0,0
3456,ACGTCGAATCTAGGGA,63,66,3,12,1931,0,0
3457,ACGTCGAATCTAGGGA,63,66,3,13,1935,0,0
3458,ACGTCGAATCTAGGGA,63,65,2,15,1936,0,0
3459,ACGTCGAATCTAGGGA,63,66,3,13,1937,0,0
3460,AAGTCGAATCTAGGGA,63,64,1,11,1938,0,0
3461,ACGTCGAATCGAGGGA,63,66,3,8,1940,0,0
3462,ACGTCGAATCTTGGGA,63,66,3,15,1942,0,0
3463,ACGTCGAATCTAGGGA,63,66,3,12,1943,0,0
3464,ACGTCGAGTCTAGGGA,63,66,3,12,1947,0,0
3465,ACGTCGAATCTAGGGA,63,64,1,11,1948,0,0
3466,ACGTCGAATCTAGGGA,63,66,3,13,1949,0,0
3467,ACGTCGAATCTAGGGA,63,66,3,13,1954,0,0
3468,ACGTCGAATCTAGGGA,63,66,3,12,1958,0,0
3469,ACGTCGAATCTAGGGA,63,66,3,12,1960,0,0
3470,ACGTCGAATCTAGGGA,63,66,3,12,1961,0,0
3471,ACGTCGAATCTAGGGA,63,66,3,14,1962,0,0
3472,ACGTCGAATCTAGGGA,63,66,3,14,1966,0,0
3473,ACGTCGAATCTAGGGA,63,64,1,12,1968,0,0
3474,ACGTCGAATCTAGGGA,63,63,0,12,1969,0,0
3475,ACGTCGAATCTAGGGA,63,66,3,11,1970,0,0
3476,ACGTCGAATCTAGGGA,63,63,0,12,1973,0,0
3477,ACGTCGAATCTAGGGA,63,66,3,14,1974,0,0
3478,ACGTCGAATCTAGGGA,63,66,3,12,1975,0,0
3479,ACGTCGAATCTAGGGA,63,63,0,14,1976,0,0
3480,ACGTCGAATCTAGGGA,63,63,0,17,1977,0,0
3481,ACGTCGAATCTAGGGA,63,64,1,13,1978,0,0
3482,ACGTCGAATCTAGGGA,63,65,2,13,1979,0,0
3483,ACGTCGAATCTAGGGA,63,66,3,13,1980,0,0
3484,ACGTCGAATCTAGGGA,63,66,3,12,1981,0,0
3485,ACGTCGAATCTAGGGA,63,66,3,10,1982,0,0
3486,ACGTCGAATCTAGGGA,63,66,3,11,1983,0,0
3487,ACGTCGAATCTAGGGA,63,66,3,13,1984,0,0
3488,ACGTCGAATCTAGGGA,63,66,3,13,1985,0,0
3489,ACGTCGAATCTAGGGA,63,64,1,14,1986,0,0
3490,ACGTCGAATCTAGGGA,63,66,3,13,1987,0,0
3491,ACGTCGAATCTAGGGA,63,66,3,12,1989,0,0
3492,ACGTCGAATCAAGGGA,63,64,1,13,1991,0,0
3493,ACGTCGAATCTAGGGA,63,66,3,13,1992,0,0
3494,ACGTCGAATCTAGGGA,63,64,1,13,1993,0,0
3495,ACGTCGAATCTAGGGA,63,63,0,14,1996,0,0
3496,ACGTCGAATCTAGGGA,63,66,3,14,1998,0,0
3497,ACGTCGAATCTAGGGA,63,66,3,8,2000,0,0
3498,ACGTCGAATCTAGGGA,63,66,3,11,2001,0,0
3499,ACGTCGAATCTAGGGA,63,66,3,16,2008,0,0
3500,ACGTCGAATCTAGGGC,63,65,2,10,2010,0,0
3501,ACGTCGAATCTAGGGA,63,66,3,11,2011,0,0
3502,ACGTCGAATCTAGGGA,63,66,3,11,2013,0,0
3503,ACGTCGAATCTAGGGA,63,66,3,12,2015,0,0
3504,ACGTCGAATCTAGGGA,63,66,3,12,2016,0,0
3505,ACGTCGAATCTAGGGA,63,66,3,8,2018,0,0
3506,ACGTCGAATCTAGGGA,63,66,3,11,2020,0,0
3507,ACGTCGAATCAAGGGA,63,66,3,11,2021,0,0
3508,ACGTCGAATCTAGGGA,63,66,3,14,2023,0,0
3509,ACGTCGAATCTAGGGA,63,63,0,17,2028,0,0
3510,ACGTCGAATCTAGGGA,63,66,3,16,2030,0,0
3511,ACGTCGAATCTAGGGA,63,66,3,13,2031,0,0
3512,ACGTCGAATCTAGGGA,63,66,3,14,2034,0,0
3513,ACGTCGAATCTAGGGA,63,66,3,11,2039,0,0
3514,ACGTAGAATCTAGGGA,63,66,3,13,2040,0,0
3515,ACGTCGAATCTAGGGA,63,66,3,13,2041,0,0
3516,ACGTGGAATCTAGGGA,63,66,3,14,2044,0,0
3517,ACGTCGAATCTAGGGA,63,66,3,12,2045,0,0
3518,ACGTCGAATCTAGGGA,63,66,3,11,2050,0,0
3519,ACGTCGAATCTAGGGA,63,66,3,12,2057,0,0
3520,ACGTCGAATCTAGGGA,63,66,3,11,2058,0,0
3521,ACGTCGAATCTAGGGA,63,66,3,13,2059,0,0
3522,ACGTCGAATCTAGGGA,63,66,3,14,2060,0,0
3523,ACGTCGAATCTAGGGA,63,66,3,13,2061,0,0
3524,ACGTCGAATCTAGGGA,63,66,3,16,2064,0,0
3525,ACGTCGAATCTAGGGA,63,66,3,19,2067,0,0
3526,ACGTCGAATCTAGGGA,63,66,3,11,2068,0,0
3527,ACGTCGAATCTAGGGA,63,64,1,13,2074,0,0
3528,ACGTCGAATCTAGGGA,63,64,1,12,2075,0,0
3529,ACGTCGAATCTCGGGA,63,66,3,13,2076,0,0
3530,ACGTTGAATCTAGGGA,63,66,3,14,2077,0,0
3531,ACGTCGAATCTAGGGA,63,66,3,14,2079,0,0
3532,ACGTCGAATCTAGGGA,63,64,1,12,2080,0,0
3533,ACGTCGAATCTAGGGA,63,64,1,15,2082,0,0
3534,ACGTCGAATCTAGGGA,63,66,3,12,2083,0,0
3535,ACGTCGAATCTAGGGA,63,66,3,12,2085,0,0
3536,ACGTCGAATCTAGGGA,63,66,3,13,2086,0,0
3537,ACGTCGAATCTAGGGA,63,66,3,14,2087,0,0
3538,ACGTCGAATCTAGGGA,63,66,3,15,2088,0,0
3539,ACGTCGAATCTAGGGA,63,66,3,13,2090,0,0
3540,ACGTTGAATCTAGGGA,63,65,2,14,2092,0,0
3541,ACGTCGAATCTAGGGA,63,64,1,13,2095,0,0
3542,ACGTCGAATCTAGGGA,63,66,3,14,2096,0,0
3543,ACGTCGAATCTAGGGA,63,66,3,14,2098,0,0
3544,ACGTCGAATCTAGGGA,63,66,3,13,2099,0,0
3545,ACGTCGAATCTAGGGA,63,66,3,13,2100,0,0
3546,ACGTCGATTCTAGGGA,63,66,3,14,2102,0,0
3547,ACGTCGAATCTAGGGA,63,66,3,15,2104,0,0
3548,ACGTCGAATCTAGGGA,63,66,3,15,2106,0,0
3549,ACGTCGAATCTAGGGA,63,66,3,14,2108,0,0
3550,ACGTCGAATCTAGGGA,63,66,3,13,2109,0,0
3551,ACGTCGAATCTAGGGA,63,66,3,18,2111,0,0
3552,ACGTCGAATCTAGGGA,63,65,2,13,2112,0,0
3553,ACGTCGAATCTAGGGA,63,66,3,15,2124,0,0
3554,ACGTCGAATCTAGGGA,63,66,3,16,2125,0,0
3555,ACGTCGAATCTAGGGA,63,66,3,16,2127,0,0
3556,ACGTCGAATCTAGGGA,63,64,1,6,2129,0,0
3557,ACGTCGAATCTAGGGA,63,66,3,7,2130,0,0
3558,ACGTCGAATCTAGGGA,63,66,3,7,2131,0,0
3559,ACGTTGAATCTAGGGA,63,66,3,9,2132,0,0
3560,ACGTCGAATCTAGGGA,63,66,3,12,2134,0,0
3561,ACGTCGAATCTAGGGA,63,66,3,9,2135,0,0
3562,ACGTCGAATCTAGGGA,63,66,3,10,2138,0,0
3563,ACGTCGAATCTAGGGA,63,66,3,14,2139,0,0
3564,ACGTCGAATCTAGGGA,63,66,3,10,2143,0,0
3565,ACGTCGAATCTAGGGA,63,66,3,6,2147,0,0
3566,ACGTCGAATCTAGGGA,63,65,2,11,2149,0,0
3567,ACGTCGAATCTAGGGA,63,66,3,9,2150,0,0
3568,ACGTCGAATCTAGGGA,63,66,3,12,2151,0,0
3569,ACGTCGAATCTAGGGA,63,64,1,10,2152,0,0
3570,ACGTCGAATCTAGGGA,63,66,3,10,2153,0,0
3571,ACGTCGAATCTAGGGA,63,66,3,15,2154,0,0
3572,ACGTCGAATCTAGGGA,63,66,3,9,2155,0,0
3573,ACGTCGAATCTAGGGA,63,66,3,10,2156,0,0
3574,ACGTCGAATCTAGGGA,63,66,3,11,2157,0,0
3575,ACGTCGAATATAGGGA,63,66,3,12,2158,0,0
3576,ACGTCGAATCTAGGGA,63,66,3,9,2160,0,0
3577,ACGTCGAATCTAGGGA,63,66,3,9,2163,0,0
3578,ACGTCGAATCTAGGGA,63,66,3,8,2164,0,0
3579,ACGTCGAATCTAGGGA,63,66,3,10,2166,0,0
3580,ACGTCGAATCTAGGGA,63,66,3,10,2169,0,0
3581,ACGTCGAATCTAGGGA,63,66,3,9,2170,0,0
3582,ACGTCGAATCTAGGGA,63,66,3,11,2171,0,0
3583,ACGTCGAATCTAGGGA,63,63,0,10,2172,0,0
3584,ACGTCGAATCTAGGGA,63,66,3,10,2173,0,0
3585,ACGTCGAATCTAGGGA,63,64,1,13,2175,0,0
3586,ACGTCGAATCTAGGGA,63,63,0,16,2176,0,0
3587,ACGTCGAATCTAGGGA,63,66,3,9,2178,0,0
3588,ACGTCGAATCTAGGGA,63,65,2,13,2182,0,0
3589,ACGTCGAATCTAGGGA,63,66,3,9,2183,0,0
3590,ACGTCGAATCTAGGGA,63,66,3,13,2186,0,0
3591,ACGTCGAATCTAGGGA,63,66,3,11,2190,0,0
3592,ACGTCGAATCTAGGGA,63,66,3,11,2191,0,0
3593,ACGTCGAATCTAGGGA,63,66,3,11,2194,0,0
3594,ACGTCGAATCTAGGGA,63,66,3,12,2195,0,0
3595,ACGTCGAATCGAGGGA,63,66,3,13,2196,0,0
3596,ACGTCGAATCTAGGGA,63,66,3,7,2199,0,0
3597,ACGTCGAATCTAGGGA,63,66,3,14,2200,0,0
3598,ACGTCGAATCTAGGGA,63,66,3,12,2201,0,0
3599,ACGTCGAATCTAGGGA,63,63,0,10,2202,0,0
3600,ACGTCGAATCTAGGGA,63,66,3,12,2204,0,0
3601,ACGTCGAATCTAGGGA,63,63,0,10,2205,0,0
3602,ATGTCGAATCTAGGGA,63,66,3,12,2207,0,0
3603,ACGTCGAATCTAGGGA,63,65,2,10,2208,0,0
3604,ACGTCGAATCTAGGGA,63,66,3,11,2209,0,0
3605,ACGTCGAATCTAGGGA,63,66,3,12,2211,0,0
3606,ACGTCGAATCTAGGGA,63,64,1,11,2215,0,0
3607,ACGTCGAATCTAGGCA,63,63,0,12,2217,0,0
3608,ACGTCGAATCTAGGGA,63,66,3,13,2218,0,0
3609,ACGTCGAATCTAGGGA,63,66,3,13,2221,0,0
3610,ACGTCGAATCTAGTGA,63,65,2,11,2222,0,0
3611,ACGTCGAATCTAGGGA,63,66,3,13,2224,0,0
3612,ACGTCGAATCTAGGGA,63,63,0,11,2225,0,0
3613,ACGTCGAATCTAGGGA,63,66,3,11,2226,0,0
3614,ACGTCGAATCTAGGGA,63,66,3,11,2227,0,0
3615,ACGTCGAATCTAGGGA,63,66,3,12,2228,0,0
3616,ACGTCGAATCTAGGGA,63,65,2,13,2231,0,0
3617,ACGTCGAATCTAGGGA,63,66,3,13,2232,0,0
3618,ACGTCGAATCTAGGGA,63,65,2,11,2233,0,0
3619,ACGTCGAATCTAGGGA,63,66,3,11,2234,0,0
3620,ACGTCGAATCTAGGGA,63,66,3,12,2236,0,0
3621,ACGTCGAATCTAGGGA,63,66,3,12,2237,0,0
3622,ACGTCAAATCTAGGGA,63,66,3,13,2240,0,0
3623,ACGTCGAATCTAGGGA,63,63,0,11,2242,0,0
3624,ACGTCGAATCTAGGGA,63,66,3,12,2243,0,0
3625,ACGTCGAATCTAGGGG,63,66,3,11,2245,0,0
3626,ACGTCGAATCTAGGGA,63,66,3,12,2246,0,0
3627,ACGTCGAATCTAGGGA,63,66,3,12,2248,0,0
3628,ACGTCGAATCTAGGGA,63,66,3,14,2249,0,0
3629,ACGCCGAATCTAGGGA,63,66,3,13,2251,0,0
3630,ACGTCGAATCTAGGGA,63,65,2,9,2252,0,0
3631,ACGTCGAATCTAGGGA,63,66,3,10,2253,0,0
3632,ACGTCGAATCTAGGGA,63,63,0,10,2259,0,0
3633,ACGTCGAATCTAGGGA,63,66,3,12,2260,0,0
3634,ACGTCGAATCTAGGGA,63,66,3,10,2261,0,0
3635,ACGTCGAATCTAGGGA,63,66,3,11,2262,0,0
3636,ACGTCGAATCTAGGGA,63,64,1,10,2265,0,0
3637,ACGTCGAATCTAGGGA,63,66,3,10,2267,0,0
3638,ACGTCGAATCTAGGGA,63,66,3,10,2268,0,0
3639,ACGTCGAATCTAGGGA,63,66,3,11,2269,0,0
3640,ACGTCGAATCTAGGGA,63,64,1,13,2272,0,0
3641,ACGTCGAATCTAGGGA,63,66,3,9,2273,0,0
3642,ACGTCGAATCTAGGGA,63,66,3,11,2277,0,0
3643,ACGTCGAATCTAGGGA,63,66,3,15,2278,0,0
3644,ACGTCGAATCTAGGGA,63,66,3,14,2281,0,0
3645,ACGTCGAATCTAGGGA,63,66,3,11,2283,0,0
3646,ACGTAGAATCTAGGGA,63,66,3,12,2284,0,0
3647,ACGTCGAATCTAGGGA,63,66,3,10,2286,0,0
3648,ACGTCGAATCTAGGGA,63,65,2,11,2287,0,0
3649,ACGTCGAATCTAGGGA,63,66,3,12,2288,0,0
3650,ACGTCGAATCTAGGGA,63,64,1,12,2291,0,0
3651,ACGTCGAATCTAGGGA,63,66,3,10,2293,0,0
3652,ACGTCGAATCTAGGAA,63,66,3,12,2295,0,0
3653,ACGTCGAATCTAGGGA,63,66,3,11,2296,0,0
3654,ACGTCGAATCTAGGGA,63,63,0,14,2298,0,0
3655,ACGTCGAATCTAGGGA,63,66,3,15,2303,0,0
3656,ACGTCGAAGCTAGGAA,63,66,3,14,2305,0,0
3657,ACGTCGAATCTAGGGA,63,66,3,18,2307,0,0
3658,ACGTCGAATCTAGGGA,63,63,0,8,2310,0,0
3659,ACGTAGAATCTAGGGA,63,66,3,12,2311,0,0
3660,ACGTCGAATCTAGGGA,63,64,1,11,2312,0,0
3661,ACGTCGAATCTCGGGA,63,66,3,12,2313,0,0
3662,ACGTCGAATCTAGGGA,63,65,2,11,2316,0,0
3663,ACGTCGAATCTAGGTA,63,63,0,11,2317,0,0
3664,ACGTCGAATCTAGGGA,63,66,3,11,2321,0,0
3665,ACGTCGAATCTCGGGA,63,65,2,11,2324,0,0
3666,ACGTCGAATCTAGCGA,63,66,3,12,2325,0,0
3667,ACGTCGAATCTCGGGA,63,66,3,13,2326,0,0
3668,ACGTCGAATCTAGGGA,63,66,3,12,2328,0,0
3669,ACGTCGAATCTAGGGA,63,66,3,12,2332,0,0
3670,ACGTCGAATCTAGGGA,63,65,2,12,2333,0,0
3671,AGGTCGAATCTAGTGA,63,66,3,12,2334,0,0
3672,ACGTCGAATCTGGGGA,63,66,3,13,2335,0,0
3673,ACGTCGAATCTAGGGA,63,66,3,12,2337,0,0
3674,ACGTCGAATCTAGGGA,63,66,3,10,2338,0,0
3675,ACGTCGAATCTAGGGA,63,65,2,12,2339,0,0
3676,ACGTCGATTCTAGGGA,63,66,3,13,2341,0,0
3677,ACGTCTAATCTAGGTA,63,66,3,11,2342,0,0
3678,ACGTCGAATCTAGGGA,63,66,3,14,2343,0,0
3679,ACGTCGAATCTAGGGA,63,66,3,11,2344,0,0
3680,ACGTCGAATCTAGGGA,63,65,2,14,2345,0,0
3681,ACGTCGAATCTAGGGA,63,64,1,12,2347,0,0
3682,ACGTCGAATCTAGGGA,63,66,3,14,2349,0,0
3683,ACGTCGAATCTAGGGA,63,66,3,12,2350,0,0
3684,ACGTCGAATCTAGGGA,63,66,3,13,2352,0,0
3685,ACGTCGAATCTAGGGA,63,66,3,12,2355,0,0
3686,ACGTCGAATCTAGGGA,63,66,3,13,2356,0,0
3687,GCGTCGAATCTAGGGA,63,66,3,13,2358,0,0
3688,ACGTCGAATCTAGGGA,63,63,0,15,2360,0,0
3689,ACGTCGAATCTAGGGA,63,66,3,13,2362,0,0
3690,ACGTCGAATCTAGGGA,63,64,1,16,2364,0,0
3691,ACGTCGAATCTAGGGA,63,66,3,7,2366,0,0
3692,ACGTCGAATCTAGGGA,63,66,3,8,2367,0,0
3693,ACGTCGAATCTAGGCA,63,66,3,10,2369,0,0
3694,ACGTCGAATCTAGGGA,63,66,3,10,2371,0,0
3695,ACGTCGAATCTAGGGA,63,66,3,9,2372,0,0
3696,ACGTCGAATCTAGGGA,63,65,2,8,2373,0,0
3697,ACGTCGAGTCTAGGGA,63,65,2,10,2374,0,0
3698,ACGTCGAATCTAGGGA,63,66,3,10,2375,0,0
3699,ACGTCGAATCTAGGGA,63,66,3,10,2376,0,0
3700,ACGTCGAATCTAGGGA,63,66,3,10,2377,0,0
3701,ACGTCGAATCTAGGGA,63,65,2,11,2378,0,0
3702,ACGTCGAATCTAGGGA,63,66,3,10,2379,0,0
3703,ACGTCGAATCTAGGGA,63,65,2,10,2381,0,0
3704,ACGTCGAATCTAGGGA,63,64,1,10,2382,0,0
3705,ACGTCGAATCTAGGGA,63,63,0,10,2383,0,0
3706,ACGTCGAATCTAGGGA,63,66,3,11,2384,0,0
3707,ACGTCGAATCTAGGGA,63,66,3,13,2385,0,0
3708,ACGTCGAATCTAGGGA,63,65,2,10,2386,0,0
3709,ACGTCGAATCTAGGGA,63,66,3,11,2388,0,0
3710,ACGTCGAATCTAGGGA,63,66,3,11,2392,0,0
3711,ACGTCGAATCTAGGGA,63,66,3,12,2394,0,0
3712,ACGTCGAATCTAGGGA,63,66,3,15,2395,0,0
3713,ACGTCGAATCTAGGGA,63,66,3,12,2396,0,0
3714,ACGTCGAATCTAGGGA,63,63,0,11,2397,0,0
3715,GCGTCGAATCTAGGGA,63,66,3,10,2399,0,0
3716,ACGTCGAATCTAGGGA,63,66,3,11,2401,0,0
3717,ACGTCGAATCTAGGGA,63,66,3,11,2402,0,0
3718,ACGTCGAATCTAGGGA,63,64,1,14,2403,0,0
3719,ACGTAGAATCTAGGGA,63,64,1,12,2404,0,0
3720,ACGTCGAATCTAGGGA,63,66,3,12,2405,0,0
3721,ACGTCGAATCTAGGGA,63,66,3,10,2406,0,0
3722,ACGACGAATCTAGGGA,63,66,3,12,2408,0,0
3723,ACGTCGAATCTAGGGA,63,64,1,10,2410,0,0
3724,ACGTCGAATCTAGGGA,63,66,3,11,2411,0,0
3725,ACGTCGAATCTAGGGA,63,66,3,11,2413,0,0
3726,ACGTCGAATCTAGGGA,63,66,3,11,2414,0,0
3727,ACGTCGAATCTAGGGA,63,66,3,14,2416,0,0
3728,ACCTCGAATCTAGGGA,63,66,3,13,2422,0,0
3729,ACGTCGAATCTAGGGA,63,65,2,10,2424,0,0
3730,ACGTCGAATCTAGGGA,63,63,0,14,2425,0,0
3731,ACGTCGAATCTAGGGC,63,65,2,13,2426,0,0
3732,ACGTCGAATCTAGGGA,63,66,3,12,2427,0,0
3733,ACGTCGAATCTAGGGA,63,66,3,13,2428,0,0
3734,ACGTCGAATCTAGGGA,63,65,2,13,2429,0,0
3735,ACGTCGAATCTAGGGA,63,66,3,13,2430,0,0
3736,ACGTCGAATCTAGGGA,63,66,3,8,2431,0,0
3737,ACGTCGAATCTAGGGA,63,64,1,11,2432,0,0
3738,ACGTCGAATCTAGGGA,63,66,3,13,2433,0,0
3739,ACGTCGAATCTAGGGA,63,66,3,11,2434,0,0
3740,ACGTCGAATCTAGGGA,63,66,3,13,2435,0,0
3741,ACGTCGAATCTAGGGA,63,66,3,11,2436,0,0
3742,ACGTCGAATCTAGGGA,63,66,3,13,2437,0,0
3743,ACGTCGAATCTAGGGA,63,66,3,13,2438,0,0
3744,ACGTCGAATCTAGGGA,63,65,2,12,2442,0,0
3745,ACGTCGAATCTAGGGA,63,66,3,12,2443,0,0
3746,ACGTCGAATCTAGGGA,63,66,3,10,2445,0,0
3747,ACGTCGAATCTAGGGA,63,66,3,15,2446,0,0
3748,ACGTCGAATCTAGGGA,63,66,3,14,2447,0,0
3749,ACGTCGAATCTAGGGA,63,66,3,12,2449,0,0
3750,ACGTCGAATCTAGGGA,63,66,3,11,2450,0,0
3751,ACGTCGAATCTAGGGA,63,66,3,17,2454,0,0
3752,ACGTCGAATCTAGGGA,63,66,3,13,2455,0,0
3753,ACGTCGAATCTAGGGA,63,66,3,12,2457,0,0
3754,ACGTTGAATCTAGGGA,63,66,3,10,2458,0,0
3755,ACGTCGAATCTAGGGA,63,66,3,11,2459,0,0
3756,ACGTCGAATCTAGGGA,63,63,0,13,2460,0,0
3757,ACGTCGAATCTAGGGA,63,66,3,13,2461,0,0
3758,ACGTCGAATCTAGGGA,63,66,3,13,2463,0,0
3759,ACGTCGAATCTAGGGA,63,63,0,12,2464,0,0
3760,ACGTCGAATCTAGGGA,63,66,3,13,2466,0,0
3761,ACGTCGAATCTAGGGA,63,65,2,13,2467,0,0
3762,ACGTCGAATCTAGGGA,63,66,3,13,2468,0,0
3763,ACGTCGAATCTAGGGA,63,66,3,14,2469,0,0
3764,ACGTCGAATCTAGGGA,63,66,3,8,2472,0,0
3765,ACGTCGAATCTAGGGA,63,65,2,11,2473,0,0
3766,ACGTCGAATCTAGGGA,63,66,3,12,2474,0,0
3767,ACGTCGAATCTAGGGA,63,66,3,10,2475,0,0
3768,ACGTCGAATCTAGGGA,63,66,3,12,2476,0,0
3769,ACGTCGAATCTAGGGA,63,66,3,16,2477,0,0
3770,ACGTCGAATCTAGGGA,63,64,1,11,2478,0,0
3771,ACGTCGAATCTAGGGA,63,66,3,11,2479,0,0
3772,ACGTCGAATCTAGGGA,63,66,3,11,2481,0,0
3773,ACGTCGAATCTAGGGA,63,66,3,11,2486,0,0
3774,ACGTCGAATCTAGGGA,63,66,3,11,2487,0,0
3775,ACGTCGAATCTAGGGA,63,65,2,14,2489,0,0
3776,ACGTCGAATCTCGGGA,63,65,2,14,2490,0,0
3777,ACGTCGAATCTAGGGA,63,66,3,12,2491,0,0
3778,ACGTCGAATCTAGGGA,63,63,0,10,2492,0,0
3779,ACGTCGAATCTAGGGA,63,66,3,12,2493,0,0
3780,ACGTCGAATCTAGGGC,63,66,3,11,2495,0,0
3781,ACGTCGAATCTAGGGA,63,64,1,16,2496,0,0
3782,ACGTCGAATCTAGGGA,63,63,0,14,2498,0,0
3783,ACGTCGAATCTAGGGA,63,66,3,12,2499,0,0
3784,ACGTCGTATCTAGGGA,63,66,3,15,2500,0,0
3785,ACGTCGAATCTAGGGA,63,66,3,11,2503,0,0
3786,ACGTCGAATCTAGGGA,63,66,3,12,2504,0,0
3787,ACGTCGAATCTAGGGA,63,66,3,15,2506,0,0
3788,ACGTCGAATCTAGGGA,63,66,3,10,2508,0,0
3789,ACGTCGAATCTAGGGA,63,66,3,12,2509,0,0
3790,ACGTCGAATCTAGGGA,63,65,2,11,2510,0,0
3791,ACGTCGAATCTAGGGA,63,66,3,14,2512,0,0
3792,ACGTCGAATCTAGGGA,63,66,3,12,2513,0,0
3793,ACGTCGAATCTAGGGA,63,66,3,11,2514,0,0
3794,ACGTCGAATCTAGGGA,63,66,3,14,2516,0,0
3795,ACGTCGAATCTAGGGA,63,66,3,13,2517,0,0
3796,ACGTCGAATCTAGGGA,63,66,3,15,2518,0,0
3797,ACGTCGAAGCTAGTAA,63,64,1,15,2519,0,0
3798,ACGTCGAATCTAGGGA,63,66,3,19,2520,0,0
3799,AAGTCGAATCTAGGGA,63,66,3,12,2521,0,0
3800,ACGTCGAATCTAGGGA,63,66,3,13,2522,0,0
3801,ACGTAGAATCTAGGGA,63,63,0,13,2525,0,0
3802,ACGTCGAATCTAGGGA,63,66,3,12,2527,0,0
3803,ACGTCGAATCTCGGGA,63,66,3,13,2528,0,0
3804,ACGTCGAATATAGGGA,63,66,3,12,2529,0,0
3805,ACGTCGAATCTAGGGA,63,66,3,12,2531,0,0
3806,ACGTCGAATCTAGGGA,63,63,0,15,2532,0,0
3807,ACGTCGAATCTAGGGA,63,66,3,12,2533,0,0
3808,ACGTCGAATCTAGGGA,63,63,0,13,2536,0,0
3809,ACGTCGAATCTAGGGA,63,64,1,13,2538,0,0
3810,ACGTCGAATATAGGGA,63,63,0,15,2539,0,0
3811,ACGTCGAATCTAGGGA,63,66,3,14,2540,0,0
3812,ACGTCGAATCTAGGGA,63,63,0,14,2542,0,0
3813,ACGTCGAATCTAGGGA,63,66,3,13,2543,0,0
3814,ACGTCGAATCTAGGGA,63,63,0,13,2545,0,0
3815,ACGTCGAATCTAGGGA,63,66,3,14,2546,0,0
3816,ACGTCGATTCTAGGGA,63,66,3,14,2549,0,0
3817,ACGTCGAATCTAGGGA,63,64,1,15,2550,0,0
3818,ACGTCGAATCTAGGGA,63,64,1,14,2552,0,0
3819,ACGTCGAATCTAAGGA,63,65,2,18,2554,0,0
3820,ACGTCGAATCTAGGGA,63,66,3,13,2555,0,0
3821,ACGTCGAATCTAGGGA,63,66,3,13,2557,0,0
3822,ACGTCGAATCTAGGGA,63,65,2,14,2558,0,0
3823,ACGTCGAATCTAGGGA,63,66,3,13,2560,0,0
3824,ACGTCGAATCTAGGGA,63,66,3,15,2562,0,0
3825,ACGTCGAATCTAGGGA,63,66,3,14,2565,0,0
3826,ACGTCGAATCTAGGGA,63,64,1,17,2567,0,0
3827,ACGTCGAATCTAGGGA,63,63,0,16,2568,0,0
3828,ACGTCGAATCTAGGGA,63,66,3,7,2569,0,0
3829,ACGTCGAATCTAGGGA,63,66,3,9,2570,0,0
3830,ACGTCGAATCTAGGGA,63,66,3,8,2571,0,0
3831,ACGTCGAATCTAGGGA,63,66,3,13,2572,0,0
3832,ACGTCGAATCTAGGGA,63,66,3,8,2573,0,0
3833,ACGTCGAATCTAGGGA,63,66,3,11,2575,0,0
3834,ACGTCGAATCTAGGGA,63,64,1,11,2580,0,0
3835,ACGTCGAATCTAGGGA,63,66,3,10,2583,0,0
3836,ACGTCGAATCTAGGGA,63,66,3,10,2586,0,0
3837,ACGTCGAATCTAGGGA,63,63,0,10,2587,0,0
3838,ACGTCGAATCTAGGGA,63,66,3,13,2588,0,0
3839,ACGTCGAATCTAGGGA,63,64,1,10,2589,0,0
3840,ACGTCGAATCTAGGGA,63,66,3,11,2591,0,0
3841,ACGTCGAATCTAGAGA,63,65,2,16,2592,0,0
3842,ACGTCGAATCTAGGGA,63,66,3,10,2593,0,0
3843,ACGTCGAATCTAGGGA,63,66,3,11,2594,0,0
3844,ACGTCGAATCTAGGGA,63,66,3,15,2595,0,0
3845,ACGTCGAATCTAGGGA,63,66,3,12,2596,0,0
3846,ACGTCGAAGCTAGGAA,63,66,3,13,2598,0,0
3847,GCGTCGAATCTAGGGA,63,66,3,10,2599,0,0
3848,ACGTCGAATCTAGGGA,63,63,0,10,2601,0,0
3849,ACGTCGAATCTAGGGA,63,66,3,10,2602,0,0
3850,ACGTCGAATCTAGGGA,63,64,1,10,2603,0,0
3851,ACGTCGAATCTAGGGA,63,66,3,11,2604,0,0
3852,ACGTCGAATCTAGGGA,63,66,3,11,2605,0,0
3853,ACGTCGAATCTAGGGA,63,64,1,11,2606,0,0
3854,ACGTCGAATCTAGGGA,63,66,3,10,2607,0,0
3855,ACGTCGATTCTAGGGA,63,66,3,12,2610,0,0
3856,ACGTCGAATCTAGGGA,63,66,3,11,2611,0,0
3857,ACGTCGAATCTAGGGA,63,66,3,13,2612,0,0
3858,ATGTCGAATCTAGGGA,63,66,3,12,2613,0,0
3859,ACGTCGAATCTAGGGA,63,66,3,17,2615,0,0
3860,ACGTCGAATCTAGGGA,63,66,3,12,2617,0,0
3861,ACGTCGAATCGAGGGA,63,66,3,13,2621,0,0
3862,ACGTCGAATCTAGGGA,63,66,3,14,2622,0,0
3863,ACGTCGAATCTAGGGA,63,66,3,12,2623,0,0
3864,ACGTCGAATCTAGGGA,63,66,3,12,2625,0,0
3865,ACGTCGAATCTAGGGA,63,66,3,12,2626,0,0
3866,ACGTCGAATCTAGGGA,63,66,3,13,2628,0,0
3867,ACGTCGAGTCTAGGGA,63,66,3,12,2629,0,0
3868,ACGTCGAATCTAGGGA,63,66,3,14,2630,0,0
3869,ACGTCGAATCTAGGGA,63,64,1,12,2633,0,0
3870,ACGTCGAATCTAGGGA,63,65,2,13,2634,0,0
3871,ACGTCGAATCTCGGGA,63,66,3,11,2637,0,0
3872,ACGTCGAATCTAGGGA,63,64,1,13,2639,0,0
3873,ACGTCGAATCTAGGGA,63,63,0,14,2640,0,0
3874,ACGTCGAATCTAGGGA,63,64,1,11,2641,0,0
3875,ACGTCGAATCTAGGGA,63,66,3,13,2642,0,0
3876,ACGTCGAATCTAGGGA,63,66,3,12,2643,0,0
3877,ACGTCGAATCTAGGGA,63,66,3,12,2644,0,0
3878,ACGTCGAATCTAGGGA,63,66,3,12,2646,0,0
3879,ACGTCGAATCTAGGGA,63,66,3,13,2647,0,0
3880,ACGTCGAATCTAGGGA,63,66,3,13,2649,0,0
3881,ACGTCGAATCTAGGGA,63,63,0,12,2650,0,0
3882,ACGTCGGATCTAGGGA,63,66,3,10,2651,0,0
3883,ACGTCGAATCTAGGGA,63,66,3,14,2653,0,0
3884,ACGTCGAATCTAGTGA,63,66,3,12,2654,0,0
3885,ACGTCGAATCTAGGGA,63,63,0,14,2655,0,0
3886,ACGTCGAATCTAGGGA,63,66,3,11,2659,0,0
3887,ACGTCGAATCTAGGGA,63,66,3,13,2660,0,0
3888,ACGTCGAATCTAGGGA,63,66,3,12,2662,0,0
3889,ACGTCGAATCTAGGGA,63,66,3,14,2663,0,0
3890,ACGTCGAATCTAGGGA,63,64,1,12,2664,0,0
3891,ACGTCGAATCTAGGGA,63,66,3,13,2666,0,0
3892,ACGTCGAATCTAGGGA,63,64,1,11,2668,0,0
3893,ACGTCGAATCTAGGGA,63,66,3,13,2670,0,0
3894,ACGTCGAATCTAGGGA,63,64,1,14,2671,0,0
3895,ACGTCGAATCTAGGGA,63,66,3,13,2674,0,0
3896,ACGTCGAATCTAGGGA,63,66,3,13,2678,0,0
3897,ACGCCGAATCTAGGGA,63,66,3,14,2680,0,0
3898,ACGTCGAATCTAGGGA,63,66,3,11,2682,0,0
3899,ACGTCGAACCTAGGGA,63,66,3,12,2685,0,0
3900,ACGTCGAATCTAGGGA,63,66,3,10,2686,0,0
3901,ACGTCGAATCTAGGGA,63,63,0,10,2687,0,0
3902,ACGTCGAATCTAGGGA,63,63,0,12,2690,0,0
3903,ACGTCGAATCTAGGGA,63,64,1,12,2691,0,0
3904,ACGTCGAATCTAGGGA,63,63,0,11,2692,0,0
3905,ACGTCGAATCTAGGGA,63,66,3,11,2694,0,0
3906,ACGTCGAATCTAGGGA,63,66,3,14,2696,0,0
3907,ACGTCGAATCTAGGGA,63,66,3,11,2698,0,0
3908,AAGTCGAATCTAGGGA,63,63,0,13,2699,0,0
3909,ACGTCGAATCTAGGGA,63,66,3,13,2700,0,0
3910,ACGTCGAATCTAGGGA,63,66,3,14,2701,0,0
3911,ACGTCGAATCTAGGGA,63,66,3,12,2702,0,0
3912,ACGTCGAATCTAGGGA,63,64,1,15,2703,0,0
3913,ACGTCGAATCTAGGGA,63,66,3,11,2704,0,0
3914,ACGTCGAATCTAGGGA,63,66,3,12,2705,0,0
3915,ACGTAGAATCTAGGGA,63,66,3,13,2706,0,0
3916,ACGTCGAATCTAGGGA,63,66,3,13,2709,0,0
3917,ACGTCGAATCTAGGGA,63,66,3,12,2710,0,0
3918,ACGTCGAATCTAGGGA,63,65,2,12,2711,0,0
3919,ACGTCGAATCTAGGGA,63,66,3,13,2712,0,0
3920,ACGTGGAATCTAGGGA,63,66,3,11,2713,0,0
3921,ACGTCGCATCTAGGGA,63,66,3,12,2714,0,0
3922,ACGTCGAATCTAGGGA,63,66,3,13,2716,0,0
3923,ACGTCGAATCTAGGGA,63,66,3,12,2717,0,0
3924,ACGTCGAATCTAGGGA,63,66,3,12,2720,0,0
3925,ACGTCGAATCTAGGGA,63,66,3,14,2723,0,0
3926,ACGTCGAATCTAGGGA,63,65,2,15,2725,0,0
3927,CCGTCGAATCTAGGGA,63,66,3,19,2726,0,0
3928,ACGTCGAATCTAGGGA,63,66,3,13,2727,0,0
3929,ACGTCGAATCTAGGGA,63,66,3,9,2728,0,0
3930,ACGTAGAATCTAGGGA,63,66,3,13,2730,0,0
3931,ACGTCGAATCTAGGGA,63,66,3,13,2731,0,0
3932,ACGTCGAATCTAGGGA,63,64,1,14,2733,0,0
3933,ACGTCGAATCTAGGGA,63,66,3,12,2734,0,0
3934,ACGTCGAATCTAGGGA,63,65,2,12,2735,0,0
3935,ACGTCGAATCTAGGGA,63,66,3,14,2736,0,0
3936,ACGTCGAATCTAGGGA,63,66,3,15,2737,0,0
3937,ACGTCGAATCTAGGGA,63,66,3,9,2738,0,0
3938,ACGTCGAATCTAGGGA,63,63,0,12,2739,0,0
3939,ACGTCGAATCTAGGGA,63,66,3,14,2741,0,0
3940,ACGTCGAATCTAGGGA,63,66,3,15,2742,0,0
3941,ACGTCGAATCTAGGGA,63,66,3,13,2743,0,0
3942,ACGTCGAATCTAGGGA,63,66,3,13,2744,0,0
3943,ACGTCGAATCTAGAGA,63,66,3,13,2747,0,0
3944,ACGTCGAATCTAGGGA,63,66,3,11,2748,0,0
3945,ACGTCGAATCTAGGGA,63,66,3,13,2749,0,0
3946,ACGTCGATTCTAGGGA,63,66,3,14,2751,0,0
3947,ACGTCGAATCTAGGGA,63,66,3,12,2752,0,0
3948,ACGTCGAATCTAGGGA,63,66,3,15,2753,0,0
3949,ACGTCGAATCTAGGGA,63,64,1,15,2756,0,0
3950,ACGTCGAATCTAGGGA,63,66,3,14,2757,0,0
3951,ACGTCGAATCTAGGGA,63,65,2,14,2759,0,0
3952,ACGTCGAATCTAGGGA,63,63,0,15,2760,0,0
3953,ACGTCGAATCTAGGGA,63,66,3,14,2762,0,0
3954,GCGTCGAATCTAGGGA,63,63,0,13,2764,0,0
3955,ACGTCGAATCTAGGGA,63,66,3,13,2766,0,0
3956,ACGTCGAATCTAGGGA,63,64,1,15,2767,0,0
3957,ACGTCGAATCTAGGGA,63,66,3,13,2769,0,0
3958,TCGTCGAATCTAGGGA,63,64,1,14,2771,0,0
3959,ACGTCGAATCTAGGGA,63,63,0,16,2775,0,0
3960,ACGTCGAATATAGGGA,63,66,3,16,2776,0,0
3961,ACGTCGAATCTAGGGA,63,66,3,16,2777,0,0
3962,ACGTCGAATCTAGGGA,63,66,3,8,2778,0,0
3963,ACGTCGAATCTAGGGA,63,66,3,10,2779,0,0
3964,ACGTCGAATCTAGGGA,63,65,2,9,2780,0,0
3965,ACGTCGAATCTAGGGA,63,66,3,9,2781,0,0
3966,ACGTCGAATCTAGGGA,63,66,3,11,2782,0,0
3967,ACGTCGAATCTAGGGA,63,64,1,10,2783,0,0
3968,ACGTCGAATCTAGGGA,63,66,3,9,2784,0,0
3969,ACGTCGAGTCTAGGGA,63,66,3,11,2785,0,0
3970,ACGTCGAATCTAGGGA,63,66,3,12,2786,0,0
3971,ACGTCGAATCTAGGGA,63,66,3,10,2787,0,0
3972,ACGTCGAATCTAGGGA,63,64,1,10,2788,0,0
3973,ACGTCGAATCTAGGGA,63,66,3,11,2789,0,0
3974,ACGTCGAATCTAGGGA,63,63,0,12,2792,0,0
3975,ACGTCGAATCTAGGGA,63,66,3,8,2795,0,0
3976,ACGTCGAATCTAGGGA,63,66,3,11,2798,0,0
3977,ACGTCGAATCTAGGGA,63,66,3,12,2799,0,0
3978,ACGTCGAATCTAGGGA,63,65,2,14,2800,0,0
3979,ACGTCGAATCTAGGGA,63,63,0,11,2801,0,0
3980,ACGTCGAATCTAGGGA,63,63,0,12,2802,0,0
3981,ACGTCGAATCTAGGGA,63,66,3,12,2803,0,0
3982,ACGTCGAATCTAGGGA,63,65,2,11,2804,0,0
3983,AAGTCGAATCTAGGGA,63,66,3,13,2807,0,0
3984,ACGTCGAAGCTAGGAA,63,64,1,14,2809,0,0
3985,ACGTCGAATCTAGGGA,63,66,3,15,2811,0,0
3986,ACGACGAATCTAGGGA,63,66,3,10,2813,0,0
3987,ACGTCGAATCTAGGGA,63,63,0,13,2814,0,0
3988,ACGTCGAATCTAGGGA,63,66,3,11,2815,0,0
3989,ACGTCGAATCTAGGGA,63,66,3,13,2817,0,0
3990,ACGTCGAATCTAGGGA,63,66,3,13,2818,0,0
3991,ACGTCGAATCTAGGGA,63,66,3,13,2821,0,0
3992,ACGTCGAATCTAGGGA,63,66,3,12,2823,0,0
3993,ACGTCGAATCTAGGGA,63,65,2,16,2829,0,0
3994,ACGTCGAATCTAGGGA,63,66,3,14,2830,0,0
3995,AAGTCGAATCTAGGGA,63,66,3,12,2831,0,0
3996,ACGTCGAATCTTGGGA,63,66,3,16,2834,0,0
3997,ACGTCGAATCTAGGGA,63,66,3,13,2835,0,0
3998,ACGTCGAATCTAGGGA,63,65,2,14,2836,0,0
3999,ACGTCGAGTCTAGGGA,63,63,0,13,2837,0,0
4000,ACGTCGAATCTAGGGA,63,65,2,14,2839,0,0
4001,ACGTCGAATCTAGGGA,63,65,2,14,2840,0,0
4002,ACGTCGAATCAAGGGA,63,65,2,13,2843,0,0
4003,ACGTCGAATCTAGGGA,63,66,3,15,2844,0,0
4004,ACGTCGAATCTAGGGA,63,66,3,16,2845,0,0
4005,ACGTCGAATCTAGGGA,63,66,3,14,2847,0,0
4006,ACGTCGAATCTAGGGA,63,66,3,13,2848,0,0
4007,ACGTCGAATCTAGGGA,63,66,3,13,2849,0,0
4008,ACGTCGAATCTAGGGA,63,66,3,12,2850,0,0
4009,ACGTCGAATCTAGGGA,66,81,15,6,57,2,0
4010,ACGTCGAATCTAGGGA,66,75,9,6,86,0,0
4011,ACGTCGAATATAGGGA,66,79,13,8,110,2,0
4012,ACGTCGAATCTAGGGA,66,75,9,7,134,0,0
4013,ACGTCGAATCTAGGGA,66,77,11,8,176,1,0
4014,ACGTCGAATCTAGGGA,66,78,12,9,211,1,0
4015,ACGTCGAATCTAGGGA,66,69,3,13,220,0,0
4016,ACGTCGAATCTAGGGA,66,69,3,8,228,0,0
4017,ACGTCGAATCTAGGGA,66,77,11,8,251,1,0
4018,ACGTCGAATCTAGGGA,66,76,10,8,294,1,0
4019,ACGTCGAATCTAGGGA,66,79,13,8,319,2,0
4020,ACGTCGAATCTAGGGA,66,78,12,11,352,1,0
4021,ACGTCGAATCTAGGGA,66,81,15,9,353,2,0
4022,ACGTCGAATCTAGGGA,66,69,3,9,356,0,0
4023,ACGTCGAATCTAGGGA,66,80,14,9,376,2,0
4024,ACGTCGAATCTAGGGA,66,82,16,8,441,3,0
4025,ACGTCGAATCTAGGGA,66,96,30,8,454,7,0
4026,ACGTCGAATCTATGGA,66,85,19,7,458,4,0
4027,ACGTCGAATCTAGGGA,66,95,29,9,470,7,0
4028,ACGTCGAATCTAGGGA,66,74,8,9,471,0,0
4029,ACGTCGAATCTAGGGA,66,79,13,9,475,2,0
4030,ACGTCGAATCTAGGGA,66,69,3,8,481,0,0
4031,ACGTCGAATCTAGGGA,66,66,0,9,492,0,0
4032,ACGTCGAATCTAGGGA,66,67,1,9,496,0,0
4033,ACGTCGAATCTAGGGA,66,70,4,15,510,0,0
4034,ACGTCGAATCTAGGGA,66,72,6,9,519,0,0
4035,ACGTCGAATCTAGGGA,66,72,6,8,520,0,0
4036,ACGTCGAATCTAGGGA,66,72,6,10,521,0,0
4037,ACGTCGAATCTAGGGA,66,66,0,9,524,0,0
4038,ACGTCGAATCTAGGGA,66,72,6,10,531,0,0
4039,ACGTCGAATCTAGGGA,66,66,0,12,539,0,0
4040,ACGTCGAATCTAGGGA,66,94,28,8,541,7,0
4041,ACGTCGAATCTAGGGA,66,70,4,12,546,0,0
4042,ACGTCGAATCTAGGGA,66,80,14,10,550,2,0
4043,ACGTCGAATCTAGGGA,66,67,1,10,559,0,0
4044,ACGTCGAATCTAGGGA,66,82,16,10,574,3,0
4045,ACGTCGAATCTAGGGA,66,66,0,11,589,0,0
4046,ACGTCGAATCTAGGGA,66,115,49,12,591,14,0
4047,AAGTCGAATCTAGGGA,66,80,14,9,597,2,0
4048,ACGTCGAATCTAGGGA,66,68,2,11,632,0,0
4049,ACGTCGAATCTAGGGA,66,68,2,9,640,0,0
4050,ACGTCGAATCTAGGGA,66,87,21,9,653,4,0
4051,ACGTCGAATCTAGGGA,66,110,44,11,657,12,0
4052,ACGTCGAATCTAGGGA,66,84,18,9,662,3,0
4053,ACGTCGAATCTAGGGA,66,66,0,10,663,0,0
4054,ACGTCGAATCTAGGGA,66,74,8,10,665,0,0
4055,ACGTCGAATCTAGGGA,66,87,21,9,673,4,0
4056,ACGTCGAATCTAGGGA,66,79,13,12,675,2,0
4057,ACGTCGAATCTAGGGA,66,73,7,10,681,0,0
4058,ACGTCGAATCTAGGGA,66,78,12,12,701,1,0
4059,ACGTCGAATCTAGGGA,66,71,5,8,714,0,0
4060,ACGTCGAATCTAGGGA,66,66,0,12,728,0,0
4061,ACGTCGAATCTCGTGA,66,66,0,10,730,0,0
4062,ACGTCGAATCTAGGGA,66,66,0,12,732,0,0
4063,ACGTCGAATCTAGGGA,66,71,5,12,733,0,0
4064,ACGTCGAATCTAGGGA,66,66,0,10,736,0,0
4065,ACGTCGAATCTAGGGA,66,85,19,10,739,4,0
4066,ACGTCGAATCTAGGGA,66,69,3,10,741,0,0
4067,ACGTCGAATCTAGGGA,66,69,3,11,744,0,0
4068,ACGTCGAATCTAGGGA,66,68,2,11,756,0,0
4069,ACGTCGAATCTAGGGA,66,77,11,11,758,0,0
4070,ACGTCGAATCTAGGGA,66,74,8,8,770,0,0
4071,ACGTCGAATCTAGGGA,66,72,6,11,776,0,0
4072,ACGTCGAATCTAGGGA,66,69,3,11,785,0,0
4073,ACGTCGAATCTAGGGA,66,71,5,11,791,0,0
4074,ACGTCGAATCTAGGGA,66,83,17,11,802,2,0
4075,ACGTCGAATCTAGGGA,66,69,3,13,813,0,0
4076,ACGTCGAATCTAGGGA,66,86,20,8,831,3,0
4077,ACGTCGAATCTAGGGA,66,69,3,9,832,0,0
4078,ACGTCGAATCTAGGGA,66,66,0,10,833,0,0
4079,ACGTCGAATCTAGGGA,66,66,0,8,843,0,0
4080,ACGTCGAATCTAGGGC,66,67,1,8,847,0,0
4081,ACGTCGAATCTAGGGA,66,71,5,9,848,0,0
4082,ACGTCGAATCTAGGGA,66,96,30,9,854,7,0
4083,ACGTCGAATCTAGGGA,66,97,31,10,858,7,0
4084,ACGTCGAATCTAGGGA,66,77,11,9,860,0,0
4085,ACGTCGAAGCTAGGAA,66,71,5,11,861,0,0
4086,ACGTCGAATCTAGGGA,66,66,0,9,867,0,0
4087,ACGTCGAATCTAGGGA,66,76,10,9,872,0,0
4088,ACGTCGAATCTAGGGA,66,84,18,12,873,3,0
4089,ACGTCGAATCTAGGGA,66,83,17,11,884,2,0
4090,ACGTCGAATCTAGGGA,66,74,8,11,892,0,0
4091,ACGTCGAATCTAGGGA,66,76,10,12,898,0,0
4092,ACGTCGAATCTAGGGA,66,88,22,13,905,4,0
4093,ACGTCGAATCTAGGGA,66,69,3,9,906,0,0
4094,ACGTAGAATCTAGGGA,66,73,7,11,908,0,0
4095,ACGTCGAATCTAGGGA,66,81,15,9,911,2,0
4096,ACGTCGAATCTAGGGA,66,69,3,9,920,0,0
4097,ACGTCGAATCTAGGGA,66,70,4,10,921,0,0
4098,ACGTCGAATCTAGGGA,66,74,8,11,924,0,0
4099,ACGTCGAATCTAGGGA,66,69,3,10,929,0,0
4100,ACGTCGAATCTAGGGA,66,76,10,10,930,0,0
4101,ACGTCGAATCTAGGGA,66,76,10,11,931,0,0
4102,ACGTCGAATCTAGGGA,66,67,1,9,939,0,0
4103,ACGTCGAATCTAGGGA,66,88,22,9,942,4,0
4104,ACGTCGAATCTAGGGA,66,87,21,11,943,4,0
4105,ACGTCGAATCTAGGGA,66,74,8,10,944,0,0
4106,ACGTCGAATCTAGGGA,66,66,0,10,949,0,0
4107,ACGTCGAATCTAGGGA,66,66,0,10,959,0,0
4108,ACGTCGAATCTAGGGA,66,75,9,11,965,0,0
4109,ACGTCGAATCTAGGGA,66,129,63,13,977,18,0
4110,ACGTCGAATCTAGGGA,66,70,4,9,981,0,0
4111,ACGTCGAATCTAGGGA,66,80,14,7,984,1,0
4112,ACGTAGAATCTAGGGA,66,67,1,11,989,0,0
4113,ACGTCGACTCTCGGGA,66,85,19,11,997,3,0
4114,ACGTCGAATCTAGGGA,66,79,13,10,1002,1,0
4115,ACGTCGAATCTAGGGA,66,66,0,12,1005,0,0
4116,ACGTCGAATCTAGGGA,66,75,9,10,1006,0,0
4117,ACGTCGAATCTAGGGA,66,97,31,12,1012,7,0
4118,ACGTCGAATCTAGGGA,66,66,0,10,1019,0,0
4119,ACGTCGAATCTAGGGA,66,74,8,11,1028,0,0
4120,ACGTCGAATATAGGGA,66,67,1,13,1029,0,0
4121,AGGTCGAATCTAGTGA,66,82,16,11,1040,2,0
4122,ACGTCGAATCTAGGGA,66,70,4,12,1045,0,0
4123,ACGTCGAATCTAGGGA,66,79,13,17,1046,1,0
4124,ACGTCGAATCTAGGGA,66,66,0,11,1048,0,0
4125,ATGTCGAATCTAGGGA,66,77,11,11,1050,0,0
4126,ACGTCGAATCTAGGGA,66,71,5,14,1052,0,0
4127,ACGTCGAATCTAGGGA,66,68,2,10,1058,0,0
4128,ACGTCGAATCTAGGGA,66,71,5,13,1062,0,0
4129,ACGTCGAATCTAGGGA,66,68,2,11,1068,0,0
4130,ACGTCGAATCTAGGGA,66,84,18,12,1072,2,0
4131,ACGTCGAATCTAGGGA,66,73,7,13,1074,0,0
4132,ACGTCGAATCTAGGGA,66,85,19,11,1075,2,0
4133,ACGTCGAATCTAGGGA,66,72,6,12,1083,0,0
4134,ACGTCGAATCGAGGGA,66,68,2,13,1086,0,0
4135,ACGTCGAATCTAGGGA,66,76,10,12,1095,0,0
4136,ACGTCGAATCTAGGGA,66,78,12,12,1097,0,0
4137,ACGTCGAATCTAGGGA,66,74,8,11,1099,0,0
4138,ACGTCGAATCTAGGGA,66,69,3,14,1112,0,0
4139,ACGTCGAATCTAGGGA,66,76,10,12,1113,0,0
4140,ACGTCGAATCTAGGGA,66,116,50,12,1114,13,0
4141,ACGTCGAATCTAGGGA,66,68,2,14,1122,0,0
4142,ACGTCGAATCTAGGGA,66,66,0,6,1125,0,0
4143,ACGTCGAATCTAGGGA,66,71,5,7,1128,0,0
4144,ACGTCGAATCTAGGGA,66,71,5,8,1132,0,0
4145,ACGTCGAGTCTAGGGA,66,77,11,9,1136,0,0
4146,ACGTCGAATCTAGGGA,66,69,3,9,1142,0,0
4147,ACGTCGAATCTAGGGA,66,66,0,9,1144,0,0
4148,ACGTCGAATCTAGGGA,66,82,16,9,1145,1,0
4149,ACGTCGAATCTAGGGA,66,73,7,9,1154,0,0
4150,ACGTCGAATCTAGGGA,66,70,4,9,1156,0,0
4151,ACGTCGAATCTAGGGA,66,77,11,9,1158,0,0
4152,ACGTCGAATCTAGGGA,66,85,19,9,1160,2,0
4153,ACGTCGAATCTAGGGA,66,73,7,12,1162,0,0
4154,ACGTCGAATCTAGGGA,66,72,6,9,1163,0,0
4155,ACGTCGAATCTAGGGA,66,66,0,12,1164,0,0
4156,ACGTCGAATCTAGGGA,66,68,2,10,1167,0,0
4157,ACGTCGAATCTAGGGA,66,73,7,10,1170,0,0
4158,ACGTCGAATCTAGGGA,66,68,2,14,1174,0,0
4159,ACGTCGAATCTAGGGA,66,75,9,11,1178,0,0
4160,ACGTCGAATCTAGGGA,66,68,2,8,1184,0,0
4161,ACGTCGAATCTAGGGA,66,66,0,13,1187,0,0
4162,ACGTCGAATCTAGGGA,66,66,0,8,1193,0,0
4163,ACGTCGAATCTAGGGA,66,69,3,11,1196,0,0
4164,ACGTCGAATCTAGGGA,66,67,1,10,1198,0,0
4165,ACGTCGAATCTAGGGA,66,68,2,9,1200,0,0
4166,ACGTCGAATCTAGGGA,66,73,7,10,1203,0,0
4167,ACGTCGAATCTAGGGA,66,81,15,11,1204,1,0
4168,ACGTCGAATCTAGGGA,66,82,16,10,1207,1,0
4169,ACGTCGAATCTAGGGA,66,66,0,11,1209,0,0
4170,ACGTCGAATCTAGGGA,66,68,2,11,1217,0,0
4171,ACGTCGAATCTAGGGA,66,75,9,11,1219,0,0
4172,ACGTCGAATCTAGGGA,66,75,9,12,1222,0,0
4173,ACGTCGAATCTAGGGA,66,68,2,10,1223,0,0
4174,ACGTCGAATCTAGGGA,66,74,8,9,1225,0,0
4175,ACGTCGACTCTAGGGA,66,75,9,13,1228,0,0
4176,ACGTCGAATCTAGGGC,66,75,9,12,1230,0,0
4177,ACGTCGAATCTAGGGA,66,74,8,11,1234,0,0
4178,ACGTCGAATCTAGGGA,66,69,3,12,1238,0,0
4179,ACGTCGAATCTAGGGA,66,69,3,12,1244,0,0
4180,ACGTCGAATCTAGGGA,66,75,9,10,1248,0,0
4181,ACGTCGAATCTAGGGA,66,75,9,12,1256,0,0
4182,ACGTCGAATCTAGGGA,66,71,5,10,1265,0,0
4183,ACGTCGAATCTAGGGA,66,68,2,12,1271,0,0
4184,ACGTCGAATCTAGGGA,66,75,9,11,1280,0,0
4185,ACGTCGAATCTAGGGA,66,75,9,11,1284,0,0
4186,ACGTCGAATCTAGGGA,66,71,5,9,1288,0,0
4187,ACGTCGAATCTAGGGA,66,67,1,13,1296,0,0
4188,ACGTCGAATCTAGGGA,66,75,9,11,1300,0,0
4189,ACGTCGAATCTAGGGA,66,72,6,12,1304,0,0
4190,ACGTCGAATCTAGGGA,66,69,3,11,1308,0,0
4191,ACGTCGAATCTAGGGA,66,68,2,16,1310,0,0
4192,ACGTCGAATCTAGGGA,66,75,9,11,1316,0,0
4193,ACGTCGAATCTAGGGA,66,75,9,9,1319,0,0
4194,ACGTCGAATCTAGGGA,66,75,9,12,1321,0,0
4195,ACGTCGAATCTAGGGA,66,75,9,12,1324,0,0
4196,ACGTCGAATCTAGGGA,66,73,7,14,1331,0,0
4197,ACGTCGAATCTAGGGA,66,75,9,12,1337,0,0
4198,ACGTCGAATCTAGGGA,66,66,0,13,1339,0,0
4199,ACGTCGAATCTAGGGA,66,66,0,7,1343,0,0
4200,ACGTCGAATCTAGGGA,66,73,7,11,1351,0,0
4201,ACGTCGAATCTAGGGA,66,71,5,9,1352,0,0
4202,ACGTCGAATCTAGGGA,66,72,6,10,1357,0,0
4203,ACGTCGAATCTAGGGA,66,72,6,12,1361,0,0
4204,ACGTCGAATCTAGGGA,66,75,9,11,1364,0,0
4205,ACGTCGAATCTAGGGA,66,73,7,11,1365,0,0
4206,ACGTCGAATCTAGGGA,66,75,9,10,1372,0,0
4207,ACGTCGAATCTAGGGA,66,74,8,13,1376,0,0
4208,CCGTCGAATCTAGGGA,66,68,2,9,1380,0,0
4209,ACGTCGAATCTAGGGA,66,67,1,16,1382,0,0
4210,ACGTCGAATCTAGGGA,66,75,9,13,1391,0,0
4211,ACGTCGAATCTAGGGA,66,74,8,11,1395,0,0
4212,ACGTCGAATCTAGGGA,66,75,9,10,1397,0,0
4213,ACGTCGAATCTAGGGA,66,73,7,12,1400,0,0
4214,ACGTCGAATCTAGGGA,66,75,9,11,1411,0,0
4215,ACGTCGAATCTAGGGA,66,69,3,14,1414,0,0
4216,ACGTCGAATCTAGGGA,66,70,4,10,1416,0,0
4217,ACGTCGAATCTAGGGA,66,68,2,11,1418,0,0
4218,ACGTCGAATCTAGGGA,68,73,5,11,1424,0,0
4219,ACGTCGAATCTAGGGA,68,73,5,10,1427,0,0
4220,ACGTCGAATCTAGGGA,68,71,3,13,1430,0,0
4221,AAGTCGAATCTAGGGA,68,68,0,11,1445,0,0
4222,ACGTCGAATCTAGGGA,68,73,5,12,1446,0,0
4223,ACGTCGAATCTAGGGA,68,73,5,11,1448,0,0
4224,ACGTCGAATCTAGGAA,68,73,5,12,1451,0,0
4225,ACGTCGAATATAGGGA,68,72,4,11,1457,0,0
4226,ACGTCGAATCTAGGGA,68,73,5,11,1461,0,0
4227,ACGTCGAATCTAGGGA,68,69,1,11,1466,0,0
4228,ACGTCGAATCTAGGGA,68,68,0,8,1467,0,0
4229,ACGTCGAATCTAGGGA,68,73,5,11,1470,0,0
4230,ACGTCGAATCTAGGGA,68,72,4,12,1471,0,0
4231,ACGTCGAATCTAGGGA,69,70,1,6,57,0,0
4232,ACGTCGAATCTAGGGA,69,74,5,6,86,0,0
4233,ACGTCGAATCTAGGGA,69,73,4,8,110,0,0
4234,ACGTCGAATCTAGGGA,69,77,8,7,134,0,0
4235,ACGTCGAATCTAGGGA,69,74,5,8,176,0,0
4236,ACGTCGAATCTAGGGA,69,86,17,9,211,2,0
4237,ACGTCGAATCTAGGGA,69,75,6,13,220,0,0
4238,ACGTCGAATCTAGGGA,69,91,22,8,294,4,0
4239,ACGTCGAATCTAGGGA,69,92,23,8,319,4,0
4240,ACGTCGAATCTAGGGA,69,73,4,9,353,0,0
4241,ACGTCGAATCTAGGGA,69,72,3,9,356,0,0
4242,ACGTCGAATCTAGGGA,69,75,6,9,376,0,0
4243,ACGTCGAATCTAGGGA,69,73,4,8,441,0,0
4244,ACGTCGAATCTAGGGA,69,74,5,8,454,0,0
4245,ACGTCGAATCTAGGGA,69,72,3,7,458,0,0
4246,ACGTCGAATCTAGGGA,69,74,5,9,470,0,0
4247,ACGTCGAATCTAGGGA,69,70,1,9,471,0,0
4248,ACGTCGAATCTAGGGA,69,71,2,8,481,0,0
4249,ACGTCGAATCTAGGGA,69,72,3,9,492,0,0
4250,ACGTCGAATCTAGGGA,69,74,5,9,496,0,0
4251,ACGTCGAATCTAGGGA,69,74,5,15,510,0,0
4252,ACGTCGAATCTAGGGA,69,70,1,9,519,0,0
4253,ACGTCGAATCTAGGGA,69,69,0,8,520,0,0
4254,ACGTCGAATCTAGGGA,69,69,0,10,521,0,0
4255,ACGTCGAATCTAGGGA,69,74,5,9,524,0,0
4256,ACGTCGAATCTAGGGA,69,69,0,10,531,0,0
4257,ACGTCGAATCTAGGGA,69,74,5,12,539,0,0
4258,ACGTCGAATCTAGGGA,69,74,5,12,546,0,0
4259,ACGTCGAATCTAGGGA,69,74,5,10,559,0,0
4260,ACGTCGAATCTAGGGA,69,74,5,10,574,0,0
4261,ACGTCGAATCTAGGGA,69,71,2,11,589,0,0
4262,ACGTCGAATCTAGGGA,69,73,4,12,591,0,0
4263,AAGTCGAATCTAGGGA,69,69,0,9,597,0,0
4264,ACGTCGAATCTAGGGA,69,73,4,11,632,0,0
4265,ACGTCGAATCTAGGGA,69,70,1,9,640,0,0
4266,ACGTCGAATCTAGGGA,69,74,5,10,663,0,0
4267,ACGTCGAATCTAGGGA,69,74,5,10,665,0,0
4268,ACGTCGAATCTAGGGA,69,74,5,10,681,0,0
4269,ACGTCGAATCTAGGGA,69,72,3,8,714,0,0
4270,ACTTCGAATCTAGGGA,69,71,2,12,728,0,0
4271,ACGTCGCATCTAGTGA,69,74,5,10,730,0,0
4272,ACGTCGAATCTAGGGA,69,74,5,10,739,0,0
4273,ACGTCGAATCTAGGGA,69,69,0,10,741,0,0
4274,ACGTCGAATCTAGGGA,69,74,5,11,744,0,0
4275,ACGTCGAATCTAGGGA,69,71,2,11,756,0,0
4276,ACGTCGAATCTAGGGA,69,74,5,11,758,0,0
4277,ACGTCGAATCTAGGGA,69,70,1,11,791,0,0
4278,ACGTCGAATCTAGGGA,69,74,5,11,802,0,0
4279,ACGTCGAATCTAGGGA,69,70,1,13,813,0,0
4280,ACGTCGAATCTAGGGA,69,74,5,8,831,0,0
4281,ACGTCGAATCTAGGGA,69,74,5,9,832,0,0
4282,ACGTCGAATCTAGGGA,69,71,2,10,833,0,0
4283,ACGTCGAATCTAGGGA,69,74,5,9,848,0,0
4284,ACGTCGAATCTAGGGA,69,70,1,9,854,0,0
4285,ACGTCGAATCTAGGGA,69,72,3,10,858,0,0
4286,ACGTCGAATCTAGGGA,69,73,4,9,867,0,0
4287,ACGTCGAATCTAGGGA,69,69,0,9,872,0,0
4288,ACGTCGAATCTAGGGA,69,74,5,12,873,0,0
4289,ACGTCGAATCTAGGGA,69,74,5,11,884,0,0
4290,ACGTCGAATCTAGGGA,69,74,5,11,892,0,0
4291,ACGTCGAATCTAGGGA,69,74,5,12,898,0,0
4292,ACGTCGAATCTAGGGA,69,74,5,13,905,0,0
4293,ACGTCGAATCTAGGGA,69,74,5,9,906,0,0
4294,ACGTAGAATCTAGGGA,69,74,5,11,908,0,0
4295,ACGTCGAATCTAGGGA,69,74,5,9,911,0,0
4296,ACGTCGAATCTAGGGA,69,74,5,9,920,0,0
4297,ACGTCGAATCTAGGGA,69,73,4,10,929,0,0
4298,ACGTCGAATCTAGGGA,69,74,5,11,931,0,0
4299,ACGTCGAATCTAGGGA,69,74,5,9,939,0,0
4300,ACGTCGAATCTAGGGA,69,74,5,9,942,0,0
4301,ACGTCGAATCTAGGGA,69,74,5,10,944,0,0
4302,ACGTCGAATCTAGGGA,69,74,5,10,949,0,0
4303,ACGTCGAATCTAGGGA,69,74,5,11,965,0,0
4304,ACGTCGAATCTAGGGA,69,72,3,13,977,0,0
4305,ACGTCGAATCTAGGGA,69,74,5,9,981,0,0
4306,ACGTCGAATCTAGGGA,69,73,4,7,984,0,0
4307,ACGTAGAATCTAGGGA,69,71,2,11,989,0,0
4308,ACGTCGAATCTCGGGA,69,74,5,11,997,0,0
4309,ACGTCGAATCTAGGGA,69,74,5,10,1002,0,0
4310,ACGTCGAATCTAGGGA,69,72,3,10,1006,0,0
4311,ACGTCGAATCTAGGGA,69,72,3,10,1019,0,0
4312,AGGTCGAATCTAGTGA,69,72,3,11,1040,0,0
4313,ACGTCGAATCTAGGGA,69,72,3,17,1046,0,0
4314,ACGTCGAATCTAGGGA,69,69,0,11,1048,0,0
4315,ACGTCGAATCTAGGGA,69,69,0,11,1050,0,0
4316,ACGTCGAATCTAGGGA,69,70,1,14,1052,0,0
4317,ACGTCGACTCTAGGGA,69,70,1,10,1058,0,0
4318,ACGTCGAATCTAGGGA,69,72,3,13,1062,0,0
4319,ACGTCGAATCTAGGGA,69,72,3,11,1068,0,0
4320,ACGTCGAATCTAGGGA,69,72,3,12,1072,0,0
4321,ACGTCGAATCTAGGGA,69,72,3,11,1075,0,0
4322,ACGTCGAATCTAGGGA,69,70,1,12,1083,0,0
4323,ACGTCGAATCTAGGGA,69,72,3,13,1086,0,0
4324,ACGTCGAATCTAGGGT,69,72,3,12,1095,0,0
4325,ACGTCGAATCTAGGGA,69,70,1,12,1097,0,0
4326,ACGTCGAATCTAGGGA,69,72,3,11,1099,0,0
4327,ACGTCGAATCTAGGGA,69,72,3,14,1112,0,0
4328,ACGTCGAATCTAGGGA,69,72,3,12,1114,0,0
4329,ACGTCGAATCTAGGGA,69,72,3,14,1122,0,0
4330,ACGTCGAATCTAAGGA,69,71,2,6,1125,0,0
4331,ACGTCGAATCTAGGGA,69,72,3,7,1128,0,0
4332,ACGTCGAATCTAGGGA,69,72,3,8,1132,0,0
4333,ACGTCGAGTCTAGGGA,69,72,3,9,1136,0,0
4334,ACGTCGAATCTAGGGA,69,69,0,9,1154,0,0
4335,ACGTCGAATCTAGGGA,69,72,3,9,1158,0,0
4336,ACGTCGAATCTAGGGA,69,71,2,12,1162,0,0
4337,ACGTCGAATCTAGGGA,69,72,3,9,1163,0,0
4338,ACGTCGAATCTAGGGA,69,72,3,12,1164,0,0
4339,ACGTCGAATCTAGGGA,69,72,3,10,1167,0,0
4340,ACGTCGAATCTAGGGA,69,71,2,10,1170,0,0
4341,ACGTCGAATCTAGGGA,69,72,3,14,1174,0,0
4342,ACGTCGAATCTAGGGA,69,72,3,11,1178,0,0
4343,ACGTCGAATCTAGGGA,69,72,3,8,1184,0,0
4344,ACGTCGAATCTAGGGA,69,72,3,13,1187,0,0
4345,ACGTCGAATCTAGGGA,69,70,1,8,1193,0,0
4346,ACGTCGAATCTAGGGA,69,72,3,10,1198,0,0
4347,ACGTCGAATCTAGGGA,69,72,3,9,1200,0,0
4348,ACGTCGAATCTAGGGA,69,72,3,10,1203,0,0
4349,ACGTCGAATCTAGGGA,69,71,2,11,1204,0,0
4350,ACGTCGAATCTAGGGA,69,72,3,10,1207,0,0
4351,ACGTCGAATCTAGGGA,69,69,0,11,1209,0,0
4352,ACGTCGAATCTAGGGA,69,72,3,11,1217,0,0
4353,ACGTCGAATCTAGGGA,69,72,3,11,1219,0,0
4354,ACGTCGAATCTAGGGA,69,72,3,12,1222,0,0
4355,ACGTCGAATCTAGGGA,69,72,3,9,1225,0,0
4356,ACGTCGAATCTAGGGA,69,71,2,13,1228,0,0
4357,ACGTCGAATCTAGGGC,69,69,0,12,1230,0,0
4358,ACGTCGAATCTAGGGA,69,69,0,11,1234,0,0
4359,ACGTCGAATCTAGGGA,69,72,3,12,1238,0,0
4360,ACGTCGAATCTAGGGA,69,71,2,12,1244,0,0
4361,ACGTCGAATCTAGGGA,69,72,3,10,1248,0,0
4362,ACGTCGAATCTAGGGA,69,72,3,12,1256,0,0
4363,ACGTCGAATCTAGGGA,69,72,3,10,1265,0,0
4364,ACGTCGAATCTAGGGA,69,72,3,12,1271,0,0
4365,ACGTCGAAGCTAGGGA,69,72,3,9,1288,0,0
4366,ACGTCGAATCTAGGGA,69,70,1,12,1304,0,0
4367,ACGTCGAATCTAGGGA,69,72,3,11,1308,0,0
4368,ACGTCGAATCTAGGGA,69,72,3,16,1310,0,0
4369,ACGTCGAATCTAGGGA,69,72,3,11,1316,0,0
4370,ACGTCGAATCTAGGGA,69,72,3,9,1319,0,0
4371,ACGTCGAATCTAGGGA,69,72,3,12,1324,0,0
4372,ACGTCGAATCTAGGGA,69,72,3,12,1337,0,0
4373,ACGTCGAATCTAGGGA,69,72,3,11,1351,0,0
4374,ACGTCGAATCTAGGGA,69,69,0,10,1357,0,0
4375,ACGTCGAATCTAGGGA,69,71,2,12,1361,0,0
4376,ACGTCGAATCTAGGGA,69,72,3,11,1364,0,0
4377,ACGTCGAATCTAGGGA,69,72,3,10,1372,0,0
4378,ACGTCGAATCTAGGGA,69,72,3,13,1376,0,0
4379,ACGTCGAATCTAGGGA,69,72,3,11,1395,0,0
4380,ACGTCGAATCTAGGGA,69,72,3,11,1411,0,0
4381,ACGTCGAATCTAGGGA,69,72,3,14,1414,0,0
4382,ACGTCGAATCTAGGGA,69,72,3,10,1416,0,0
4383,ACGTCGAATCTAGGGA,69,72,3,11,1418,0,0
4384,ACGTCGAATCTAGGGA,70,79,9,14,1474,0,0
4385,ACGTCGAATCTAGGGA,70,75,5,12,1476,0,0
4386,ACGTCGAATCTAGGGA,70,85,15,13,1478,2,0
4387,ACGTCGAATCTAGGGA,70,92,22,12,1490,5,0
4388,ACGTCGATTCTAGGGA,70,75,5,13,1493,0,0
4389,ACGTCGAATCTAGGGA,70,70,0,14,1496,0,0
4390,ACGTCGAATCTAGGGA,70,77,7,13,1504,0,0
4391,ACGTCGAATCTAGGGA,70,81,11,12,1506,1,0
4392,ACGTCGAATCTAGGGA,70,73,3,12,1510,0,0
4393,ACGTCGAATCTAGGGA,70,78,8,13,1519,0,0
4394,ACGTCGAATCTAGGGA,70,74,4,13,1521,0,0
4395,ACGTCGAATCTAGGGA,70,90,20,14,1526,4,0
4396,ACGTCGAATCTAGGGA,70,71,1,15,1530,0,0
4397,ACGTCGAATCTAGGGA,70,84,14,13,1533,2,0
4398,ACGTCGAATCTAGGGA,70,78,8,12,1547,0,0
4399,ACGTCGAATCTAGGGA,70,70,0,7,1550,0,0
4400,ACGTCGAATCTAGGGA,70,70,0,9,1551,0,0
4401,ACGTCGAATCTAGGGA,70,70,0,10,1552,0,0
4402,ACGTCGAATCTAGGGA,70,87,17,14,1553,3,0
4403,ACGTCGAATCTAGGGA,71,73,2,11,1424,0,0
4404,ACGTCGAATCTAGGGA,71,73,2,10,1427,0,0
4405,ACGTCGAATCTAGGGA,71,78,7,13,1430,0,0
4406,AAGTCGAATCTAGGGA,71,75,4,11,1445,0,0
4407,ACGTCGAATCTAGGGA,71,78,7,11,1448,0,0
4408,ACGTCGAATCTAGGGA,71,76,5,12,1451,0,0
4409,ACGTCGAATATAGGGA,71,75,4,11,1457,0,0
4410,ACGTCGAATCTAGGGA,71,73,2,11,1461,0,0
4411,ACGTCGAATCTAGGGA,71,84,13,8,1467,2,0
4412,ACGTCGAATCTAGGGA,71,94,23,11,1470,6,0
4413,ACGTCGAATCTAGGGA,71,88,17,12,1471,4,0
4414,ACGTCGAATCTAGGGA,72,73,1,6,57,0,0
4415,ACGTCGAATCTAGGGA,72,72,0,8,110,0,0
4416,ACGTCGAATCTAGGGA,72,74,2,7,134,0,0
4417,ACGTCGACTCTAGGGA,72,81,9,8,176,2,0
4418,ACGTCGAATCTAGGGA,72,75,3,13,220,0,0
4419,ACGTCGAATCTAGGGA,72,86,14,8,294,3,0
4420,ACGTCGAATCTAGGGA,72,94,22,9,353,6,0
4421,ACGTCGAATCTAGGGA,72,73,1,9,356,0,0
4422,ACGTCGAATCTAGGGA,72,109,37,9,376,11,0
4423,ACGTCGAATCTAGGGA,72,73,1,7,458,0,0
4424,ACGTCGAATCTAGGGA,72,79,7,9,470,1,0
4425,ACGTCGAATCTAGGGA,72,73,1,8,481,0,0
4426,ACGTCGAATCTAGGGA,72,73,1,9,492,0,0
4427,ACGTCGAATCTAGGGA,72,73,1,9,496,0,0
4428,ACGTCGAATCTAGGGA,72,73,1,15,510,0,0
4429,ACGTCGAATCTAGGGA,72,83,11,10,521,2,0
4430,ACGTCGAATCTAGGGA,72,80,8,10,531,1,0
4431,ACGTCGAATCTAGGGA,72,77,5,12,539,0,0
4432,ACGTCGAATCTAGGGA,72,91,19,12,546,5,0
4433,ACGTCGAATCTAGGGA,72,72,0,10,574,0,0
4434,ACGTCGAATCTAGGGA,72,73,1,11,589,0,0
4435,ACGTTGAATCTAGGGA,72,72,0,12,591,0,0
4436,ACGTCGAATCTAGGGA,72,97,25,11,632,7,0
4437,ACGTCGAATCTAGGGA,72,80,8,9,640,1,0
4438,ACGTCGAATCTAGGGA,72,90,18,10,681,5,0
4439,ACGTCGAATCTAGGGA,72,72,0,12,728,0,0
4440,ACGTCGAATCTAGTGA,72,73,1,10,730,0,0
4441,ACGTCGAATCTAGGGA,72,74,2,10,741,0,0
4442,ACGTCGAATCTAGGGT,72,79,7,11,744,1,0
4443,ACGTCGAATCTAGGGA,72,75,3,11,756,0,0
4444,ACGTCGAATCTAGGGA,72,80,8,11,802,1,0
4445,ACGTCGAATCTAGGGA,72,73,1,13,813,0,0
4446,ACGTCGAATCTAGGGA,72,73,1,8,831,0,0
4447,ACGTCGAATCTAGGGA,72,100,28,9,832,8,0
4448,ACGTCGAATCTAGGGA,72,77,5,10,833,0,0
4449,ACGTCGAATCTAGGGA,72,74,2,9,848,0,0
4450,ACGTCGAATCTAGGGA,72,74,2,10,858,0,0
4451,ACGTCGAATCTAGGGA,72,75,3,9,867,0,0
4452,ACGTCGAATCTAGGGA,72,72,0,9,872,0,0
4453,ACGTCGAATCTAGGGA,72,80,8,12,873,1,0
4454,ACGTCGAATCTAGGGA,72,84,12,13,905,3,0
4455,ACGTCGAATCTAGGGA,72,76,4,9,906,0,0
4456,ACGTAGAATCTAGGGA,72,80,8,11,908,1,0
4457,ACGTCGAATCTAGGGA,72,86,14,10,929,2,0
4458,ACGTCGAATCTAGGGA,72,82,10,11,965,1,0
4459,ACGTCGAATCTAGGGA,72,73,1,13,977,0,0
4460,ACGTCGAATCTAGGGA,72,72,0,9,981,0,0
4461,ACGTCGAATCTAGGGA,72,79,7,7,984,0,0
4462,ACGTAGAATCTAGGGA,72,87,15,11,989,2,0
4463,ACGTCGAATCTCGGGA,72,80,8,11,997,0,0
4464,ACGTCGAATCTAGGGA,72,97,25,10,1006,6,0
4465,ACGTCGAATCTAGGGA,72,74,2,10,1019,0,0
4466,AGGTCGAATCTAGTGA,72,79,7,11,1040,0,0
4467,ACGTCGAATCTAGGGA,72,77,5,17,1046,0,0
4468,ACGTCGAATCTAGGGA,72,75,3,11,1050,0,0
4469,ACGTCGAATCTAGGGA,72,75,3,14,1052,0,0
4470,ACGTCGAATCTAGGGA,72,72,0,13,1062,0,0
4471,ACGTCGAATCTAGGGA,72,74,2,12,1072,0,0
4472,ACGTCGAATCTAGGGA,72,75,3,11,1075,0,0
4473,ACGTCGAATCTAGGGA,72,75,3,12,1083,0,0
4474,ACGTCGAATCTAGGGA,72,75,3,13,1086,0,0
4475,ACGTCGAATCTAGGGA,72,75,3,12,1095,0,0
4476,ACGTCGAATCTAGGGA,72,75,3,11,1099,0,0
4477,ACGTCGAATCTAGGGA,72,75,3,14,1112,0,0
4478,ACGTCGAATCTAGGGA,72,75,3,14,1122,0,0
4479,ACGTCGAATCTAGGGA,72,74,2,7,1128,0,0
4480,ACGTCGAATCTAGGGA,72,73,1,8,1132,0,0
4481,ACGTCGAGTCTAGGGA,72,75,3,9,1136,0,0
4482,ACGTCGAATCTAGGGA,72,75,3,9,1154,0,0
4483,ACGTCGAATCTAGGGA,72,74,2,9,1158,0,0
4484,ACGTCGAATCTAGGGA,72,74,2,12,1162,0,0
4485,ACGTCGAATCTAGGGA,72,73,1,9,1163,0,0
4486,ACGTCGAATCTAGGGA,72,75,3,14,1174,0,0
4487,ACGTCGAATCTAGGGA,72,73,1,11,1178,0,0
4488,ACGTCGAATCTAGGGA,72,72,0,8,1184,0,0
4489,ACGTCGAATCTAGGGA,72,75,3,13,1187,0,0
4490,AAGTCGAATCTAGGGA,72,75,3,8,1193,0,0
4491,ACGTCGAATCTAGGGA,72,75,3,9,1200,0,0
4492,ACGTCGAATCTAGGGA,72,75,3,10,1203,0,0
4493,ACGTCGAATCTAGGGA,72,75,3,11,1204,0,0
4494,ACGTCGAATCTAGGGA,72,75,3,10,1207,0,0
4495,ACGTCGAATCTAGGGA,72,73,1,11,1209,0,0
4496,ACGTCGAAGCTAGGGA,72,75,3,11,1217,0,0
4497,ACGTCGAATCTAGGGA,72,75,3,11,1219,0,0
4498,ACGTCGAATCTAGGGA,72,75,3,12,1222,0,0
4499,ACGTCGAATCTAGGGA,72,73,1,9,1225,0,0
4500,ACGTCGAATCTAGGGA,72,75,3,13,1228,0,0
4501,ACGTCGAATCTAGGGC,72,75,3,12,1230,0,0
4502,ACGTCGAATCTAGGGA,72,75,3,11,1234,0,0
4503,ACGTCGAATCTAGGGA,72,75,3,12,1238,0,0
4504,ACGTCGAATCTAGGGA,72,75,3,12,1244,0,0
4505,ACGTCGAATCTAGGGA,72,72,0,10,1248,0,0
4506,ACGTCGAATCTAGGGA,72,75,3,10,1265,0,0
4507,ACGTCGAATCTAGGGA,72,75,3,9,1288,0,0
4508,ACGTCGAATCTAGGGA,72,75,3,11,1316,0,0
4509,ACGTCGAATCTAGGGA,72,75,3,9,1319,0,0
4510,ACGTCGAATCTAGGGA,72,75,3,12,1324,0,0
4511,ACGTCGAATCTAGGGA,72,73,1,12,1337,0,0
4512,ACGTCGAATCTAGGGA,72,75,3,11,1351,0,0
4513,ACGTCCAATCTAGGGA,72,75,3,12,1361,0,0
4514,ACGTCGAATCTAGGGA,72,72,0,11,1364,0,0
4515,ACGTCGAATCTAGGGA,72,75,3,13,1376,0,0
4516,ACGTCGAATCTAGGGA,72,75,3,11,1395,0,0
4517,ACGTCGAATCTAGGGA,72,75,3,11,1411,0,0
4518,ACGTCGAATCTAGGGA,72,75,3,11,1418,0,0
4519,ACGTCGAATCTAGGGA,72,75,3,11,1557,0,0
4520,ACGTCGAATCTAGGGA,72,72,0,10,1561,0,0
4521,ACGTCGAATCTAGGGA,72,75,3,9,1562,0,0
4522,ACGTCGAATCTAGGGA,72,75,3,9,1567,0,0
4523,ACGTCGAATCTAGGGA,72,75,3,9,1568,0,0
4524,ACGTCGAATCTAGGGA,72,75,3,9,1570,0,0
4525,GCGTCGAATCTAGGGA,72,75,3,9,1583,0,0
4526,ACGTCGAATCTAGGGA,72,74,2,9,1589,0,0
4527,ACGTCGATTCTAGGGA,72,75,3,10,1593,0,0
4528,ACGTCGAATCTAGGGA,72,75,3,10,1600,0,0
4529,ATGTCGAATCTAGGGA,72,75,3,11,1604,0,0
4530,ACGTCGAATCTAGGGA,72,75,3,11,1618,0,0
4531,ACGTCGAATCTAGGGA,72,75,3,11,1623,0,0
4532,ACGTCGAATCTAGGGA,72,73,1,13,1627,0,0
4533,ACGTCGAATCTAGGGA,72,75,3,11,1629,0,0
4534,ACGTCGAATCTAGGGA,72,74,2,11,1633,0,0
4535,ACGTCGAATCTAGGGA,72,75,3,12,1640,0,0
4536,ACGTCGAATCTAGGGA,72,75,3,7,1642,0,0
4537,ACGTCGAATCTAGGGA,72,73,1,10,1646,0,0
4538,ACGTCGAATCTAGGGA,72,75,3,13,1651,0,0
4539,ACGTCGAATCTAGGGA,72,75,3,12,1653,0,0
4540,ACGTCGAATCTAGGGA,72,75,3,11,1655,0,0
4541,ACGTCGAATCTAGGGA,72,75,3,12,1659,0,0
4542,ACGTCGAATCTAGGGA,72,73,1,11,1665,0,0
4543,ACGTCGAATCTAGGGA,72,75,3,11,1679,0,0
4544,ACGTCGAATCTAGGGA,72,75,3,12,1686,0,0
4545,ACGTCGAATCTAGGGA,72,75,3,13,1687,0,0
4546,ACGTCGAATCTAGGGA,72,75,3,10,1688,0,0
4547,ACGTCGAATCTAGGGA,72,73,1,12,1700,0,0
4548,ACGTCGAATCTAGGGA,72,73,1,9,1706,0,0
4549,ACGTCGAATCTAGGGA,72,75,3,9,1713,0,0
4550,ACGTCGAATCTAGGGA,72,75,3,13,1731,0,0
4551,ACGTCGAATCTAGGGA,72,72,0,13,1741,0,0
4552,ACGTCGAATCTAGGGA,72,75,3,9,1749,0,0
4553,ACGTCGAATCTAGGGA,72,75,3,11,1760,0,0
4554,ACGTCGAATCTAGGGA,72,75,3,10,1761,0,0
4555,ACGTCGAATCTAGGGA,72,75,3,11,1764,0,0
4556,ACGTCGAATCTAGGGA,72,75,3,13,1766,0,0
4557,ACGTCGAATCTAGGGG,72,75,3,11,1767,0,0
4558,ACGTCGAATCTAGGGA,72,75,3,12,1769,0,0
4559,ACGTCGAAGCTAGGAA,72,75,3,14,1774,0,0
4560,CCGTCGAATCTAGGGA,72,75,3,18,1776,0,0
4561,ACGTCGAATCTAGGGA,72,75,3,8,1780,0,0
4562,ACGTCGAATCTAGGGA,73,89,16,14,1474,3,0
4563,ACGTCGAATCTAGGGA,73,90,17,12,1476,3,0
4564,ACGTCTAATCTAGGGA,73,96,23,13,1478,5,0
4565,ACGTCGAATCTAGGGA,73,77,4,12,1490,0,0
4566,ACGTCGAATCTAGGGA,73,75,2,14,1496,0,0
4567,ACGTCGAATCTAGGGA,73,98,25,13,1504,6,0
4568,ACGTCGAATCTAGGGA,73,75,2,12,1506,0,0
4569,ACGTCGAATCTAGGGA,73,73,0,13,1519,0,0
4570,ACGTCGAATCTAGGGA,73,77,4,13,1521,0,0
4571,ACGTCGAATCTAGGGA,73,73,0,14,1526,0,0
4572,ACGTCGAATCTAGGGA,73,74,1,12,1547,0,0
4573,ACGTCGAATCTAGGGA,73,76,3,7,1550,0,0
4574,ACGTCGAATCTAGGGA,73,76,3,9,1551,0,0
4575,ACGTCGAATCTAGGGA,73,84,11,10,1552,1,0
4576,ACGTCGAATCTAGGGA,73,81,8,14,1553,0,0
4577,ACGTCGAATCTAGGGA,74,78,4,11,1424,0,0
4578,ACGTCGAATCTAGGGA,74,83,9,10,1427,1,0
4579,ACGTCGAATCTAGGGA,74,88,14,13,1430,3,0
4580,ACGTCGAATCTAGGGA,74,76,2,11,1448,0,0
4581,ACGTCGAATCTAGGGA,74,76,2,12,1451,0,0
4582,ACGTCGAATATAGGGA,74,102,28,11,1457,7,0
4583,ACGTCGAATCTAGGGA,74,85,11,11,1461,2,0
4584,ACGTCGAATCTAGGGA,74,75,1,8,1467,0,0
4585,ACGTCGAATCTAGGGA,74,75,1,12,1471,0,0
4586,ACGTCGAATCTAGGGA,74,75,1,11,1788,0,0
4587,ACGTCGAATCTAGGGA,74,87,13,14,1794,2,0
4588,ACGTCGAATCTAGGGA,74,80,6,12,1800,0,0
4589,ACGTCGAATCTAGGGA,74,80,6,11,1818,0,0
4590,ACGTCGAATCTAGGGA,74,77,3,14,1822,0,0
4591,ACGTCGAATCTAGGGA,74,87,13,14,1833,2,0
4592,ACGTCGAATCTAGGGA,74,76,2,15,1842,0,0
4593,ACGTCGAATCTAGGGA,74,83,9,9,1854,1,0
4594,ACGTCGAATCTAGGGA,74,96,22,10,1860,5,0
4595,ACGTCGAATCTAGGGA,74,75,1,9,1866,0,0
4596,ACGTCGAATCTAGGGA,74,104,30,11,1881,8,0
4597,ACGTCGAATCTAGGGA,74,80,6,12,1916,0,0
4598,ACGTCGAATCTAGGGA,74,80,6,17,1919,0,0
4599,ACGTCGAATCTAGGGA,74,88,14,12,1922,2,0
4600,ACGTCGAATCTAGGGA,74,103,29,13,1925,7,0
4601,ACGTCGAATCTAGGGA,74,78,4,13,1935,0,0
4602,AAGTCGAATCTAGGGA,74,77,3,11,1938,0,0
4603,ACGTCGAATCTAGGGA,75,83,8,6,57,1,0
4604,ACGTCGAATCTAGGGA,75,76,1,8,110,0,0
4605,ACGTCGAATCTAGGGA,75,88,13,7,134,2,0
4606,ACGTCGAATCTAGGGA,75,80,5,13,220,0,0
4607,ACGTCGAATCTAGGGA,75,79,4,8,294,0,0
4608,ACGTCGAATCTAGGGA,75,80,5,9,356,0,0
4609,ACGTCGAATCTAGGGA,75,86,11,9,376,2,0
4610,ACGTCGAATGTAGGGA,75,85,10,7,458,1,0
4611,ACGTCGAATCTAGGGA,75,79,4,9,470,0,0
4612,ACGTCGAATCTAGGGA,75,77,2,8,481,0,0
4613,ACGTCGAATCTAGGGA,75,84,9,10,521,1,0
4614,ACGTCGAATCTAGGGA,75,86,11,10,531,2,0
4615,ACGTCGAATCTAGGGA,75,81,6,12,539,0,0
4616,ACGTCGAATCTAGGGA,75,89,14,12,546,3,0
4617,ACGTCGAATCTAGGGA,75,84,9,10,574,1,0
4618,ACGTCGAATCTAGGGA,75,77,2,12,591,0,0
4619,ACGTCGAATCTAGGGA,75,77,2,11,632,0,0
4620,ACGTCGAATCTAGGGA,75,86,11,10,681,2,0
4621,ACGTCGAATCTAGGGA,75,76,1,12,728,0,0
4622,ACGTCGAATCTAGTGA,75,81,6,10,730,0,0
4623,ACGTCGAATCTAGGGA,75,89,14,10,741,2,0
4624,ACGTCGAATCTAGGGA,75,103,28,11,756,7,0
4625,ACGTCGAATCTAGGGA,75,93,18,8,831,3,0
4626,ACGTCGAATCTAGGGA,75,85,10,9,848,1,0
4627,ACGTCGAATCTAGGGA,75,104,29,10,858,7,0
4628,ACGTCGAATCTAGGGA,75,76,1,9,867,0,0
4629,ACGTCGAATCTAGGGA,75,77,2,12,873,0,0
4630,ACGTCGAATCTAGGGA,75,79,4,13,905,0,0
4631,ACGTCGAATCTAGGGA,75,82,7,9,906,0,0
4632,ACGTAGAATCTAGGGA,75,100,25,11,908,6,0
4633,ACGTCGAATCTAGGGA,75,96,21,10,929,4,0
4634,ACGTCGAATCTAGGGA,75,79,4,11,965,0,0
4635,ACGTCGAATCTAGGGA,75,84,9,9,981,0,0
4636,ACGTAGAATCTAGGGA,75,76,1,11,989,0,0
4637,ACGTCGAATCTCGGGA,75,78,3,11,997,0,0
4638,ACGTCGAATCTAGGGA,75,102,27,10,1006,6,0
4639,ACGTCGAATCTAGGGA,75,89,14,10,1019,2,0
4640,ACGTCGAATCTAGGGA,75,89,14,17,1046,2,0
4641,ACGTCGAATCTAGGGA,75,84,9,11,1050,0,0
4642,ACGTCGAATCTAGGGA,75,78,3,14,1052,0,0
4643,ACGTCGAATCTAGGGA,75,77,2,13,1062,0,0
4644,ACGTCGAATCTAGGGA,75,77,2,11,1075,0,0
4645,ACGTCGAATCTAGGGA,75,78,3,12,1083,0,0
4646,ACGTCGAATCTAGGGA,75,92,17,13,1086,3,0
4647,ACGTCGAATCTAGGGA,75,95,20,12,1095,4,0
4648,ACGTCGAATCTAGGGA,75,88,13,14,1112,2,0
4649,ACGTCGAATCTAGGGA,75,78,3,14,1122,0,0
4650,ACGTCGAATCTAGGGA,75,77,2,8,1132,0,0
4651,ACGTCGAGTCTAGGGA,75,75,0,9,1136,0,0
4652,ACGTCGAATCTAGGGA,75,95,20,9,1163,4,0
4653,ACGTCGAATCTAGGGA,75,98,23,14,1174,5,0
4654,ACGTCGAATCTAGGGA,75,76,1,8,1184,0,0
4655,ACGTCGAATCTAGGGA,75,77,2,13,1187,0,0
4656,ACGTCGAATCTAGGGA,75,76,1,8,1193,0,0
4657,ACGTCGAATCTAGGGA,75,75,0,10,1203,0,0
4658,ACGTCGAATCTAGGGA,75,79,4,10,1207,0,0
4659,ACGTCGAATCTAGGGA,75,76,1,11,1209,0,0
4660,ACGTCGAATCTAGGGA,75,84,9,12,1222,0,0
4661,ACGTCGAATCTAGGGC,75,77,2,12,1230,0,0
4662,ACGTCGAATCTAGGGA,75,85,10,12,1238,1,0
4663,ACGTCGAATCTAGGGA,75,76,1,12,1244,0,0
4664,ACGTCGAATCTAGGGA,75,96,21,10,1248,4,0
4665,ACGTCGAATCTAGGGA,75,79,4,9,1288,0,0
4666,ACGTCGAATCTAGGGA,75,76,1,11,1316,0,0
4667,ACGTCGAATCTAGGGA,75,75,0,9,1319,0,0
4668,ACGTCGAATCTAGGGA,75,82,7,12,1337,0,0
4669,ACGTCGAATCTAGGGA,75,83,8,11,1351,0,0
4670,ACGTCGAATCTAGGGA,75,83,8,12,1361,0,0
4671,ACGTCGAATCTAGGGA,75,79,4,13,1376,0,0
4672,ACGTCGAATCTAGGGA,75,75,0,11,1395,0,0
4673,ACGTCGAATCTAGGGA,75,76,1,11,1411,0,0
4674,ACGTCGAATCTAGGGA,75,78,3,11,1418,0,0
4675,ACGTCGAATCTAGGGA,75,78,3,11,1557,0,0
4676,ACGTCGAATCTAGGGA,75,78,3,10,1561,0,0
4677,ACGTCGAATCTAGGGA,75,76,1,9,1562,0,0
4678,ACGTCGAATCTAGGGA,75,76,1,9,1567,0,0
4679,ACGTCGAATCTAGGGA,75,78,3,9,1570,0,0
4680,GCGTCGAATCTAGGGA,75,78,3,9,1583,0,0
4681,ACGTCGAATCTAGGGA,75,78,3,9,1589,0,0
4682,ACGTCGAATCTAGGGA,75,77,2,10,1593,0,0
4683,ACGTCGAATCTAGGGA,75,78,3,10,1600,0,0
4684,ATGTCGAATCTAGGGA,75,76,1,11,1604,0,0
4685,ACGTCGAATCTAGGGA,75,77,2,11,1623,0,0
4686,ACGTCGAATCTAGGGA,75,78,3,13,1627,0,0
4687,ACGTCGAATCTAGGGA,75,78,3,11,1629,0,0
4688,ACGTCGAATCTAGGGA,75,78,3,11,1633,0,0
4689,ACGTCGAATCTAGGGA,75,75,0,12,1640,0,0
4690,ACGTCGAATCCAGGGA,75,78,3,10,1646,0,0
4691,ACGTCGAATCTAGGGA,75,78,3,13,1651,0,0
4692,ACGTCGAAGCTAGGGA,75,78,3,12,1653,0,0
4693,ACGTCGAATCTAGGGA,75,78,3,11,1655,0,0
4694,ACGTCGAATCTAGGGA,75,78,3,12,1659,0,0
4695,ACGTCGAATCTAGGGA,75,77,2,11,1679,0,0
4696,ACGTCGAATCTAGGGA,75,78,3,12,1686,0,0
4697,ACGTCGAATCTAGGGA,75,78,3,13,1687,0,0
4698,ACGTCGAATCTAGGGA,75,78,3,10,1688,0,0
4699,ACGTCGAATCTAGGGA,75,78,3,9,1713,0,0
4700,ACGTCGAATCTAGAGA,75,78,3,13,1731,0,0
4701,ACGTCGAATCTAGGGA,75,78,3,13,1741,0,0
4702,ACGTCGAATCTAGGGA,75,78,3,9,1749,0,0
4703,ACGTCGAATCTAGGGA,75,78,3,10,1761,0,0
4704,ACGTCGAATCTAGGGA,75,78,3,11,1767,0,0
4705,ACGTCGAATCTAGGGA,75,78,3,12,1769,0,0
4706,ACGTCGAAGCTAGGAA,75,78,3,14,1774,0,0
4707,CCGTCGAATCTAGGGA,75,78,3,18,1776,0,0
4708,ACGTCGAATCTAGGGA,75,75,0,8,1780,0,0
4709,ACGTCGAATCTAGGGA,75,76,1,15,2853,0,0
4710,ACGTCGAATCTAGGGA,75,76,1,7,4009,0,0
4711,ACGTCGAATATAGGGA,75,75,0,9,4011,0,0
4712,ACGTCGAATCTAGGGA,75,75,0,9,4013,0,0
4713,ACGTCGAATCTAGGGA,75,78,3,10,4014,0,0
4714,ACGTCGAATCTAGGGA,75,78,3,9,4017,0,0
4715,ACGTCGAATCTAGGGA,75,75,0,9,4018,0,0
4716,ACGTCGAATCTAGGGA,75,78,3,9,4019,0,0
4717,ACGTCGAATCTAGGGA,75,78,3,12,4020,0,0
4718,ACGTCGAATCTAGGGA,75,78,3,10,4021,0,0
4719,ACGTCGAATCTAGGGA,75,77,2,10,4023,0,0
4720,ACGTCGAATCTAGGGA,75,78,3,9,4024,0,0
4721,ACGTCGAATCTAGGGA,75,78,3,9,4025,0,0
4722,ACGTCGAATCTATGGA,75,75,0,8,4026,0,0
4723,ACGTCGAATCTAGGGA,75,75,0,10,4027,0,0
4724,ACGTCGAATCTAGGGA,75,78,3,10,4029,0,0
4725,ACGTCGAATCTAGGGA,75,75,0,9,4040,0,0
4726,ACGTCGAATCTAGGGA,75,78,3,11,4042,0,0
4727,ACGTCGAATCTAGGGA,75,78,3,11,4044,0,0
4728,ACGTCGAATCTAGGGA,75,78,3,13,4046,0,0
4729,AAGTCGAATCTAGGGA,75,76,1,10,4047,0,0
4730,ACGTCGAATCTAGGGA,75,78,3,10,4050,0,0
4731,ACGTCGAATCTAGGGA,75,78,3,12,4051,0,0
4732,ACGTCGAATCTAGGGA,75,75,0,10,4052,0,0
4733,ACGTCGAATCTAGGGA,75,77,2,10,4055,0,0
4734,ACGTCGAATCTAGGGA,75,78,3,13,4056,0,0
4735,ACGTCGAATCTAGGGA,75,78,3,13,4058,0,0
4736,ACGTCGAATCTAGGGA,75,78,3,11,4065,0,0
4737,ACGTCGAATCTAGGGA,76,82,6,12,1476,0,0
4738,ACGTCGAATCTAGGGA,76,77,1,13,1478,0,0
4739,ACGTCGAATCTAGGGA,76,77,1,12,1490,0,0
4740,ACGTCGAATCTAGGGA,76,76,0,14,1496,0,0
4741,ACGTCGAATCTAGGGA,76,115,39,13,1504,10,0
4742,ACGTCGAATCTAGGGA,76,79,3,12,1506,0,0
4743,ACGTCGAATCTAGGGA,76,77,1,13,1519,0,0
4744,ACGTCGAATCTAGGGA,76,76,0,13,1521,0,0
4745,ACGTCGAATCTAGGGA,76,83,7,14,1526,0,0
4746,ACGTCAAATCTAGGGA,76,81,5,9,1551,0,0
4747,ACGTCGAATCTAGGGA,76,81,5,14,1553,0,0
4748,ACGTCGAATCCAGGGA,76,85,9,13,1949,0,0
4749,ACGTCGAATCTAGGGA,76,81,5,14,1966,0,0
4750,ACGTCGAATCTAGGGA,76,90,14,12,1968,2,0
4751,ACGTCGAATCTAGGGA,76,81,5,14,1974,0,0
4752,ACGTCGAATCTAGGGA,76,82,6,17,1977,0,0
4753,ACGTCGAATCTAGGGA,76,76,0,12,1981,0,0
4754,ACGTCGAATCTAGGGA,76,83,7,11,1983,0,0
4755,ACGTCGTATCTAGGGA,76,83,7,13,1984,0,0
4756,ACGTCGAATCTAGGGA,76,86,10,13,1985,1,0
4757,ACGTCGAATCAAGGGA,76,95,19,13,1991,4,0
4758,ACGTCGAATCTAGGGA,76,86,10,8,2018,1,0
4759,ACGTCGAATCTAGGGA,76,82,6,14,2023,0,0
4760,ACGTCGAATCTAGGGA,76,76,0,13,2041,0,0
4761,ACGTCGAATCTAGGGA,76,81,5,12,2045,0,0
4762,ACGTCGAATCTAGGGA,76,86,10,12,2057,1,0
4763,ACGTCGAATCTAGGGA,76,87,11,15,2855,1,0
4764,ACGTCGAATCTAGGGA,77,80,3,10,1427,0,0
4765,ACGTCGAATCTAGGTA,77,87,10,13,1430,1,0
4766,ACGTCGAATCTAGGGA,77,83,6,11,1448,0,0
4767,ACGTCGAATCTAGGGA,77,77,0,8,1467,0,0
4768,ACGTCGAATCTAGGGA,77,92,15,12,1471,3,0
4769,ACGTCGAATCTAGGGA,77,77,0,11,1788,0,0
4770,ACGTCGAATCTAGGGA,77,81,4,14,1794,0,0
4771,ACGTCGAATCTAGGGA,77,103,26,11,1818,7,0
4772,ACGTCGAATCTAGGGA,77,83,6,14,1822,0,0
4773,ACGTCGAATCTAGGGA,77,77,0,14,1833,0,0
4774,ACGTCGAATCTAGGGA,77,81,4,15,1842,0,0
4775,ACGTCGAATCTAGGGA,77,97,20,9,1854,4,0
4776,ACGTCGAATCTAGGGA,77,79,2,9,1866,0,0
4777,ACGTCGAATCTAGGGA,77,86,9,11,1881,0,0
4778,ACGTCGAATCTAGGGA,77,84,7,12,1916,0,0
4779,ACGTCGAATCTAGGGA,77,80,3,12,1922,0,0
4780,ACGTCGAATCTAGGGA,77,79,2,13,1925,0,0
4781,ACGTCGAATCTAGGGA,77,78,1,13,1935,0,0
4782,AAGTCGAATCTAGGGA,77,88,11,11,1938,1,0
4783,ACGTCGAATCTAGGGA,77,77,0,14,2859,0,0
4784,ACGTCGAATCTAGGGA,77,79,2,14,2863,0,0
4785,ACGTCGAATCTAGGGA,77,87,10,14,2864,1,0
4786,ACGTCGAATCTAGGGA,77,94,17,13,2868,3,0
4787,ACGTCGAATCTAGGGA,77,84,7,18,2890,0,0
4788,ACGTCGAATCTAGGGA,77,114,37,17,2892,10,0
4789,ACGTCGAATCTAGGGA,77,84,7,15,2895,0,0
4790,ACGTCGAATCTAGGGA,77,97,20,12,2908,4,0
4791,ACGTCGAATCTAGGGA,77,85,8,12,2910,0,0
4792,ACGTCGAAGCTAGGAA,77,90,13,16,2916,2,0
4793,ACGTCGAATCTAGGGA,77,87,10,12,2918,1,0
4794,ACGTCGAATCTAGGGA,77,81,4,13,2924,0,0
4795,ACGTCGAATAGAGGGA,77,82,5,16,2933,0,0
4796,ACGTCGAATCTAGGGA,77,90,13,16,2953,2,0
4797,ACGTCGAATCTAGGGA,77,78,1,12,4074,0,0
4798,ACGTCGAATCTAGGGA,77,83,6,9,4076,0,0
4799,ACGTCGAATCTAGGGA,77,87,10,10,4082,1,0
4800,ACGTCGAATCTAGGGA,77,80,3,11,4083,0,0
4801,ACGTCGAATCTAGGGA,77,80,3,13,4088,0,0
4802,ACGTCGAATCTAGGGA,77,78,1,12,4089,0,0
4803,ACGTCGAATCTAGGGA,77,79,2,14,4092,0,0
4804,ACGTCGAATCTAGGGA,77,77,0,10,4095,0,0
4805,ACGTCGAATCTAGGGA,77,89,12,10,4103,1,0
4806,ACGTCGAATCTAGGGA,77,80,3,12,4104,0,0
4807,ACGTCGAATCTAGGGA,77,80,3,14,4109,0,0
4808,ACGTCGAATCTAGGGA,77,78,1,8,4111,0,0
4809,ACGTCGACTCTCGGGA,77,80,3,12,4113,0,0
4810,ACGTCGAATCTATGGA,77,77,0,11,4114,0,0
4811,ACGTCGAATCTAGGGA,77,78,1,13,4117,0,0
4812,AGGTCGAATCTAGTGA,77,80,3,12,4121,0,0
4813,ACGTCGAATCTAGGGA,77,80,3,18,4123,0,0
4814,ACGTCGACTCTAGGGA,77,80,3,9,4417,0,0
4815,ACGTCGAATCTAGGGA,77,80,3,9,4419,0,0
4816,ACGTCGAATCTAGGGA,77,80,3,10,4420,0,0
4817,ACGTCGAATCTAGGGA,77,80,3,10,4422,0,0
4818,ACGTCGAATCTAGGGA,77,77,0,10,4424,0,0
4819,ACGTCGAATCTAGGGA,77,80,3,11,4429,0,0
4820,ACGTCGAATCTAGGGA,77,77,0,11,4430,0,0
4821,ACGTCGAATCTAGGGA,77,80,3,13,4432,0,0
4822,ACGTCGAATCTAGGGA,77,80,3,12,4436,0,0
4823,ACGTCGAATCTAGGGA,77,79,2,10,4437,0,0
4824,ACGTCGAATCTAGGGA,77,80,3,11,4438,0,0
4825,ACGTCGAATCTAGGGT,77,80,3,12,4442,0,0
4826,ACGTCGAATCTAGGGA,77,80,3,12,4444,0,0
4827,ACGTCGAATCTAGGGA,77,80,3,10,4447,0,0
4828,ACGTCGAATCTAGGGA,77,80,3,13,4453,0,0
4829,ACGTCGAATCTAGGGA,77,80,3,14,4454,0,0
4830,ACGTCGAATCTAGGGA,78,81,3,6,57,0,0
4831,ACGTCGAATCTAGGGA,78,89,11,7,134,2,0
4832,ACGTCGAATCTAGGGA,78,86,8,8,294,1,0
4833,ACGTCGAATCTAGGGA,78,94,16,9,356,3,0
4834,ACGTCGAATCTAGGGA,78,88,10,9,376,1,0
4835,ACGTCGAATCTAGGGA,78,78,0,9,470,0,0
4836,ACGTCGAATCTAGGGA,78,88,10,8,481,1,0
4837,ACGTCGAATCTAGGGA,78,96,18,10,521,4,0
4838,ACGTCGAATCTAGGGA,78,91,13,10,531,2,0
4839,ACGTCGAATCTAGGGA,78,82,4,10,574,0,0
4840,ACGTCGAATCTAGGGA,78,79,1,11,632,0,0
4841,ACGTCGAATCTAGGGA,78,105,27,10,681,6,0
4842,ACGTCGAATCTAGGGA,78,84,6,12,728,0,0
4843,ACGTCGAATCTAGTGA,78,80,2,10,730,0,0
4844,ACGTCGAATCTAGGGA,78,81,3,10,741,0,0
4845,ACGTCGAATCTAGGGA,78,87,9,11,756,0,0
4846,ACGTCGAATCTAGGGA,78,96,18,8,831,3,0
4847,ACGTCGAATCTAGGGA,78,88,10,9,848,1,0
4848,ACGTCGAATCTAGGGA,78,91,13,10,858,2,0
4849,ACGTCGAATCTAGGGA,78,78,0,9,867,0,0
4850,ACGTCGAATCTAGGGA,78,87,9,12,873,0,0
4851,ACGTCGAATCTAGGGA,78,85,7,13,905,0,0
4852,ACGTCGAATCTAGGGA,78,85,7,9,906,0,0
4853,ACGTCGAATCTAGGGA,78,81,3,10,929,0,0
4854,ACGTCGAATCTAGGGA,78,82,4,11,965,0,0
4855,ACGTAGAATCTAGGGA,78,81,3,11,989,0,0
4856,ACGTCGAATCTCGGGA,78,81,3,11,997,0,0
4857,ACGTCGAATCTAGGGA,78,78,0,10,1006,0,0
4858,ACGTCGAATCTAGGGA,78,81,3,10,1019,0,0
4859,ACGTCGAATCGAGGGA,78,78,0,17,1046,0,0
4860,ACGTCGAATCTAGGGA,78,81,3,11,1050,0,0
4861,ACGTCGAATCTAGGGA,78,81,3,14,1052,0,0
4862,ACGTCGAATCTAGGGA,78,79,1,13,1062,0,0
4863,ACGTCGAATCTAGGGA,78,80,2,11,1075,0,0
4864,ACGTCGAATCTAGGGA,78,81,3,12,1083,0,0
4865,ACATCGAATCTAGGGA,78,81,3,13,1086,0,0
4866,ACGTCGAATCTAGGGA,78,80,2,12,1095,0,0
4867,ACGTCGAATCTAGGGA,78,81,3,14,1112,0,0
4868,ACGTCGAATCTAGGGA,78,81,3,14,1122,0,0
4869,ACGTCGAATCTAGGGA,78,81,3,8,1132,0,0
4870,ACGTCGAGTCTAGGGA,78,80,2,9,1136,0,0
4871,ACGTCGAATCTAGGGA,78,81,3,14,1174,0,0
4872,ACGTCGAATCTAGGGA,78,81,3,13,1187,0,0
4873,ACGTCGAATCTAGGGA,78,81,3,8,1193,0,0
4874,ACGTCGAATCTAGGGA,78,81,3,10,1203,0,0
4875,ACGTCGAATCTAGGGA,78,81,3,10,1207,0,0
4876,ACGTCGAATCTAGGGA,78,81,3,11,1209,0,0
4877,ACGTCGAATCTAGGGA,78,81,3,12,1238,0,0
4878,ACGTCGAATCTAGCGA,78,81,3,9,1288,0,0
4879,ACGTCGAATCTAGGGA,78,81,3,11,1316,0,0
4880,ACGTCGAATCTAGGGA,78,81,3,9,1319,0,0
4881,ACGTCGAATCTAGGGA,78,81,3,12,1337,0,0
4882,ACGTCGAATCTAGGGA,78,81,3,13,1376,0,0
4883,ACGTCGAATCTAGGGA,78,81,3,11,1411,0,0
4884,ACGTCGAATCTAGGGA,78,81,3,11,1557,0,0
4885,ACGTCGAATCTAGGGA,78,80,2,10,1561,0,0
4886,ACGTCGAATCTAGGGA,78,81,3,9,1562,0,0
4887,ACGTCGAATCTAGGGA,78,81,3,9,1567,0,0
4888,ACGTCGAATCTAGGGA,78,81,3,9,1570,0,0
4889,GCGTCGAATCTAGGGA,78,80,2,9,1583,0,0
4890,ACGTCGAATCTAGGGA,78,81,3,9,1589,0,0
4891,ATGTCGAATCTAGGGA,78,81,3,11,1604,0,0
4892,ACGTCGAATCTAGGGA,78,81,3,13,1627,0,0
4893,ACGTCGAATCTAGGGA,78,81,3,11,1629,0,0
4894,ACGTCGAATCTAGGGA,78,81,3,11,1633,0,0
4895,ACGTCGAATCTAGGGA,78,81,3,12,1640,0,0
4896,ACGTCGAATCTAGGGA,78,81,3,10,1646,0,0
4897,ACGTCGAATCTAGGGA,78,81,3,13,1651,0,0
4898,ACGTCGAATCTAGGGA,78,78,0,11,1655,0,0
4899,ACGTCGAATCTAGGGA,78,78,0,12,1659,0,0
4900,ACGTCGAATCTAGGGA,78,81,3,11,1679,0,0
4901,ACGTCGAATCTAGGGA,78,81,3,13,1687,0,0
4902,ACGTCGAATCTAGGGA,78,81,3,10,1688,0,0
4903,ACGTCGAATCTAGGGA,78,80,2,9,1713,0,0
4904,ACGTCGAATCTAGGGA,78,78,0,13,1741,0,0
4905,ACGTCGAATCTAGGGA,78,80,2,12,1769,0,0
4906,ACGTCGAAGCTAGGAA,78,81,3,14,1774,0,0
4907,CCGTCGAATCTAGGGA,78,81,3,18,1776,0,0
4908,ACGTCGAATCTAGGGA,78,79,1,8,1780,0,0
4909,ACGTCGAATCTAGGGA,78,80,2,15,2853,0,0
4910,ACGTCGAATCTAGGGA,78,81,3,7,4009,0,0
4911,ACGTCGAATATAGGGA,78,80,2,9,4011,0,0
4912,ACGTCGAATCTAGGGA,78,81,3,9,4019,0,0
4913,ACGTCGAATCTAGGGA,78,81,3,10,4021,0,0
4914,ACGTCGAATCTAGGGA,78,79,1,10,4023,0,0
4915,ACGTCGAATCTAGGGA,78,81,3,9,4024,0,0
4916,ACGTCGAATCTAGGGA,78,81,3,9,4025,0,0
4917,ACGTCGAATCTATGGA,78,81,3,8,4026,0,0
4918,ACGTCGAATCTAGGGA,78,81,3,10,4027,0,0
4919,ACGTCGAATCTAGGGA,78,79,1,10,4029,0,0
4920,ACGTCGAATCTAGGGA,78,81,3,9,4040,0,0
4921,ACGTCGAATCTAGGGA,78,81,3,11,4042,0,0
4922,ACGTCGAATCTAGGGA,78,78,0,11,4044,0,0
4923,ACGTCGAATCTAGGGA,78,81,3,13,4046,0,0
4924,AAGTCGAATCTAGGGA,78,78,0,10,4047,0,0
4925,ACGTCGAATCTAGGGA,78,81,3,10,4050,0,0
4926,ACGTCGAATCTAGGGA,78,80,2,12,4051,0,0
4927,ACGTCGAATCTAGGGA,78,79,1,10,4052,0,0
4928,ACGTCGAATCTAGGGA,78,78,0,10,4055,0,0
4929,ACGTCGAATCTAGGGA,78,80,2,13,4056,0,0
4930,ACGTCGAATCTAGGGA,78,80,2,11,4065,0,0
4931,ACGTCGAATCTAGGGA,78,79,1,9,4411,0,0
4932,ACGTCGAATCTAGGGA,78,81,3,12,4412,0,0
4933,ACGTCGAATCTAGGGA,78,78,0,13,4413,0,0
4934,ACGTCGAATCTAGGGA,79,87,8,12,1476,1,0
4935,ACGTCGAATCTAGGGA,79,84,5,13,1478,0,0
4936,ACGTCGAATCTAGGGA,79,86,7,14,1496,0,0
4937,ACGTCGAATCTAGGGA,79,91,12,13,1504,2,0
4938,ACGTCGAATCTAGGGA,79,94,15,12,1506,3,0
4939,ACGTCGAATCTAGGGA,79,83,4,13,1519,0,0
4940,ACGTCGAATCTAGGGA,79,91,12,13,1521,2,0
4941,ACGTCGAATCTAGGGA,79,98,19,9,1551,4,0
4942,ACGTCGAATCTAGGGA,79,93,14,14,1553,3,0
4943,ACGTCGAATCTAGGGA,79,87,8,14,1966,1,0
4944,ACGTCGAATCTAGGGA,79,84,5,12,1968,0,0
4945,ACGTCGAATCTAGGGA,79,81,2,14,1974,0,0
4946,ACGTCGAATCTAGGGA,79,79,0,17,1977,0,0
4947,ACGTCGAATCTAGGGA,79,79,0,12,1981,0,0
4948,ACGTCGAATCTAGGGA,79,93,14,13,1984,3,0
4949,ACGTCGAATCTAGGGA,79,83,4,13,1985,0,0
4950,ACGTCGAATCTAGGGA,79,81,2,8,2018,0,0
4951,ACGTCGAATCTAGGGA,79,79,0,14,2023,0,0
4952,ACGTCGAATCTAGGGA,79,99,20,13,2041,5,0
4953,ACGTCGAATCTAGGGA,79,89,10,12,2045,1,0
4954,ACGTCGAATCTAGGGA,79,79,0,12,2057,0,0
4955,ACGTCGAATCTAGGGA,79,81,2,15,2855,0,0
4956,ACGTCGAATCTAGGGA,79,114,35,13,4130,10,0
4957,ACGTCGAATCTAGGGA,79,80,1,12,4132,0,0
4958,ACGTCGAATCTAGGGA,79,81,2,13,4140,0,0
4959,ACGTCGAATCTAGGGA,79,108,29,10,4148,7,0
4960,ACGTCGAATCTAGGGA,79,85,6,10,4152,0,0
4961,ACGTCGAATCTAGGGA,79,79,0,12,4167,0,0
4962,ACGTCGAATCTAGGGA,79,79,0,14,4386,0,0
4963,ACGTCGAATCTAGGGA,79,97,18,13,4387,3,0
4964,ACGTCGAATCTAGGGA,79,89,10,13,4391,1,0
4965,ACGTCGAATCTAGGGA,79,86,7,15,4395,0,0
4966,ACGTCGAATCTAGGGA,79,80,1,14,4397,0,0
4967,ACGTCGAATCTAGGGA,79,83,4,15,4402,0,0
4968,ACGTAGAATCTAGGGA,79,88,9,12,4456,0,0
4969,ACGTCGAATCTAGGGA,80,87,7,10,1427,0,0
4970,ACGTCGAATCTAGGGA,80,85,5,13,1430,0,0
4971,ACGTCGAATCTAGGGA,80,104,24,8,1467,6,0
4972,ACGTCGAATCTAGGGA,80,115,35,12,1471,10,0
4973,ACGTCGAATCTAGGGA,80,85,5,11,1788,0,0
4974,ACGTCGAATCTAGGGA,80,80,0,11,1818,0,0
4975,ACGTCGAATCTAGGGA,80,81,1,14,1822,0,0
4976,ACGTCGAATCTAGGGA,80,86,6,14,1833,0,0
4977,ACGTCGAATCTAGGGA,80,80,0,15,1842,0,0
4978,ACGTCGAATCTAGGGA,80,86,6,9,1854,0,0
4979,ACGTCGAATCTAGGGA,80,81,1,9,1866,0,0
4980,ACGTCGAATCTAGGGA,80,97,17,12,1916,4,0
4981,ACGTCGAATCTAGGGA,80,80,0,13,1925,0,0
4982,ACGTCGAATCTAGGGA,80,80,0,13,1935,0,0
4983,ACGTCGAATCTAGGGA,80,86,6,14,2859,0,0
4984,ACGTCGAATCTAGGGA,80,83,3,14,2863,0,0
4985,ACGTCGAATCTAGGGA,80,80,0,14,2864,0,0
4986,ACGTCGAATCTAGGGA,80,80,0,13,2868,0,0
4987,ACGTCGAATCTAGGGA,80,81,1,18,2890,0,0
4988,ACGTCGAATCTAGGGA,80,81,1,17,2892,0,0
4989,ACGTCGAATCTAGGGA,80,85,5,15,2895,0,0
4990,ACGTCGAATCTAGGGA,80,81,1,12,2910,0,0
4991,ACGTCGAAGCTAGGAA,80,80,0,16,2916,0,0
4992,ACGTCGAATCTAGGGA,80,84,4,12,2918,0,0
4993,ACGTCGAATCTAGGGA,80,103,23,13,2924,6,0
4994,ACGTCGAATAGAGGGA,80,101,21,16,2933,5,0
4995,ACGTCGAATCTAGGGA,80,81,1,16,2953,0,0
4996,ACGTCGAATCTAGGGA,80,82,2,12,4074,0,0
4997,ACGTCGAATCTAGGGA,80,93,13,9,4076,2,0
4998,ACGTCGAATCTAGGGA,80,80,0,10,4082,0,0
4999,ACGTCGAATCTAGGGA,80,98,18,11,4083,4,0
5000,ACGTCGAATCTAGGGA,80,80,0,13,4088,0,0
5001,ACGTCGAATCTAGGGA,80,90,10,12,4089,1,0
5002,ACGTCGAATCTAGGGA,80,88,8,14,4092,1,0
5003,ACGTCGAATCTAGGGA,80,85,5,10,4095,0,0
5004,ACGTCGAATCTAGGGA,80,102,22,10,4103,5,0
5005,ACGTCGAATCTAGGGA,80,85,5,12,4104,0,0
5006,ACGTCGAATCTAGGGA,80,80,0,14,4109,0,0
5007,ACGTCGACTCTCGGGA,80,89,9,12,4113,0,0
5008,ACGTCGAATCTAGGGA,80,93,13,13,4117,2,0
5009,AGGTCGAATCTAGTGA,80,80,0,12,4121,0,0
5010,ACGTCGAATCTAGGGA,80,93,13,11,4168,2,0
5011,ACGTCGAATCTAGGGA,80,82,2,10,4236,0,0
5012,ACGTCGAATCTAGGGA,80,81,1,9,4238,0,0
5013,ACGTCGAATCTAGGGA,80,90,10,9,4239,1,0
5014,ACGTCGACTCTAGGGA,80,83,3,9,4417,0,0
5015,ACGTCGAATCTAGGGA,80,81,1,9,4419,0,0
5016,ACGTCGAATCTAGGGA,80,80,0,10,4420,0,0
5017,ACGTCGAATCTAGGGA,80,81,1,10,4422,0,0
5018,ACGTCGAATCTAGGGA,80,88,8,11,4429,0,0
5019,ACGTCGAATCTAGGGA,80,83,3,13,4432,0,0
5020,ACGTCGAATCTAGGGC,80,89,9,12,4436,0,0
5021,ACGTCGAATCTAGGGA,80,95,15,11,4438,2,0
5022,ACGTCGAATCTAGGGA,80,87,7,10,4447,0,0
5023,ACGTCGAATCTAGGGA,80,85,5,14,4454,0,0
5024,ACGTCGAATCTAGGGA,81,99,18,6,57,4,0
5025,ACGTCGAATCTAGGGA,81,96,15,7,134,3,0
5026,ACGTCGAATCTAGGGA,81,86,5,8,294,0,0
5027,ACGTCGAATCTAGGGA,81,88,7,9,356,0,0
5028,ACGTCGAATCTAGGGA,81,90,9,9,376,1,0
5029,ACGTCGAATCTAGGGA,81,84,3,9,470,0,0
5030,ACGTCGAATCTAGGGA,81,92,11,10,531,2,0
5031,ACGTCGAATCTAGGGA,81,102,21,11,632,5,0
5032,ACGTCGAATCTAGGGA,81,89,8,12,728,1,0
5033,ACGTCGAATCTAGTGA,81,82,1,10,730,0,0
5034,ACGTCGAATCTAGGGA,81,99,18,10,741,4,0
5035,ACGTCGAATCTAGGGA,81,110,29,11,756,8,0
5036,ACGTCGAATCTAGGGA,81,81,0,8,831,0,0
5037,ACGTCGAATCTAGGGA,81,89,8,9,848,1,0
5038,ACGTCGAATCTAGGGA,81,95,14,10,858,3,0
5039,ACGTCGAATCTAGGGA,81,87,6,9,867,0,0
5040,ACGTCGAATCTAGGGA,81,82,1,12,873,0,0
5041,ACGTCGAATCTAGGGA,81,84,3,13,905,0,0
5042,ACGTCGAATCTAGGGA,81,83,2,9,906,0,0
5043,ACGTCGAATCTAGGGA,81,82,1,11,965,0,0
5044,ACGTAGAATCTAGGGA,81,84,3,11,989,0,0
5045,ACGTCGAATCTCGGGA,81,84,3,11,997,0,0
5046,ACGTCGAATCTAGGGA,81,83,2,10,1006,0,0
5047,ACGTCGAATCTAGGGA,81,84,3,17,1046,0,0
5048,ACGTCGAATCTAGGGA,81,84,3,11,1050,0,0
5049,ACGTCGAATCTAGGGA,81,84,3,13,1062,0,0
5050,ACGTCGAATCTAGGGA,81,82,1,11,1075,0,0
5051,ACGTCGAATCTAGGGA,81,84,3,13,1086,0,0
5052,ACGTCGAATCTAGGGA,81,84,3,12,1095,0,0
5053,ACGTCGAATCTAGGGA,81,81,0,14,1112,0,0
5054,ACGTCGAATCTAGGGA,81,81,0,14,1122,0,0
5055,ACGTCGAATCTAGGGA,81,84,3,8,1132,0,0
5056,ACGTCGAGTCTAGGGA,81,82,1,9,1136,0,0
5057,ACGTCGAATCTAGGGA,81,83,2,13,1187,0,0
5058,ACGTCGAATCTAGGGA,81,84,3,8,1193,0,0
5059,ACGTCGAATCTAGGGA,81,82,1,10,1203,0,0
5060,ACGTCGAATCTAGGGA,81,84,3,12,1238,0,0
5061,ACGTCGAATCTAGGGA,81,84,3,9,1288,0,0
5062,ACGTCGAATCTAGGGA,81,84,3,9,1319,0,0
5063,ACGTCGAATCTAGGGA,81,84,3,12,1337,0,0
5064,ACGTCGAATCTAGGGA,81,84,3,11,1411,0,0
5065,ACGTCGAATCTAGGGA,81,81,0,11,1557,0,0
5066,ACGTCGAATCTGGGGA,81,84,3,10,1561,0,0
5067,ACGTCGAATCTAGGGA,81,84,3,9,1562,0,0
5068,ACGTCGAATCTAGGGA,81,84,3,9,1567,0,0
5069,ACGTCGAATCTAGGGA,81,84,3,9,1570,0,0
5070,GCGTCGAATCTAGGGA,81,81,0,9,1583,0,0
5071,ATGTCGAATCTAGGGA,81,84,3,11,1604,0,0
5072,ACGTCGAATCTAGGGA,81,84,3,13,1627,0,0
5073,ACGTCGAATCTAGGGA,81,83,2,11,1629,0,0
5074,ACGTCGAATTTAGGGA,81,84,3,12,1640,0,0
5075,ACGTCGAATCTAGGGA,81,84,3,10,1646,0,0
5076,ACGTCGAATCTAGGGA,81,84,3,13,1651,0,0
5077,ACGTCGAATCTAGGGA,81,84,3,11,1655,0,0
5078,ACGTCGAATCTAGGGA,81,83,2,11,1679,0,0
5079,ACGTCGAATCTAGGGA,81,82,1,13,1687,0,0
5080,ACGTCGAATCTAGGGA,81,84,3,10,1688,0,0
5081,ACGTCGAATCTAGGGA,81,82,1,13,1741,0,0
5082,ACGTCGAAGCTAGGAA,81,81,0,14,1774,0,0
5083,CCGTCGAATCTAGGGA,81,84,3,18,1776,0,0
5084,ACGTCGAATCTAGGGA,81,84,3,8,1780,0,0
5085,ACGTCGAATCTAGGGA,81,84,3,15,2853,0,0
5086,ACGTCGAATCTAGGGA,81,84,3,9,4024,0,0
5087,ACGTCGAATCTAGGGA,81,84,3,9,4025,0,0
5088,ACGTCGAATCTATGGA,81,84,3,8,4026,0,0
5089,ACGTCGAATCTAGGGA,81,84,3,10,4027,0,0
5090,ACGTCGAATCTAGGGA,81,84,3,9,4040,0,0
5091,ACGTCGAATCTAGGGA,81,82,1,11,4044,0,0
5092,ACGTCGAATCTAGGGA,81,84,3,13,4046,0,0
5093,ACGTCGAATCTAGGGA,81,84,3,10,4050,0,0
5094,ACGTCGAATCTAGGGA,81,84,3,12,4051,0,0
5095,ACGTCGAATCTAGGGA,81,84,3,10,4052,0,0
5096,ACGTCGAATCTAGGGA,81,84,3,10,4055,0,0
5097,ACGTCGAATCTAGGGA,81,84,3,11,4065,0,0
5098,ACGTCGAATCTAGGGA,81,84,3,9,4411,0,0
5099,ACGTCGAATCTAGGGA,81,84,3,12,4412,0,0
5100,ACGTCGAATCTAGGGA,81,81,0,13,4413,0,0
5101,ACGTCGAATCTAGGGA,81,84,3,11,4457,0,0
5102,ACGTCCAATCTAGGGA,81,84,3,12,4458,0,0
5103,ACGTAGAATCTAGGGA,81,84,3,12,4462,0,0
5104,ACGTCGAATCTAGGGA,81,84,3,11,4464,0,0
5105,ACGTCGAATCTAGGGA,81,84,3,11,4578,0,0
5106,ACGTCGAATCTAGGGA,81,83,2,14,4579,0,0
5107,ACGTCGAATATAGGGA,81,84,3,12,4582,0,0
5108,ACGTCGAATCTAGGGA,81,84,3,12,4583,0,0
5109,ACGTCGAATCTAGGGA,81,84,3,15,4587,0,0
5110,ACGTCGAATCTAGGGA,81,81,0,15,4591,0,0
5111,ACGTCGAATCTAGGGA,81,84,3,10,4593,0,0
5112,ACGTCGAATCTAGGGA,81,84,3,11,4594,0,0
5113,ACGTCGAATCTAGGGA,81,81,0,12,4596,0,0
5114,ACGTCGAATCTAGGGA,82,96,14,12,1476,3,0
5115,ACGTCGAATCTAGGGA,82,84,2,13,1478,0,0
5116,ACGTCGAATCTAGGGA,82,87,5,12,1506,0,0
5117,ACGTCGAATCTAGGGA,82,82,0,13,1519,0,0
5118,ACGTCGAATCTAGGGA,82,91,9,14,1553,1,0
5119,ACGTCGAATCTAGGGA,82,83,1,14,1966,0,0
5120,ACGTCGAATCTAGGGA,82,86,4,12,1968,0,0
5121,ACGTCGAATCTAGGGA,82,90,8,17,1977,1,0
5122,ACGTCGAATCTAGGGA,82,84,2,13,1984,0,0
5123,ACGTCGAATCTAGGGA,82,111,29,13,1985,8,0
5124,ACGTCGAATCTAGGGA,82,140,58,14,2023,17,0
5125,ACGTCGAATCTAGGGA,82,84,2,13,2041,0,0
5126,ACGTCGAATCTAGGGA,82,83,1,12,2045,0,0
5127,ACGTCGAATCTAGGGA,82,84,2,12,2057,0,0
5128,ACGTCGAATCTAGGGA,82,83,1,13,4130,0,0
5129,ACGTCGAATCTAGGGA,82,84,2,12,4132,0,0
5130,ACGTCGAATCTAGGGA,82,86,4,13,4140,0,0
5131,ACGTCGAATCTAGGGA,82,91,9,10,4152,1,0
5132,ACGTCGAATCTAGGGA,82,83,1,14,4386,0,0
5133,ACGTCGAATCTAGGGA,82,83,1,13,4387,0,0
5134,ACGTCGAATCTAGGGA,82,104,22,15,4395,5,0
5135,ACGTCGAATCTAGGGA,82,85,3,14,4397,0,0
5136,ACGTCGAATCTAGGGA,82,104,22,15,4402,5,0
5137,ACGTCGAATCTAGGGA,82,93,11,15,4562,2,0
5138,ACGTCGAATCTAGGGA,82,112,30,13,4563,8,0
5139,ACGTCTAATCTAGGGA,82,91,9,14,4564,1,0
5140,ACGTCGAATCTAGGGA,82,87,5,14,4567,0,0
5141,ACGTCGAATCTAGGGA,82,86,4,11,4575,0,0
5142,ACGTCGAATCTAGGGA,82,96,14,7,4603,3,0
5143,ACGTCGAATCTAGGGA,82,86,4,8,4605,0,0
5144,ACGTCGAATCTAGGGA,82,83,1,10,4609,0,0
5145,ACGTCGAATGTAGGGA,82,85,3,8,4610,0,0
5146,ACGTCGAATCTAGGGA,82,87,5,11,4613,0,0
5147,ACGTCGAATCTAGGGA,82,100,18,11,4614,4,0
5148,ACGTCGAATCTAGGGA,82,83,1,13,4616,0,0
5149,ACGTCGAATCTAGGGA,82,83,1,11,4617,0,0
5150,ACGTCGAATCTAGGGA,82,84,2,11,4620,0,0
5151,ACGTCGAATCTAGGGA,83,119,36,10,1427,11,0
5152,ACGTCGAATCTAGGGA,83,85,2,13,1430,0,0
5153,ACGTCGAATCTAGGGA,83,84,1,8,1467,0,0
5154,ACGTCGAATCTAGGGA,83,84,1,12,1471,0,0
5155,ACGTCGAATCTAGGGA,83,90,7,11,1788,1,0
5156,ACGTCGAATCTAGGGA,83,85,2,11,1818,0,0
5157,ACGTCGAATCTAGGGA,83,95,12,14,1833,3,0
5158,ACGTCGAATCTAGGGA,83,108,25,15,1842,7,0
5159,ACGTCGAATCTAGGGA,83,96,13,12,1916,3,0
5160,ACGTCGAATCTAGGGA,83,96,13,13,1935,3,0
5161,ACGTCGAATCTAGGGA,83,91,8,14,2859,1,0
5162,ACGTCGAATCTAGGGA,83,83,0,14,2863,0,0
5163,ACGTCGAATCTAGGGA,83,88,5,14,2864,0,0
5164,ACGTCGAATCTAGGGA,83,88,5,15,2895,0,0
5165,ACGTCGAATCTAGGGA,83,89,6,12,2910,0,0
5166,ACGTCGAAGCTAGGAA,83,95,12,16,2916,2,0
5167,ACGTCGAATCTAGGGA,83,83,0,9,4076,0,0
5168,ACGTCGAATCTAGGGA,83,95,12,10,4082,2,0
5169,ACGTCGAATCTAGGGA,83,84,1,11,4083,0,0
5170,ACGTCGAATCTAGGGA,83,100,17,13,4088,4,0
5171,ACGTCGAATCTAGGGA,83,87,4,14,4092,0,0
5172,ACGTCGAATCTAGGGA,83,91,8,10,4103,1,0
5173,ACGTCGAATCTAGGGA,83,97,14,12,4104,3,0
5174,ACGTCGAATCTAGGGA,83,101,18,14,4109,4,0
5175,ACGTCGAGTCTCGGGA,83,98,15,12,4113,3,0
5176,ACGTCGAATCTAGGGA,83,117,34,13,4117,9,0
5177,ACGTCGAATCTAGGGA,83,103,20,10,4236,5,0
5178,ACGTCGAATCTAGGGA,83,90,7,9,4238,0,0
5179,ACGTCGAATCTAGGGA,83,92,9,9,4239,1,0
5180,ACGTCGAATCTAGGGA,83,118,35,9,4419,10,0
5181,ACGTAGAATCTAGGGA,83,98,15,10,4420,3,0
5182,ACGTCGAATCTAGGGA,83,125,42,10,4422,12,0
5183,ACGTCGAATCTAGGGA,83,88,5,13,4432,0,0
5184,ACGTCGAATCTACGGA,83,100,17,12,4436,4,0
5185,ACGTCGAATCTAGGGA,83,98,15,11,4438,3,0
5186,ACGTCGAATCTAGGGA,83,107,24,10,4447,6,0
5187,ACGTCGAATCTAGGGC,83,103,20,14,4454,5,0
5188,ACGTCGAATCTAGGGA,83,84,1,13,4599,0,0
5189,ACGTCGAATCTAGGGA,83,105,22,14,4600,5,0
5190,ACGTCGAATCTAGGGA,84,97,13,6,57,3,0
5191,ACGTCGAATCTAGGGA,84,118,34,8,294,10,0
5192,ACGTCGAATCTAGGGA,84,85,1,9,376,0,0
5193,ACGTCGAATCTAGGGA,84,93,9,9,470,2,0
5194,ACGTCGAATCTAGGGA,84,94,10,11,632,2,0
5195,ACGTCGAATCTAGGGA,84,90,6,12,728,1,0
5196,ACGTCGAATCTAGTGA,84,84,0,10,730,0,0
5197,ACGTCGAATCTAGGGA,84,107,23,8,831,6,0
5198,ACGTCGAATCTAGGGA,84,87,3,9,848,0,0
5199,ACGTCGAATCTAGGGA,84,96,12,10,858,2,0
5200,ACGTCGAATCTAGGGA,84,85,1,9,867,0,0
5201,ACGTCGAATCTAGGGA,84,97,13,13,905,2,0
5202,ACGTCGAATCTAGGGA,84,86,2,9,906,0,0
5203,ACGTCGAATCTAGGGA,84,92,8,11,965,1,0
5204,ACGTAGAATCTAGGGA,84,87,3,11,989,0,0
5205,ACGTCGAATCTAGGGA,84,103,19,17,1046,4,0
5206,ACGTCGAATCTAGGGA,84,101,17,11,1050,4,0
5207,ACGTCGAATCTAGGGA,84,91,7,13,1062,0,0
5208,ACGTCGAATCTAGGGA,84,87,3,11,1075,0,0
5209,ACGTCGAATCTAGGGA,84,87,3,13,1086,0,0
5210,ACGTCGAATCTAGGGA,84,86,2,8,1132,0,0
5211,ACGTCGAGTCTAGGGA,84,85,1,9,1136,0,0
5212,ACGTCGAATCTAGGGA,84,87,3,13,1187,0,0
5213,ACGTCGAATCTAGGGA,84,87,3,8,1193,0,0
5214,ACGTCGAATCTAGGGA,84,87,3,12,1238,0,0
5215,ACGTCGAATCTAGGGA,84,87,3,9,1288,0,0
5216,ACGTCGAATCTAGGGA,84,87,3,9,1319,0,0
5217,ACGTCGAATCTAGGGA,84,86,2,12,1337,0,0
5218,ACGTCGAATCTAGGGA,84,85,1,11,1411,0,0
5219,ACGTCGAATCTAGGGA,84,87,3,11,1557,0,0
5220,ACGTCGAATCTAGGGA,84,87,3,10,1561,0,0
5221,ACGTCGAATCTAGGGA,84,87,3,9,1562,0,0
5222,ACGTCGAATCTAGGGA,84,84,0,9,1567,0,0
5223,ACGTCGAATCTAGGGA,84,87,3,9,1570,0,0
5224,ATGTCGAATCTAGGGA,84,84,0,11,1604,0,0
5225,ACGTCGAATCTAGGGA,84,86,2,13,1627,0,0
5226,ACGTCGAATCTAGGGA,84,85,1,11,1629,0,0
5227,ACGTCGAATCTAGGGA,84,87,3,12,1640,0,0
5228,ACGTCGAATCTAGGGA,84,84,0,13,1651,0,0
5229,ACGTCGAATCTAGGGA,84,84,0,11,1679,0,0
5230,ACGTCGAATCTAGGGA,84,87,3,13,1687,0,0
5231,ACGTCGAATCTAGGGA,84,87,3,10,1688,0,0
5232,ACGTCGAATCTAGGGA,84,87,3,13,1741,0,0
5233,ACGTCGAAGCTAGGAA,84,87,3,14,1774,0,0
5234,ACGTCGAATCTAGGGA,84,87,3,8,1780,0,0
5235,ACGTCGAATCTAGGGA,84,87,3,15,2853,0,0
5236,ACGTCGAATCTAGGGA,84,87,3,9,4025,0,0
5237,ACGTCGAATCTATGGA,84,87,3,8,4026,0,0
5238,ACGTCGAATCTAGGGA,84,87,3,10,4027,0,0
5239,ACGTCGAATCTAGGGA,84,87,3,9,4040,0,0
5240,ACGTCGAATCTAGGGA,84,87,3,13,4046,0,0
5241,ACGTCGAATCTAGGGA,84,87,3,10,4050,0,0
5242,ACGTCGAATCTAGAGA,84,87,3,12,4051,0,0
5243,ACGTCGAATCTAGGGA,84,87,3,10,4055,0,0
5244,ACGTCGAATCTAGGGA,84,87,3,11,4065,0,0
5245,ACGTCGAATCTAGGGA,84,87,3,12,4412,0,0
5246,ACGTCGAATCTAGGGA,84,87,3,13,4413,0,0
5247,ACGTCGAATCTAGGGA,84,86,2,11,4457,0,0
5248,ACGTAGAATCTAGGGA,84,87,3,12,4462,0,0
5249,ACGTCGAATCTAGGGA,84,84,0,11,4464,0,0
5250,ACGTCGAATCTAGGGA,84,87,3,14,4579,0,0
5251,ACGTCGAATATAGGGA,84,87,3,12,4582,0,0
5252,TCGTCGAATCTAGGGA,84,87,3,12,4583,0,0
5253,ACGTCGAATCTAGGGA,84,86,2,15,4587,0,0
5254,ACGTCGAATCTAGGGA,84,87,3,15,4591,0,0
5255,ACGTCGAATCTAGGGA,84,87,3,11,4594,0,0
5256,ACGTCGAATCTAGGGA,84,87,3,12,4596,0,0
5257,ACGTCGAATCTAGGGA,84,85,1,11,4623,0,0
5258,ACGTCGAATCTAGGGA,84,87,3,12,4624,0,0
5259,ACGTCGAATCTAGGGA,84,87,3,9,4625,0,0
5260,ACGTCGAATCTAGGGA,84,84,0,10,4626,0,0
5261,ACGTCGAATCTAGGGA,84,87,3,11,4627,0,0
5262,ACGTAGAATCTAGGGA,84,85,1,12,4632,0,0
5263,ACGTCGAATCTAGGGA,84,87,3,11,4633,0,0
5264,ACGTCGAATCTAGGGA,84,86,2,11,4638,0,0
5265,ACGTCGAATCTAGGGA,84,84,0,11,4639,0,0
5266,ACGTCGAATCTAGGGA,84,87,3,18,4640,0,0
5267,ACGTCGAATCTAGGGA,84,87,3,14,4646,0,0
5268,ACGTCGAATCTAGGGA,84,85,1,13,4647,0,0
5269,ACGTCGAATCTAGGGA,84,87,3,15,4648,0,0
5270,ACGTCGAATCTAGGGA,84,87,3,10,4652,0,0
5271,ACGTCGAATCTAGGGA,84,87,3,15,4653,0,0
5272,ACGTCGAATCTAGGGA,84,87,3,13,4662,0,0
5273,ACGTCGAATCTAGGGA,84,87,3,11,4664,0,0
5274,ACGTCGAATCTAGGTA,84,87,3,14,4765,0,0
5275,ACGTCGAATCTAGGGA,84,87,3,13,4768,0,0
5276,ACGTCGAATCTAGGGA,84,87,3,12,4771,0,0
5277,ACGTCGAATCTAGGGA,85,91,6,12,1476,0,0
5278,ACGTCGAATCTAGGGA,85,89,4,13,1478,0,0
5279,ACGTCGAATCTAGGGA,85,89,4,12,1506,0,0
5280,ACGTCGAATCTAGGGA,85,88,3,13,1519,0,0
5281,ACGTCGAATCTAGGGA,85,90,5,14,1553,0,0
5282,ACGTCGAATCTAGGGA,85,97,12,14,1966,2,0
5283,ACGTCGAATCTAGGGA,85,87,2,12,1968,0,0
5284,ACGTCGAATCTAGGGA,85,124,39,17,1977,11,0
5285,ACGTCGAATCTAGGGA,85,89,4,13,1984,0,0
5286,ACGTCGAATCTAGGGA,85,88,3,13,1985,0,0
5287,ACGTCGAATCTAGGGA,85,90,5,14,2023,0,0
5288,ACGTCGAATCTAGGGA,85,125,40,13,2041,11,0
5289,ACGTCGAATCTAGGGA,85,86,1,12,2045,0,0
5290,ACGTCGAATCTAGGGA,85,91,6,12,2057,0,0
5291,ACGTCGAATCTAGGGA,85,91,6,13,4140,0,0
5292,ACGTCGAATCTAGGGA,85,86,1,13,4387,0,0
5293,ACGTCGAATCTAGGGA,85,86,1,15,4395,0,0
5294,ACGTCGAATCTAGGGA,85,89,4,15,4402,0,0
5295,ACGTCGAATCTAGGGA,85,95,10,15,4562,1,0
5296,ACGTCGAATCTAGGGA,85,97,12,13,4563,2,0
5297,ACGTCTAATCTAGGGA,85,85,0,14,4564,0,0
5298,ACGTCGAATCTAGGGA,85,88,3,14,4567,0,0
5299,ACGTCGAATCTAGGGA,85,90,5,8,4605,0,0
5300,ACGTCGAATCTAGGGA,85,86,1,10,4609,0,0
5301,ACGTCGAATCTAGGGA,85,104,19,11,4614,4,0
5302,ACGTCGAATCTAGGGA,85,98,13,13,4616,2,0
5303,ACGTCGAATCTAGGGA,85,87,2,11,4620,0,0
5304,ACGTCGAATCTAGGGA,85,86,1,14,4741,0,0
5305,ACGTCGAATCTAGGGA,85,91,6,13,4750,0,0
5306,ACGTCGAATCTAGGGA,85,112,27,14,4756,7,0
5307,ACGTCGAATCAAGGGA,85,98,13,14,4757,2,0
5308,ACGTCGAATCTAGGGA,85,92,7,9,4758,0,0
5309,ACGTCGAATCTAGGGA,85,127,42,13,4762,12,0
5310,ACGTCGAATCTAGGGA,85,92,7,16,4763,0,0
5311,ACGTCGAATCTAGGGA,85,85,0,8,4831,0,0
5312,ACGTCGAATCTAGGGA,85,95,10,9,4832,1,0
5313,ACGTCGAATCTAGGGA,85,97,12,10,4833,2,0
5314,ACGTCGAATCTAGGGA,85,86,1,10,4834,0,0
5315,ACGTCGAATCTAGGGA,85,89,4,9,4836,0,0
5316,ACGTCGAATCTAGGGA,85,90,5,11,4837,0,0
5317,ACGTCGAATCTAGGGA,85,86,1,11,4838,0,0
5318,ACGTCGAATCTAGGGA,86,112,26,8,1467,7,0
5319,ACGTCGAATCTAGGGA,86,92,6,12,1471,1,0
5320,ACGTCGAATCTAGGGA,86,90,4,11,1788,0,0
5321,ACGTCGAATCTAGGGA,86,90,4,11,1818,0,0
5322,ACGTCGAATCTAGGGA,86,86,0,14,1833,0,0
5323,ACGTCGAATCTAGGGA,86,86,0,15,1842,0,0
5324,ACGTCGAATCTAGGGA,86,90,4,12,1916,0,0
5325,ACGTCGAATCTAGGGA,86,88,2,14,2859,0,0
5326,ACGTCGAATCTAGGGA,86,110,24,14,2863,7,0
5327,ACGTCGAATCTAGGGA,86,92,6,14,2864,1,0
5328,ACGTCGAATCTAGGGA,86,86,0,15,2895,0,0
5329,CCGTCGAATCTAGGGA,86,108,22,12,2910,6,0
5330,ACGTCGAAGCTAGGAA,86,86,0,16,2916,0,0
5331,ACGTCGAATCTAGGGA,86,90,4,10,4082,0,0
5332,ACGTCGAATCTAGGGA,86,93,7,11,4083,1,0
5333,ACGTCGAATCTAGGGA,86,87,1,14,4092,0,0
5334,ACGTCGAATCTAGGGA,86,94,8,10,4103,1,0
5335,ACGTCGAATCTAGGGA,86,121,35,12,4104,10,0
5336,ACGTCGAATCTAGGGA,86,106,20,14,4109,5,0
5337,ACGTCGAATCTAGGGA,86,98,12,13,4117,3,0
5338,ACGTCGAATCTAGGGA,86,101,15,9,4238,4,0
5339,ACGTCGAATCTAGGGA,86,86,0,9,4239,0,0
5340,ACGTCGAATCTAGGGA,86,98,12,10,4420,2,0
5341,ACGTCGAATCTAGGGA,86,95,9,10,4422,1,0
5342,ACGTCGAATCTAGGGA,86,93,7,13,4432,0,0
5343,ACGTCGAATCTAGGGA,86,87,1,12,4436,0,0
5344,ACGTCGAATCTAGGGA,86,102,16,11,4438,3,0
5345,ACGTCGAATCTAGGGA,86,89,3,10,4447,0,0
5346,AGGTCGAATCTAGGGA,86,105,19,13,4599,4,0
5347,ACGTCGAATCTAGAGA,86,97,11,14,4600,2,0
5348,ACGTCGAATCTAGGGA,86,103,17,10,4775,4,0
5349,AAGTCGAATCTAGGGA,86,89,3,12,4782,0,0
5350,ACGTCGAATCTAGGGA,86,94,8,15,4785,1,0
5351,ACGTCGAATCTAGGGA,86,101,15,14,4786,3,0
5352,ACGTCGAATCTAGGGA,86,88,2,18,4788,0,0
5353,ACGTCGAATCTAGGGA,86,88,2,13,4790,0,0
5354,ACGTCGAAGCTAGGAA,86,88,2,17,4792,0,0
5355,ACGTCGAATCTAGGGA,86,97,11,13,4793,2,0
5356,ACGTCGAATCTAGGGA,86,92,6,17,4796,0,0
5357,ACGTCGAATCTAGGGA,86,95,9,11,4799,1,0
5358,ACGTCGAATCTAGGGA,86,99,13,11,4805,2,0
5359,ACGTCGAATCTAGGGA,86,94,8,13,4934,1,0
5360,ACGTCGAATCTAGGGA,86,90,4,14,4937,0,0
5361,ACGTCGAATCTAGGGA,86,86,0,13,4938,0,0
5362,ACGTCGAATCTAGGGA,86,91,5,14,4940,0,0
5363,ACGTCGAATCTAGGGA,86,95,9,10,4941,1,0
5364,ACGTCGAATCTAGGGA,86,92,6,15,4942,0,0
5365,ACGTCGAATCTAGGGA,86,128,42,15,4943,12,0
5366,ACGTCGAATCTAGGGA,86,98,12,14,4948,2,0
5367,ACGTCGAATCTAGGGA,86,95,9,14,4952,1,0
5368,ACGTCGAATCTAGGGA,86,104,18,13,4953,3,0
5369,ACGTCGAATCTAGGGA,86,116,30,14,4956,7,0
5370,ACGTCGAATCTAGGGA,87,105,18,8,294,4,0
5371,ACGTCGAATCTAGGGA,87,93,6,9,376,0,0
5372,ACGTCGAATCTAGGGA,87,93,6,9,470,0,0
5373,ACGTCGAATCTAGGGA,87,100,13,11,632,2,0
5374,ACGTCGAATCTAGGGA,87,93,6,12,728,0,0
5375,CCGTCGAATCTAGTGA,87,105,18,10,730,4,0
5376,ACGTCGAATCTAGGGA,87,123,36,9,848,10,0
5377,ACGTCGAATCTAGGGA,87,102,15,10,858,3,0
5378,ACGTCGAATCTAGGGA,87,94,7,9,867,0,0
5379,ACGTCGAATCTAGGGA,87,87,0,13,905,0,0
5380,ACGTCGAATCTAGGGA,87,104,17,9,906,4,0
5381,ACGTCGAATCTAGGGA,87,91,4,11,965,0,0
5382,ACGTAGAATCTAGGGA,87,106,19,11,989,4,0
5383,ACGTCGAATCTAGGGA,87,100,13,11,1050,2,0
5384,ACGTCGAATCTAGGGA,87,90,3,13,1062,0,0
5385,ACGTCGAATCTAGGGA,87,90,3,11,1075,0,0
5386,ACGACGAATCTAGGGA,87,90,3,13,1086,0,0
5387,ACGTCGAATCTAGGGA,87,87,0,8,1132,0,0
5388,ACGTCGAATCTAGGGA,87,90,3,13,1187,0,0
5389,ACGTCGAATCTAGGGA,87,90,3,8,1193,0,0
5390,ACGTCGAATCTAGGGA,87,90,3,12,1238,0,0
5391,ACGTCGAATCTAGGGA,87,90,3,9,1288,0,0
5392,ACGTCGAATCTAGGGA,87,87,0,12,1337,0,0
5393,ACGTCGAATCTCGGGA,87,90,3,11,1411,0,0
5394,ACGTCGAATCTAGGGA,87,87,0,11,1557,0,0
5395,ACGTCGAATCTAGGGA,87,90,3,9,1562,0,0
5396,ACGTCGAATCTAGGGA,87,90,3,9,1570,0,0
5397,ACGTCGAATCTAGGGA,87,90,3,13,1627,0,0
5398,ACGTCGAATCTAGGGA,87,90,3,11,1629,0,0
5399,ACGTCGAATCTAGGGA,87,90,3,12,1640,0,0
5400,ACGTCGAATCTAGGGA,87,90,3,11,1679,0,0
5401,ACGTCGAATCTAGGGA,87,87,0,10,1688,0,0
5402,ACGTCGAATCTAGGGA,87,90,3,13,1741,0,0
5403,ACGTCGAAGCTAGGAA,87,90,3,14,1774,0,0
5404,ACGTCGAATCTAGGGA,87,90,3,8,1780,0,0
5405,ACGTCGAATCTAGGGA,87,90,3,9,4025,0,0
5406,ACGTCGAATCTAGGGA,87,90,3,10,4027,0,0
5407,ACGTCGAATCTAGGGA,87,87,0,9,4040,0,0
5408,ACGTCGAATCTAGGGA,87,90,3,13,4046,0,0
5409,ACGTCGAATCTAGGGA,87,90,3,12,4051,0,0
5410,ACGTCGAATCTAGGGA,87,88,1,12,4412,0,0
5411,ACGTCGAATCTAGGGA,87,90,3,13,4413,0,0
5412,ACGTCGAATCTAGGGA,87,88,1,11,4464,0,0
5413,ACGTCGAATCTAGGGA,87,90,3,14,4579,0,0
5414,ACGTCGAATATAGGGA,87,90,3,12,4582,0,0
5415,ACGTCGAATCTAGGGA,87,88,1,11,4594,0,0
5416,ACGTCGAATCTAGGGA,87,89,2,12,4596,0,0
5417,ACGTCGAATCTAGGGA,87,90,3,11,4623,0,0
5418,TCGTCGAATCTAGGGA,87,90,3,12,4624,0,0
5419,ACGTCGAATCTATGGA,87,87,0,9,4625,0,0
5420,ACGTCGAATCTAGGGA,87,90,3,11,4627,0,0
5421,ACGTAGAATCTAGGGA,87,87,0,12,4632,0,0
5422,ACGTCGAATCTAGGGA,87,90,3,11,4633,0,0
5423,ACGTCGAATCTAGGGA,87,88,1,11,4638,0,0
5424,ACGTCGAATCTAGGGA,87,90,3,11,4639,0,0
5425,ACGTCGAATCTAGGGA,87,90,3,18,4640,0,0
5426,ACGTCGAATCTAGGGA,87,90,3,14,4646,0,0
5427,ACGTCGAATCTAGGGA,87,90,3,13,4647,0,0
5428,ACGTCGAATCTAGGGA,87,90,3,15,4648,0,0
5429,ACGTCGAATCTAGGGA,87,90,3,10,4652,0,0
5430,ACGTCGAATCTAGGGA,87,90,3,15,4653,0,0
5431,ACGTCGAATCTAGGGA,87,90,3,11,4664,0,0
5432,ACGTCGAATCTAGGGA,87,88,1,13,4768,0,0
5433,ACGTCGAATCTAGGGA,87,90,3,12,4771,0,0
5434,ACGTCGAATCTAGGGA,87,90,3,11,4841,0,0
5435,ACGTCGAATCTAGGGA,87,90,3,9,4846,0,0
5436,ACGTCGAATCTAGGGA,87,90,3,10,4847,0,0
5437,ACGTCGAATCTAGGGA,87,87,0,11,4848,0,0
5438,ACGTCGAATCTAGGGA,87,90,3,9,4971,0,0
5439,ACGTCGAATCTAGGGA,87,89,2,13,4972,0,0
5440,ACGTCGAATCTAGGGA,87,88,1,13,4980,0,0
5441,ACGTCGAATCTAGGGA,87,90,3,14,4993,0,0
5442,ACGTCGAATAGAGGGA,87,88,1,17,4994,0,0
5443,ACGTCGAATCTAGGGA,87,89,2,10,4997,0,0
5444,ACGTCGAATCTAGGGA,87,90,3,12,4999,0,0
5445,ACGTCGAATCTAGGGA,87,88,1,13,5001,0,0
5446,ACGTCGAATCTAGGGA,87,90,3,15,5002,0,0
5447,ACGTCGAATCTAGGGA,88,108,20,12,1476,5,0
5448,ACGTCGAATCTAGGGA,88,99,11,12,1506,2,0
5449,ACGTCGAATCTAGGGA,88,91,3,13,1519,0,0
5450,ACGTCGAATCGAGGGA,88,120,32,14,1553,9,0
5451,ACGTCGAATCTAGGGA,88,89,1,12,1968,0,0
5452,ACGTCGAATCTAGGGA,88,92,4,17,1977,0,0
5453,ACGTCGAATCTAGGGA,88,93,5,13,1984,0,0
5454,ACGTCGAATCTAGGGA,88,96,8,14,2023,1,0
5455,ACGTCGAATCTAGGGA,88,93,5,13,2041,0,0
5456,ACGTCGAATCTAGGGA,88,113,25,12,2045,6,0
5457,ACGTCGAATCTAGGGA,88,105,17,13,4140,4,0
5458,ACGTCGAATCTAGGGA,88,92,4,13,4387,0,0
5459,ACGTCGAATCTAGGGA,88,109,21,15,4395,5,0
5460,ACGTCGAATCTAGGGA,88,108,20,15,4562,5,0
5461,ACGTCGAATCTAGGGA,88,89,1,13,4563,0,0
5462,AAGTCTAATCTAGGGA,88,97,9,14,4564,1,0
5463,ACGTCGAATCTAGGGA,88,101,13,14,4567,2,0
5464,ACGTCGAATCTAGGGA,88,88,0,13,4616,0,0
5465,ACGTCGAATCTAGGGA,88,99,11,14,4741,2,0
5466,ACGTCGAATCTAGGGA,88,92,4,13,4750,0,0
5467,ACGTCGAATCAAGGGA,88,90,2,14,4757,0,0
5468,ACGTCGAATCTAGGGA,88,89,1,8,4831,0,0
5469,ACGTCGAATCTAGGGA,88,120,32,10,4833,9,0
5470,ACGTCGAATCTAGGGA,88,108,20,11,4837,5,0
5471,ACGTCGAATCTAGGGA,88,92,4,11,4838,0,0
5472,ACGTCGAATCTAGGGA,88,89,1,11,4959,0,0
5473,ACGTCGAATCTAGGGA,88,103,15,14,4963,3,0
5474,ACGTCGAATCTAGGGA,88,91,3,14,4964,0,0
5475,ACGTCGAATCTAGGGA,88,88,0,7,5024,0,0
5476,ACGTCGAATCTAGGGA,88,115,27,8,5025,7,0
5477,ACGTCGAATCTAGGGA,88,101,13,10,5028,2,0
5478,ACGCCGAATCTAGGGA,88,89,1,11,5030,0,0
5479,ACGTCGAATCTAGGGA,88,96,8,12,5031,1,0
5480,ACGTCGAATCTAGGGA,88,88,0,13,5032,0,0
5481,ACGTCGAATCTAGGGA,88,104,16,11,5034,3,0
5482,ACGTCGAATCTAGGGA,88,112,24,12,5035,6,0
5483,ACGTCGAATCTAGGGA,88,89,1,10,5037,0,0
5484,ACGTCGAATCTAGGGA,88,107,19,11,5038,4,0
5485,ACGTCGAATCTAGGGA,88,121,33,11,5151,9,0
5486,ACGTCGAATCTAGGGA,88,88,0,12,5155,0,0
5487,ACGTCGAATCTAGGGA,88,94,6,15,5157,0,0
5488,ACGTCGAATCTAGGGA,88,88,0,16,5158,0,0
5489,ACGTCGAATCTAGGGA,88,93,5,13,5159,0,0
5490,ACGTCGAATCTAGGGA,88,89,1,14,5160,0,0
5491,ACGTCGAATCTAGGGA,88,90,2,15,5161,0,0
5492,ACGTCGAATCTAGGGA,89,94,5,8,1467,0,0
5493,ACGTCGAATCTAGGGA,89,93,4,12,1471,0,0
5494,ACGTCGAATCTAGGGA,89,109,20,14,1833,5,0
5495,ACGTCGAATCTAGGGA,89,114,25,15,1842,7,0
5496,ACGTCGAATCTAGGGA,89,89,0,12,1916,0,0
5497,ACGTCGAATCTAGGGA,89,93,4,14,2859,0,0
5498,ACGTCGAATCTAGGGA,89,131,42,14,2863,13,0
5499,ACGTCGAATCTAGGGA,89,102,13,14,2864,3,0
5500,ACGTCGAATCTAGGGA,89,100,11,15,2895,2,0
5501,ACGTCGAATCTAGGGA,89,92,3,12,2910,0,0
5502,ACGTCGAAGCGAGGAA,89,92,3,16,2916,0,0
5503,ACGTCGAATCTAGGGA,89,93,4,10,4082,0,0
5504,ACGTCGAATCTAGGGA,89,90,1,11,4083,0,0
5505,ACGTCGAATCTAGGGA,89,89,0,14,4109,0,0
5506,ACGTCGAATCTAGGGA,89,99,10,13,4117,1,0
5507,ACGTCGAATCTAGGGA,89,90,1,9,4238,0,0
5508,ACGTCGAATCTAGGGA,89,92,3,9,4239,0,0
5509,ACGTCGAATCTAGGGA,89,89,0,10,4420,0,0
5510,ACGTCGAATCTAGGGA,89,102,13,10,4422,2,0
5511,ACGTCGAATCTAGGGA,89,91,2,13,4432,0,0
5512,ACGTCGAATCTAGGGA,89,99,10,12,4436,1,0
5513,ACGTCGAATCTAGGGA,89,104,15,11,4438,3,0
5514,ACGTCGAATCTAGGGA,89,90,1,10,4447,0,0
5515,ACGTCGAATCTAGGGA,89,116,27,14,4600,7,0
5516,ACGTCGAATCTAGGGA,89,127,38,10,4775,11,0
5517,ACGTCGAATCTAGGGA,89,90,1,14,4786,0,0
5518,ACGTCGAATCTAGGGA,89,107,18,18,4788,4,0
5519,ACGTCGAATCTAGGGA,89,90,1,13,4790,0,0
5520,ACGTCGAAGCTAGGAA,89,89,0,17,4792,0,0
5521,ACGTCGAATCTAGGGA,89,97,8,17,4796,1,0
5522,ACGTCGAATCTAGGGA,89,96,7,14,4937,0,0
5523,ACGTCCAATCTAGGGA,89,92,3,13,4938,0,0
5524,ACGTCGAATCTAGGGA,89,94,5,14,4940,0,0
5525,ACGTCGAATCTAGGGA,89,93,4,10,4941,0,0
5526,ACGTCGAATCTAGGGA,89,94,5,15,4942,0,0
5527,ACGTCGAATCTAGGGA,89,102,13,14,4948,2,0
5528,ACGTCGAATCTAGGGA,89,107,18,14,4952,4,0
5529,ACGTCGAATCTAGGGA,89,91,2,14,4956,0,0
5530,ACGTCGAATCTAGGGA,89,93,4,11,5004,0,0
5531,ATGTCGAATCTAGGGA,89,91,2,14,5008,0,0
5532,ACGTCGAATCTAGGGA,89,92,3,12,5010,0,0
5533,ACGTCGATTCTAGGGA,89,111,22,10,5013,5,0
5534,ACGTCGAATCTAGGGA,89,89,0,12,5021,0,0
5535,ACGTCGAATCTAGGGA,89,108,19,13,5114,4,0
5536,ACGTCGAATCTAGGGA,89,118,29,15,5118,8,0
5537,ACGTCGAATCTAGGGA,89,93,4,18,5121,0,0
5538,ACGTCGAATCTAGGGA,89,104,15,14,5123,3,0
5539,ACGTCGAATCTAGGGA,89,94,5,15,5124,0,0
5540,ACGTCGAATCTAGGGA,89,106,17,11,5131,3,0
5541,ACGTCGAATCTAGGGA,89,95,6,16,5134,0,0
5542,ACGTCGAACCTAGGGA,89,99,10,16,5136,1,0
5543,ACGTCGAATCTAGGGA,89,94,5,16,5137,0,0
5544,ACGTCGAATCTAGGGA,89,100,11,14,5138,1,0
5545,ACGTCTAATCTAGGGA,89,101,12,15,5139,1,0
5546,ACGTCGAATCTAGGGA,89,89,0,8,5142,0,0
5547,ACGTCGAATCTAGGGA,89,93,4,12,5147,0,0
5548,ACGTCGAATCTAGGGA,89,92,3,7,5190,0,0
5549,ACGTCGAATCTAGGGA,89,92,3,9,5191,0,0
5550,ACGTCGAATCTAGGGA,89,92,3,10,5193,0,0
5551,ACGTCGAATCTAGGGA,89,90,1,12,5194,0,0
5552,ACGTCGAATCTAGGGA,89,90,1,13,5195,0,0
5553,ACGTCGAATCTAGGGA,90,107,17,8,294,4,0
5554,ACGTCGAATCTAGGGA,90,98,8,9,376,1,0
5555,ACGTCGAATCTAGGGA,90,92,2,9,470,0,0
5556,ACGTCGAATCTAGGGA,90,101,11,11,632,2,0
5557,ACGTCGAATCTAGGGA,90,90,0,12,728,0,0
5558,ACGTCGAATCTAGTGA,90,96,6,10,730,0,0
5559,ACGTCGAATCTAGGGA,90,94,4,10,858,0,0
5560,ACGTCGAATCTAGGGA,90,92,2,9,867,0,0
5561,ACGTCGAATCTAGGGA,90,93,3,13,905,0,0
5562,ACGTCGAATCTAGGGA,90,93,3,9,906,0,0
5563,ACGTAGAATCTAGGGA,90,93,3,11,989,0,0
5564,ACGTCGAATCTAGGGA,90,93,3,13,1062,0,0
5565,ACGTCGAATCTAGGGA,90,90,0,11,1075,0,0
5566,ACGTCGAATCTAGGGA,90,90,0,8,1132,0,0
5567,ACGTCGAATCTAGGGA,90,91,1,13,1187,0,0
5568,ACGTCGAATCTAGGGA,90,93,3,8,1193,0,0
5569,ACGTCGAATCTAGGGA,90,93,3,12,1238,0,0
5570,ACGTCGAATCTAGGGA,90,93,3,12,1337,0,0
5571,ACGTCGAATCTAGGGA,90,93,3,11,1411,0,0
5572,ACGTCGAATCTAGGGA,90,93,3,11,1557,0,0
5573,ACGTCGAATCTAGGGA,90,93,3,9,1562,0,0
5574,ACGTCGAATCTAGGGA,90,92,2,13,1627,0,0
5575,ACGTCGAATCTAGGGA,90,93,3,11,1629,0,0
5576,ACGTCGAATCTAGGGA,90,93,3,12,1640,0,0
5577,ACGTCGAATCTAGGGA,90,91,1,11,1679,0,0
5578,ACGTCGAATCTAGGGA,90,93,3,13,1741,0,0
5579,ACGTCGAATCTAGGGA,90,93,3,8,1780,0,0
5580,ACGTCGAATCTAGGGA,90,93,3,9,4025,0,0
5581,ACGTCGAATCTAGGGA,90,93,3,10,4027,0,0
5582,ACGTCGAATCTAGGGA,90,93,3,9,4040,0,0
5583,ACGTCGAATCTAGGGA,90,93,3,13,4046,0,0
5584,ACGTCGAATCTAGGGA,90,92,2,12,4051,0,0
5585,ACGTCGAATCTAGGGA,90,93,3,12,4412,0,0
5586,ACGTCGAATCTAGGGA,90,93,3,11,4464,0,0
5587,ACGTCGAATATAGGGA,90,93,3,12,4582,0,0
5588,ACGTCGAATCTAGGGA,90,93,3,11,4594,0,0
5589,ACGTCGAATCTAGGGA,90,93,3,12,4596,0,0
5590,ACGTCGAATCTAGGGA,90,92,2,12,4624,0,0
5591,ACGTCGAATCTAGGGA,90,93,3,9,4625,0,0
5592,ACGTCGAATCTAGGGA,90,93,3,11,4627,0,0
5593,ACGTAGAATCTAGGGA,90,93,3,12,4632,0,0
5594,ACGTCGAATCTAGGGA,90,90,0,11,4633,0,0
5595,ACGTCGAATCTAGGGA,90,91,1,11,4638,0,0
5596,ACGTCGAATCTAGGGA,90,93,3,14,4646,0,0
5597,ACGTCGAATCTAGGGA,90,93,3,13,4647,0,0
5598,ACGTCGAATCTAGGGA,90,92,2,10,4652,0,0
5599,ACGTCGAATCTAGGGA,90,93,3,15,4653,0,0
5600,ACGTCGAATCTAGGGA,90,93,3,11,4664,0,0
5601,ACGTCGAATCTAGGGA,90,93,3,13,4768,0,0
5602,ACGTCGAATCTAGGGA,90,90,0,12,4771,0,0
5603,ACGTCGAATCTAGGGA,90,90,0,11,4841,0,0
5604,ACGTCGAATCTAGGGA,90,92,2,9,4846,0,0
5605,ACGTCGAATTTAGGGA,90,93,3,11,4848,0,0
5606,ACGTCGAATCTAGGGA,90,93,3,9,4971,0,0
5607,ACGTCGAATCTAGGGA,90,93,3,13,4972,0,0
5608,ACGTCGAATCTAGGGA,90,93,3,13,4980,0,0
5609,ACGTCGAATCTAGGGA,90,93,3,14,4993,0,0
5610,ACGTCGAATAGAGGGA,90,93,3,17,4994,0,0
5611,ACGTCGAATCTAGGGA,90,93,3,10,4997,0,0
5612,ACGTCGAATCTAGGGA,90,90,0,12,4999,0,0
5613,ACGTCGAAGCTAGGAA,90,92,2,17,5166,0,0
5614,ACGTCGAATCTAGGGA,90,93,3,11,5168,0,0
5615,ACGTCGAATCTAGGGA,90,93,3,14,5170,0,0
5616,ACGTCGAATCTAGTGA,90,93,3,11,5172,0,0
5617,ACGTCGAATCTAGGGA,90,93,3,13,5173,0,0
5618,ACGTCGAATCTAGGGA,90,93,3,15,5174,0,0
5619,ACGTCGAGTCTCGGGA,90,93,3,13,5175,0,0
5620,ACGTCGAATCTAGGGA,90,93,3,14,5176,0,0
5621,ACGTCGAATCTAGGGA,90,93,3,11,5177,0,0
5622,ACGTCGAATCTAGGGA,90,93,3,10,5179,0,0
5623,ACGTCGAATCTAGGGA,90,93,3,10,5180,0,0
5624,ACGTAGAATCTAGGGA,90,93,3,11,5181,0,0
5625,ACGTCGAATCTAGGGA,90,93,3,11,5182,0,0
5626,ACGTCGAATCTACGGA,90,93,3,13,5184,0,0
5627,ACGTCGAATCTAGGGA,90,93,3,12,5185,0,0
5628,ACGTCGAATCTAGGGA,90,93,3,11,5186,0,0
5629,ACGTCGAATCTAGGGC,90,93,3,15,5187,0,0
5630,ACGTCGAATCTAGGGA,90,93,3,15,5189,0,0
5631,ACGTCGAATCTAGGGA,91,94,3,12,1476,0,0
5632,ACGTCGAATCTAGGGA,91,97,6,12,1506,0,0
5633,ACGTCGAATCTAGGGA,91,93,2,13,1519,0,0
5634,ACGTCGAATCTAGGGA,91,92,1,14,1553,0,0
5635,ACGTCGAATCTAGGGA,91,95,4,12,1968,0,0
5636,ACGTCGAATCTAGGGA,91,104,13,13,2041,2,0
5637,ACGTCGAATCTAGGGA,91,91,0,12,2045,0,0
5638,ACGTCGAATCTAGGGA,91,99,8,13,4140,1,0
5639,ACGGCGAATCTAGGGA,91,117,26,13,4387,7,0
5640,ACGTCTAATCTAGGGA,91,102,11,14,4564,2,0
5641,ACGTCGAATCTAGGGA,91,101,10,14,4567,1,0
5642,ACGTCGATTCTAGGGA,91,100,9,14,4741,1,0
5643,ACGTCGAATCAAGGGA,91,100,9,14,4757,1,0
5644,ACGTCGAATCTAGGGA,91,93,2,10,4833,0,0
5645,ACGTCGAATCTAGGGA,91,92,1,11,4837,0,0
5646,ACGTCGAATCTAGGGA,91,92,1,11,4959,0,0
5647,ACGTCGAATCTAGGGA,91,109,18,14,4963,4,0
5648,ACGTCGAATCTAGGGA,91,105,14,7,5024,3,0
5649,ACGTCGAATCTAGGGA,91,91,0,8,5025,0,0
5650,ACGTCGAATCTAGGGA,91,101,10,11,5030,1,0
5651,ACGTCGAATCTAGGGA,91,92,1,12,5031,0,0
5652,ACGTCGAATCTAGGGA,91,91,0,11,5034,0,0
5653,ACGTCGAATCTAGGGA,91,99,8,12,5035,1,0
5654,ACGTCGAATCTAGGGA,91,93,2,11,5038,0,0
5655,ACGTCGAATCTAGGGA,91,91,0,11,5151,0,0
5656,ACGTCGAATCTAGGGA,91,98,7,15,5157,0,0
5657,ATGTCGAATCTAGGGA,91,106,15,16,5158,3,0
5658,ACGTCGAATCTAGGGA,91,104,13,13,5159,2,0
5659,ACGTCGAATCTAGGGA,91,113,22,14,5160,5,0
5660,ACGTCGAATCTAGGGA,91,94,3,9,5197,0,0
5661,ACGTCGAATCTAGGGA,91,95,4,11,5199,0,0
5662,ACGTCGAATCTAGGGA,91,99,8,14,5201,1,0
5663,ACGTCGAATCTAGGGA,91,91,0,12,5203,0,0
5664,ACGTCGAATCTAGGGA,91,111,20,18,5205,5,0
5665,ACGTCGAATCTAGGGA,91,96,5,12,5206,0,0
5666,ACGTCGAATCTAGGGA,91,99,8,9,5318,1,0
5667,ACGTCGAATCTAGGGA,91,96,5,13,5319,0,0
5668,ACGTCGAATCTAGGGA,91,124,33,15,5326,9,0
5669,ACGTCGAATCTAGGGA,91,94,3,15,5327,0,0
5670,CCGTCGAATCTAGGGA,91,97,6,13,5329,0,0
5671,ACGTCGAATCTAGGGA,91,92,1,12,5332,0,0
5672,ACGTCGAATCTAGGGA,91,92,1,11,5334,0,0
5673,ACGTCGAATCTAGGGA,91,116,25,13,5335,6,0
5674,ACGTCGAATCTAGGGA,91,94,3,15,5336,0,0
5675,ACGTCGAATCTAGGGA,91,93,2,14,5337,0,0
5676,ACGTCGAATCTAGGGA,91,93,2,10,5338,0,0
5677,ACGTCGAATCTAGGGA,92,96,4,8,1467,0,0
5678,ACGTCGAATCTAGGGA,92,109,17,12,1471,4,0
5679,ACGTCGAATCTAGGGA,92,92,0,14,1833,0,0
5680,ACGTCGAATCTAGGGA,92,99,7,12,1916,1,0
5681,ACGTCGAATCTAGGGA,92,93,1,14,2859,0,0
5682,ACGTCGAATCTAGGGA,92,94,2,14,2864,0,0
5683,ACGTCGAATCTAGGGA,92,92,0,15,2895,0,0
5684,ACGTCGAATCTAGGGA,92,110,18,12,2910,5,0
5685,ACGTCGAAGCTAGGAA,92,97,5,16,2916,0,0
5686,ACGTCGAATCTAGGGA,92,104,12,10,4082,3,0
5687,ACGTCGAATCTAGGGA,92,101,9,11,4083,2,0
5688,ACGTCGAATCTAGGGA,92,92,0,14,4109,0,0
5689,ACGTCGAATCTAGGGA,92,99,7,13,4117,1,0
5690,ACGTCGAATCTAGGGA,92,110,18,10,4420,5,0
5691,ACGTCGAATCTAGGGA,92,100,8,10,4422,1,0
5692,ACGTCGAATCTAGGGA,92,93,1,12,4436,0,0
5693,ACGTCGAATCTAGGGA,92,108,16,10,4447,3,0
5694,ACGTCGAATCTAGGGA,92,100,8,14,4600,1,0
5695,ATGTCGAATCTAGGGA,92,98,6,10,4775,0,0
5696,ACGTCGAATCTAGGGA,92,92,0,14,4786,0,0
5697,ACGTCGAATCTAGGGA,92,115,23,18,4788,6,0
5698,ACGTCGAATCTAGGGA,92,92,0,13,4790,0,0
5699,ACGTCGAATCTAGGGA,92,96,4,13,4938,0,0
5700,ACGTCGAATCTAGGGA,92,97,5,10,4941,0,0
5701,ACGTCGAATCTAGGGA,92,118,26,15,4942,7,0
5702,ACGTCGAATCTAGGGA,92,103,11,14,4948,2,0
5703,ACGTCGAATCTAGGGA,92,92,0,14,4952,0,0
5704,ACGTCGAATCTAGGGA,92,96,4,14,4956,0,0
5705,ACGTCGAATCTAGGGA,92,97,5,11,5004,0,0
5706,ACGTCGAATCTAGGGA,92,131,39,14,5008,11,0
5707,ACGTCGAATCTAGGGA,92,96,4,12,5010,0,0
5708,ACGTCGAATCTAGGGA,92,98,6,12,5021,0,0
5709,ACGTCGAATCTAGGGA,92,97,5,13,5114,0,0
5710,ACGTCGAATCTAGGGA,92,101,9,14,5123,1,0
5711,ACGTCGAATCTAGGGA,92,92,0,15,5124,0,0
5712,ACGTCGAATCTAGGGA,92,96,4,16,5134,0,0
5713,ACGTCGAATCTAGGGA,92,114,22,16,5136,5,0
5714,ACGTCGAATCTAGGGA,92,96,4,16,5137,0,0
5715,ACGTCGAATCTAGGGA,92,100,8,14,5138,1,0
5716,ACGTCGAATCTAGGGA,92,105,13,8,5142,2,0
5717,ACGTCGAATCTAGGGA,92,94,2,12,5147,0,0
5718,ACGTCGAATCTAGGGA,92,109,17,7,5190,3,0
5719,ACGTCGAATCTAGGGA,92,92,0,9,5191,0,0
5720,ACGTCGAATCTAGGGA,92,101,9,10,5193,0,0
5721,ACGTCGAATCTAGGGA,92,105,13,12,5194,2,0
5722,ACGTCGAATCTAGGGA,92,101,9,15,5282,0,0
5723,ACGTCGAATCTAGGGA,92,97,5,18,5284,0,0
5724,ACGTCGAATCTAGGGA,92,123,31,14,5288,8,0
5725,ACGTCGAATCTAGGGA,92,96,4,16,5295,0,0
5726,ACGTCGAATCTAGGGA,92,92,0,14,5296,0,0
5727,ACGTCGAATCTAGGGA,92,93,1,12,5301,0,0
5728,ACGTCGAATCTAGGGA,92,101,9,14,5302,0,0
5729,ACGTCGAATCTAGGGA,92,92,0,15,5306,0,0
5730,ACGTCGAATCAAGGGA,92,93,1,15,5307,0,0
5731,ACGTCGAATCTAGGGA,92,111,19,14,5309,4,0
5732,ACGTCGAATCTAGGGA,92,94,2,10,5312,0,0
5733,ACGTCGAATCTAGGGA,92,101,9,11,5313,0,0
5734,ACGTCGAATCTAGGGA,93,93,0,8,294,0,0
5735,ACGTCGAATCTAGGGA,93,116,23,9,376,6,0
5736,ACGTCGAATCTAGGGA,93,107,14,9,470,3,0
5737,ACGTCGAATCTAGGGA,93,94,1,11,632,0,0
5738,ACGTCGAATCTAGGGA,93,94,1,12,728,0,0
5739,ACGTCGAATCTAGTGA,93,96,3,10,730,0,0
5740,ACGTCGAATCTAGGGA,93,99,6,10,858,0,0
5741,ACGTCGAATCTAGGGA,93,95,2,13,905,0,0
5742,ACGTCGAATCTAGGGA,93,103,10,9,906,1,0
5743,ACGTAGAATCTAGGGA,93,100,7,11,989,0,0
5744,ACGTCGAATCTAGGGA,93,98,5,13,1062,0,0
5745,ACGTCGAATCTAGGGA,93,96,3,11,1075,0,0
5746,ACGTCGAATCTAGGGA,93,96,3,8,1193,0,0
5747,ACGTCGAATCTAGGGA,93,96,3,12,1238,0,0
5748,ACGTCGAATCTAGGGA,93,96,3,12,1337,0,0
5749,ACGTCGAATCTAGGGA,93,96,3,11,1411,0,0
5750,ACGTCGAATCTAGGGA,93,96,3,9,1562,0,0
5751,ACGTCGAATCTAGGGA,93,96,3,13,1627,0,0
5752,ACGTCGAATCTAGGGA,93,96,3,12,1640,0,0
5753,ACGTCGAATCTAGGGA,93,94,1,11,1679,0,0
5754,ACGTCGAATCTAGGGA,93,96,3,9,4025,0,0
5755,ACGTCGAATCTAGGGA,93,96,3,10,4027,0,0
5756,ACGTCGAATCTAGGGA,93,94,1,9,4040,0,0
5757,ACGTCGAATCTAGGGA,93,94,1,13,4046,0,0
5758,ACGTCGAATCTAGGGA,93,93,0,12,4051,0,0
5759,ACGTCGAATCTAGGGA,93,96,3,12,4412,0,0
5760,ACGTCGAATCTAGGGA,93,96,3,11,4464,0,0
5761,ACGTCGAATATAGGGA,93,96,3,12,4582,0,0
5762,ACGTCGAATCTAGGGA,93,96,3,11,4594,0,0
5763,ACGTCGAATCTAGGGA,93,96,3,12,4596,0,0
5764,ACGTCGAATCTAGGGA,93,96,3,12,4624,0,0
5765,ACGTCGAATCTAGGGA,93,93,0,11,4627,0,0
5766,ACGTAGAATCTAGGGA,93,96,3,12,4632,0,0
5767,ACGTCGAATCTAGGGA,93,96,3,11,4633,0,0
5768,ACGTCGAATCTAGGGA,93,96,3,11,4638,0,0
5769,ACGTCGAATCTAGGGA,93,96,3,13,4647,0,0
5770,ACGTCGAATCTAGGGA,93,94,1,10,4652,0,0
5771,ACGTCGAATCTAGGGA,93,93,0,15,4653,0,0
5772,ACGTCGAATCTAGGGA,93,96,3,11,4664,0,0
5773,ACGTCGAATCTAGGGA,93,94,1,12,4771,0,0
5774,ACGTCGAATCTAGGGA,93,94,1,11,4841,0,0
5775,ACGTCGAATCTAGGGA,93,96,3,9,4846,0,0
5776,ACGTCGAATCTAGGGA,93,96,3,9,4971,0,0
5777,ACGTCGAATCTAGGGA,93,96,3,13,4972,0,0
5778,ACGTCGAATCTAGGGA,93,96,3,13,4980,0,0
5779,ACGTCGAATCTAGGGA,93,96,3,14,4993,0,0
5780,ACGTCGAATAGAGGGA,93,96,3,17,4994,0,0
5781,ACGTCGAATCTAGGGA,93,93,0,12,4999,0,0
5782,ACGTCGAAGCTAGGAA,93,96,3,17,5166,0,0
5783,ACGTCGAATCTAGGGA,93,96,3,11,5168,0,0
5784,ACGTCGAATCTAGGGA,93,96,3,14,5170,0,0
5785,ACGTCGAATCTAGGGA,93,96,3,13,5173,0,0
5786,ACGTCGAATCTAGGGA,93,96,3,15,5174,0,0
5787,ACGTCGAGTCTCGGGA,93,96,3,13,5175,0,0
5788,ACGTCGAATCTAGGGA,93,96,3,14,5176,0,0
5789,ACGTCGAATCTAGGGA,93,96,3,11,5177,0,0
5790,ACGTCGAATCTAGGGA,93,93,0,10,5180,0,0
5791,ACGTAGAATCTAGGGA,93,96,3,11,5181,0,0
5792,ACGTCGAATCTAGGGA,93,93,0,11,5182,0,0
5793,ACGTCGAATCTACGGA,93,95,2,13,5184,0,0
5794,ACGTCGAATCTAGGGA,93,96,3,12,5185,0,0
5795,ACGTCGAATCTAGGGA,93,96,3,11,5186,0,0
5796,ACGTCGAATCTAGGGC,93,96,3,15,5187,0,0
5797,ACGTCGAATCTAGGGA,93,96,3,15,5189,0,0
5798,ACGTCGAATCTAGGGA,93,94,1,11,5340,0,0
5799,ACGTCGAATCTGGGGA,93,95,2,11,5341,0,0
5800,ACGTCGAATCTAGGGA,93,96,3,12,5344,0,0
5801,AGGTCGAATCGAGGGA,93,96,3,14,5346,0,0
5802,ACGTCGAATCTAGAGA,93,96,3,15,5347,0,0
5803,ACGTCGAATCTAGGGA,93,96,3,11,5348,0,0
5804,ACGTCGAATCTAGGGA,93,96,3,16,5350,0,0
5805,ACGTCGAATCTAGGGA,93,94,1,15,5351,0,0
5806,ACGTCGAATCTAGGGA,93,96,3,14,5355,0,0
5807,ACGTCGAATCTAGGGA,93,96,3,12,5357,0,0
5808,ACGTCGAATCTAGGGA,93,96,3,12,5358,0,0
5809,ACGCCGAATCTAGGGA,93,96,3,14,5359,0,0
5810,ACGTCGAATCTAGGGA,93,96,3,11,5363,0,0
5811,ACGTCGAATCTAGGGA,93,96,3,16,5365,0,0
5812,ACGTCGAATCTAGGGA,93,95,2,15,5366,0,0
5813,ACGTCGAATCTAGGGA,93,93,0,15,5367,0,0
5814,ACGTCGAATCTAGGGA,94,97,3,12,1476,0,0
5815,ACGTCGAATCTAGGGA,94,95,1,12,1506,0,0
5816,ACGTCGAATCTAGGGA,94,97,3,13,1519,0,0
5817,ACGTCGAATCTAGGGA,94,111,17,12,1968,4,0
5818,ACGTCGAATCTAGGGA,94,94,0,12,2045,0,0
5819,ACGTCGAAGCTAGGGA,94,104,10,13,4140,1,0
5820,ACGTCTAATCTAGGGA,94,106,12,14,4564,2,0
5821,ACGTCGAATCTAGGGA,94,114,20,14,4567,5,0
5822,ACGTCGAATCTAGGGA,94,95,1,14,4741,0,0
5823,ACGTCGAATCAAGGGA,94,94,0,14,4757,0,0
5824,ACGTCGAATCTAGGGA,94,107,13,11,4837,2,0
5825,ACGTCGAATCTAGGGA,94,100,6,11,4959,0,0
5826,ACGTCGAATCTAGGGA,94,97,3,14,4963,0,0
5827,ACGTCGAATCTAGGGA,94,111,17,7,5024,4,0
5828,ACGTCGAATCTAGGGA,94,96,2,8,5025,0,0
5829,ACGTCGAATCTAGGGA,94,104,10,12,5031,1,0
5830,ACGTCGAATCTAGGGA,94,101,7,11,5034,0,0
5831,ACGTCGAATCTAGGGA,94,96,2,12,5035,0,0
5832,ACGTCGAATCTAGGGA,94,97,3,11,5038,0,0
5833,ACGTCGAATCTAGGGA,94,100,6,11,5151,0,0
5834,ACGTCGAATCTAGGGA,94,108,14,15,5157,3,0
5835,ACGTCGAATCTAGGGA,94,116,22,16,5158,5,0
5836,ACGTCGAATCTAGGGA,94,96,2,13,5159,0,0
5837,ACGTCGAATCTAGGGA,94,95,1,14,5160,0,0
5838,ACGTCGAATCTAGGGA,94,97,3,9,5197,0,0
5839,ACGTCGAATCTAGGGA,94,103,9,11,5199,1,0
5840,ACGTCGAATCTAGGGA,94,100,6,14,5201,0,0
5841,ACGTCGAATCTAGGGA,94,101,7,18,5205,0,0
5842,ACGTCGAATCTAGGGA,94,101,7,12,5206,0,0
5843,ACGTCGAATCTAGGGA,94,115,21,9,5318,5,0
5844,ACGTCGAATCTAGGGA,94,94,0,15,5326,0,0
5845,CCGTCGAATCTAGGGA,94,100,6,13,5329,0,0
5846,ACGTCGAATCTAGGGA,94,95,1,13,5335,0,0
5847,ACGTCGAATCTAGGGA,94,98,4,15,5336,0,0
5848,ACGTCGAATCTAGGGA,94,97,3,14,5337,0,0
5849,ACGTCGAATCTAGGGA,94,94,0,10,5338,0,0
5850,ACGTCGAATCTAGGGA,94,118,24,9,5370,6,0
5851,ACGTCGAATCTAGGGA,94,107,13,12,5373,2,0
5852,CCGTCGAATCTAGTGA,94,97,3,11,5375,0,0
5853,ACGTCGAATCTAGGGA,94,96,2,10,5376,0,0
5854,ACGTCGAATCTAGGGA,94,97,3,11,5377,0,0
5855,ACGTCGAATCTAGGGA,94,100,6,10,5380,0,0
5856,ACGTAGAATCTAGGGA,94,101,7,12,5382,0,0
5857,ACGTCGAATCTAGGGA,94,111,17,15,5494,4,0
5858,ACGTCGAATCTAGGGA,94,99,5,16,5495,0,0
5859,ACGTCGAATCTAGGGA,94,110,16,15,5498,3,0
5860,ACGTCGAATCTAGGGA,94,97,3,15,5499,0,0
5861,ACGTCGAATCTAGGGA,94,94,0,16,5500,0,0
5862,ACGTCGAATCTAGGGA,95,96,1,8,1467,0,0
5863,ACGTCGAATCTAGGGA,95,106,11,12,1471,2,0
5864,ACGTCGAATCTAGGGA,95,106,11,14,1833,2,0
5865,ACGTCGAATCTAGGGA,95,99,4,12,1916,0,0
5866,ACGTCGAATCTAGGGA,95,95,0,15,2895,0,0
5867,ACGTCGAAGCTAGGAA,95,108,13,16,2916,3,0
5868,ACGTCGAATCTAGGGA,95,99,4,10,4082,0,0
5869,ACGTCGAATCTAGGGA,95,102,7,11,4083,1,0
5870,ACGTCGAATCTAGGGA,95,108,13,14,4109,3,0
5871,ACGTCGAATCTAGGGA,95,111,16,13,4117,4,0
5872,ACGTCGAATCTAGGGA,95,96,1,10,4422,0,0
5873,ACGTCGAATCTAGGGA,95,95,0,12,4436,0,0
5874,ACGTCGAATCTAGGGA,95,119,24,10,4447,7,0
5875,ACGTCGAATCTAGGGA,95,97,2,14,4600,0,0
5876,ACGTCGAATCTAGGGA,95,100,5,10,4775,0,0
5877,ACGTCGAATCTAGGGA,95,96,1,18,4788,0,0
5878,ACGTCGAATCTAGGGA,95,123,28,13,4790,8,0
5879,ACGTCGAATCTAGGGA,95,108,13,10,4941,3,0
5880,ACGTCGAATCTAGGGA,95,113,18,14,4952,5,0
5881,ACGTCGAATCTAGGGA,95,100,5,14,4956,0,0
5882,ACGTCGAATCTAGGGA,95,119,24,11,5004,7,0
5883,ACGTCGAATCTAGGGA,95,97,2,13,5114,0,0
5884,ACGTCGAATCTAGGGA,95,98,3,14,5123,0,0
5885,ACGTCGAATCTAGGGA,95,99,4,15,5124,0,0
5886,ACGTCGAATCTAGGGA,95,113,18,16,5134,4,0
5887,ACGTCGAATCTAGGGA,95,107,12,16,5136,2,0
5888,ACGTCGAATCTAGGGA,95,101,6,14,5138,0,0
5889,ACGTCGAATCTAGGGA,95,106,11,8,5142,2,0
5890,ACGTCGAATCTAGGGA,95,98,3,12,5147,0,0
5891,ACGTCGAATCTAGGGA,95,97,2,7,5190,0,0
5892,ACGTCGAATCTAGGGA,95,95,0,9,5191,0,0
5893,ACGTCGAATCTAGGGA,95,99,4,15,5282,0,0
5894,ACGTCGAATCTAGGGA,95,97,2,18,5284,0,0
5895,ACGTCGAATCTAGGGA,95,95,0,14,5288,0,0
5896,ACGTCGAATCTAGGGA,95,114,19,14,5296,4,0
5897,ACGTCGAATCTAGGGA,95,96,1,12,5301,0,0
5898,ACGTCGAATCTAGGGA,95,104,9,14,5302,1,0
5899,ACGTCGAATCTAGGGA,95,116,21,15,5306,5,0
5900,ACGTCGAATCAAGGGA,95,95,0,15,5307,0,0
5901,ACGTCGAATCTAGGGA,95,105,10,14,5309,1,0
5902,ACGTCGAATCTAGGGA,95,122,27,11,5313,7,0
5903,ACGTCGAATCTAGGGA,95,98,3,14,5368,0,0
5904,ACGTCGAATCTAGGGA,95,95,0,15,5369,0,0
5905,ACGTCGAATCTAGGGA,95,106,11,12,5383,2,0
5906,ACGTCGAATCTAGGGA,95,95,0,13,5447,0,0
5907,ACGTCGAATCTAGGGA,95,114,19,13,5448,4,0
5908,ACGTCGAATCGAGGGA,95,113,18,15,5450,4,0
5909,ACGTCGAATCTAGGGA,95,97,2,15,5454,0,0
5910,ACGTCGAATCTAGGGA,95,96,1,13,5456,0,0
5911,ACGTCGAATCTAGGGA,95,119,24,14,5457,6,0
5912,ACGTCGAATCTAGGGA,95,103,8,16,5459,1,0
5913,ACGTCGAATCTAGGGA,95,109,14,16,5460,3,0
5914,AAGTCTAATCTAGGGA,95,97,2,15,5462,0,0
5915,ACGTCGAATCTAGGGA,95,95,0,15,5463,0,0
5916,ACGTCGAATCTAGGGA,95,116,21,15,5465,5,0
5917,ACGTCGAATCTAGGGA,95,104,9,11,5469,1,0
5918,ACGTCGAATCTAGGGA,95,120,25,12,5470,6,0
5919,ACGTCGAATCTAGGGA,95,97,2,15,5473,0,0
5920,ACGTCGAATCTAGGGA,95,95,0,9,5476,0,0
5921,ACGTCGAATCTAGGGA,95,95,0,11,5477,0,0
5922,ACGTCGAATCTAGGGA,95,106,11,13,5479,2,0
5923,ACGTCGAATCTAGGGA,95,97,2,12,5481,0,0
5924,ACGTCGAATCTAGGGA,95,95,0,13,5482,0,0
5925,ACGGCGAATCTAGGGA,95,104,9,12,5484,0,0
5926,ACGTCGAATCTAGGGA,95,101,6,12,5485,0,0
5927,ACGTCGAATCTAGGGA,96,99,3,8,294,0,0
5928,ACGTCGAATCTAGGGA,96,99,3,9,376,0,0
5929,ACGTCGAATCTAGGGA,96,99,3,9,470,0,0
5930,ACGTCGAATCTAGGGA,96,98,2,12,728,0,0
5931,ACGTCGAATCTAGTGA,96,98,2,10,730,0,0
5932,ACGTCGAATCTAGGGA,96,97,1,10,858,0,0
5933,ACGTCGAATCTAGGGA,96,99,3,13,905,0,0
5934,ACGTCGAATCTAGGGA,96,99,3,13,1062,0,0
5935,ACGTCGAATCTAGGGA,96,99,3,11,1075,0,0
5936,ACGTCGAATCTAGGGA,96,99,3,9,1562,0,0
5937,ACGTCGAATCTAGGTA,96,96,0,12,1640,0,0
5938,ACGTCGAATCTAGGGA,96,98,2,11,1679,0,0
5939,ACGTCGAATCTAGGGA,96,96,0,13,4046,0,0
5940,ACGTCGAATCTAGGGA,96,99,3,12,4051,0,0
5941,AAGTCGAATCTAGGGA,96,99,3,11,4464,0,0
5942,ACGTCGAATATAGGGA,96,99,3,12,4582,0,0
5943,ACGTCGAATCTAGGGA,96,96,0,12,4596,0,0
5944,ACGTCGAATCTAGGGA,96,99,3,12,4624,0,0
5945,ACGTCGAATCTAGGGA,96,99,3,11,4627,0,0
5946,ACGTAGAATCTAGGTA,96,99,3,12,4632,0,0
5947,ACGTCGAATCTAGGGA,96,99,3,11,4638,0,0
5948,ACGTCGAATCTAGGGA,96,99,3,15,4653,0,0
5949,ACGTCGAATCTAGGGA,96,99,3,12,4771,0,0
5950,ACGTCGAATCTAGGGA,96,99,3,11,4841,0,0
5951,ACGTCGAATCTAGGGA,96,99,3,9,4971,0,0
5952,ACGTCGAATCTAGGGA,96,99,3,13,4972,0,0
5953,ACGTCGAATCTAGGGA,96,99,3,13,4980,0,0
5954,ACGTCGAATCTAGGGA,96,99,3,14,4993,0,0
5955,ACGTCGAATAGAGGGA,96,99,3,17,4994,0,0
5956,ACCTCGAATCTAGGGA,96,99,3,12,4999,0,0
5957,ACGTCGAATCTAGGGA,96,96,0,14,5170,0,0
5958,ACGTCGAATCTAGGGA,96,99,3,13,5173,0,0
5959,ACGTCGAATCTAGGGA,96,99,3,15,5174,0,0
5960,ACGTCGAGTCTCGGGA,96,99,3,13,5175,0,0
5961,ACGTCGAATCTAGGGA,96,99,3,14,5176,0,0
5962,ACGTCGAATCTAGGGA,96,99,3,11,5177,0,0
5963,ACGTCGAATCTAGGGA,96,97,1,10,5180,0,0
5964,ACGTAGAATCTAGGGA,96,99,3,11,5181,0,0
5965,ACGTCGAATCTAGGGA,96,96,0,11,5182,0,0
5966,ACGTCGAATCTACGGA,96,99,3,13,5184,0,0
5967,ACGTCGAATCTAGGGA,96,99,3,12,5185,0,0
5968,ACGTCGAATCTAGGGA,96,96,0,11,5186,0,0
5969,ACGTCGAATCTAGGGC,96,99,3,15,5187,0,0
5970,ACGTCGAATCTAGGGA,96,99,3,15,5189,0,0
5971,ACGTCGAATCTAGGGA,96,99,3,11,5340,0,0
5972,ACGTCGAATCTAGGGA,96,99,3,12,5344,0,0
5973,AGGTCGAATCTAGGGA,96,99,3,14,5346,0,0
5974,ACGTCGAATCTAGAGA,96,99,3,15,5347,0,0
5975,ACGTCGAATCTAGGGA,96,96,0,11,5348,0,0
5976,ACGTCGAATCTAGGGA,96,99,3,15,5351,0,0
5977,ACGTCGAATCTAGGGA,96,96,0,14,5355,0,0
5978,ACGTCGAATCTAGGGA,96,99,3,12,5358,0,0
5979,ACGTCGAATCTAGGGA,96,99,3,16,5365,0,0
5980,ACGTCGAATCTAGGGA,96,99,3,15,5366,0,0
5981,ACGTCGAATCTAGGGA,96,99,3,14,5506,0,0
5982,ACGTCGAATCTAGGGA,96,99,3,11,5510,0,0
5983,ACGTCGAATCTAGGGA,96,97,1,13,5512,0,0
5984,ACGTCGAATCTAGGGA,96,96,0,12,5513,0,0
5985,ACGTCGAATCTAGGGA,96,97,1,15,5515,0,0
5986,ACGTCGAATCTAGGGA,96,99,3,11,5516,0,0
5987,ACGTCGAATCTAGGGA,96,99,3,19,5518,0,0
5988,ACGTCGAATCTAGGGA,96,99,3,18,5521,0,0
5989,ACGTCGAATCTAGGGA,96,99,3,15,5527,0,0
5990,ACGTCGAATCTAGGGA,96,99,3,15,5528,0,0
5991,ACGTCGATTCTAGGGA,96,99,3,11,5533,0,0
5992,ACGTCGAATCTAGGGA,96,99,3,14,5535,0,0
5993,ACGTCGAATCTAGGGA,96,99,3,16,5536,0,0
5994,ACGTCGAATCTAGGGA,96,99,3,15,5538,0,0
5995,ACGTCGAATCTAGGGA,97,97,0,12,1476,0,0
5996,ACGTCGAATCTAGGGA,97,97,0,12,1506,0,0
5997,ACGTCGAATCTAGGGA,97,115,18,13,1519,4,0
5998,ACGTCGAATCTAGGGA,97,126,29,12,1968,8,0
5999,ACGTCGAATCTAGGGA,97,107,10,13,4140,1,0
6000,ACGTCGAATCTAGGGA,97,110,13,14,4567,2,0
6001,ACGTCGAATCTAGGGA,97,97,0,14,4741,0,0
6002,ACGTCGAATCTAGGGA,97,100,3,11,4959,0,0
6003,ACGTCGAATCTAGGGA,97,103,6,7,5024,0,0
6004,ACGTCGAATCTAGGGA,97,97,0,12,5031,0,0
6005,ACGTCGAATCTAGGGA,97,107,10,11,5034,1,0
6006,ACGTCGAATCTAGGGA,97,97,0,12,5035,0,0
6007,ACGTCGAATCTAGGGA,97,98,1,11,5151,0,0
6008,ACGTCGAATCTAGGGA,97,101,4,16,5158,0,0
6009,ACGTCGAATCTAGGGA,97,105,8,9,5197,1,0
6010,ACGTCGAATCTAGGGA,97,100,3,18,5205,0,0
6011,ACGTCGAATCTAGGGA,97,107,10,12,5206,1,0
6012,TCGTCGAATCTAGGGA,97,99,2,9,5318,0,0
6013,ACGTCGAATCTAGGGA,97,100,3,15,5326,0,0
6014,CCGTCGAATCTAGGGA,97,105,8,13,5329,1,0
6015,ACGTCGAATCTAGGGA,97,114,17,13,5335,4,0
6016,ACGTCGAATCTAGGGA,97,101,4,15,5336,0,0
6017,ACGTCGATTCTAGGGA,97,99,2,14,5337,0,0
6018,ACGTCGAATCTAGGGA,97,102,5,10,5338,0,0
6019,ACGTCGAATCTAGGGA,97,106,9,9,5370,1,0
6020,ACGTCGAATCTAGGGA,97,97,0,12,5373,0,0
6021,CCGTCGAATCTAGTGA,97,98,1,11,5375,0,0
6022,ACGTCGAATCTAGGGA,97,116,19,10,5376,4,0
6023,ACGTCGAATCTAGGGA,97,97,0,11,5377,0,0
6024,ACGTCGAATCTAGGGA,97,112,15,10,5380,3,0
6025,ACGTAGAATCTAGGGA,97,105,8,12,5382,1,0
6026,ACGTCGAATCTAGGGA,97,105,8,15,5494,1,0
6027,ACGTCGAATCTAGGGA,97,112,15,16,5495,3,0
6028,ACGTCGAATCTAGGGA,97,97,0,15,5498,0,0
6029,ACGTCGAATCTAGGGA,97,125,28,15,5499,7,0
6030,ACGTCGAATCTAGGGA,97,101,4,16,5500,0,0
6031,ACGTCGAATCTAGGGA,97,106,9,9,5553,1,0
6032,ACGTCGAATCTAGGGA,97,98,1,10,5554,0,0
6033,ACGTCGAATCTAGGGA,97,105,8,12,5556,1,0
6034,ACGTCGAATCTAGGGA,97,105,8,13,5678,1,0
6035,ACGTCGAATCTAGGGA,97,103,6,13,5680,0,0
6036,ACGTCGAATCTAGGGA,97,101,4,13,5684,0,0
6037,ACGTCGAATCTAGGGA,97,104,7,11,5686,0,0
6038,ACGTCGAATCTAGGGA,97,103,6,12,5687,0,0
6039,ACGTCGAATCTAGGGA,97,108,11,14,5689,2,0
6040,ATGTCGAATCTAGGGA,97,110,13,11,5690,2,0
6041,ACGTCGAATCTAGGGA,97,103,6,11,5691,0,0
6042,ACGTCGAATCTAGGGA,98,126,28,8,1467,8,0
6043,ACGTCGAATCTAGGGA,98,104,6,12,1471,1,0
6044,ACGTCGAATCTAGGGA,98,105,7,14,1833,1,0
6045,ACGTCGAATCTAGGGA,98,101,3,12,1916,0,0
6046,ACGTCGAATCTAGGGA,98,130,32,15,2895,9,0
6047,ACGTCGAAGCTAGGAA,98,102,4,16,2916,0,0
6048,ACGTCGAATCTAGGGA,98,134,36,14,4109,11,0
6049,ACGTCGAATCTAGGGA,98,105,7,10,4422,1,0
6050,ACGTCGAATCTAGGGA,98,114,16,10,4447,4,0
6051,ACGTCGAATCTAGGGA,98,109,11,14,4600,2,0
6052,ACGTCGAATCTAGGGA,98,103,5,18,4788,0,0
6053,ACGTCGAATCTAGGGA,98,103,5,14,4952,0,0
6054,ACGTCGAATCAAGGGA,98,116,18,14,4956,5,0
6055,ACGTCGAATCTAGGGA,98,98,0,11,5004,0,0
6056,ACGTCGAATCTAGGGA,98,117,19,14,5123,5,0
6057,ACGTCGAATCTAGGGA,98,104,6,15,5124,1,0
6058,ACGTCGAATCTAGGGA,98,106,8,16,5134,1,0
6059,ACGTCGAATCTAGGGA,98,104,6,16,5136,0,0
6060,ACGTCGAATCTAGGGA,98,142,44,14,5138,13,0
6061,ACGTCGAATCTAGGGA,98,105,7,12,5147,0,0
6062,ACGTCGAATCTAGGGA,98,101,3,9,5191,0,0
6063,ACGTCGAATCTAGGGA,98,110,12,18,5284,2,0
6064,ACGTCGAATCTAGGGA,98,101,3,14,5288,0,0
6065,ACGTCGAATCTAGGGA,98,113,15,12,5301,3,0
6066,ACGTCGAATCTAGGGA,98,132,34,15,5306,9,0
6067,ACGTCGAATCTAGGGA,98,101,3,14,5309,0,0
6068,ACGTCGAATCTAGGGA,98,98,0,14,5368,0,0
6069,ACGTCGAATCTAGGGA,98,115,17,15,5369,4,0
6070,ACGTCGAATCTAGGGA,98,111,13,12,5383,2,0
6071,ACGTCGAATCTAGGGA,98,114,16,13,5447,3,0
6072,ACGTCGAATCTAGGGA,98,101,3,13,5448,0,0
6073,ACGTCGAATCGAGGGA,98,114,16,15,5450,3,0
6074,ACGTCGAATCTAGGGA,98,101,3,13,5456,0,0
6075,ACGTCGAATCTAGGGA,98,101,3,14,5457,0,0
6076,ACGTCGAATCTAGGGA,98,107,9,16,5459,1,0
6077,ACGTCGAATCTAGGGA,98,102,4,16,5460,0,0
6078,ACGTCGAATCTAGGGA,98,115,17,15,5463,4,0
6079,ACGTCGAATCTAGGGA,98,98,0,15,5465,0,0
6080,ACGTCGAATCTAGGGA,98,102,4,11,5469,0,0
6081,ACGTCGAATCTAGGGA,98,109,11,12,5470,2,0
6082,ACGTCGAATCTAGGGA,98,101,3,15,5473,0,0
6083,ACGTCGAATCTAGGGA,98,102,4,9,5476,0,0
6084,ACGTCGAATCTAGGGA,98,100,2,11,5477,0,0
6085,ACGTCGAATCTAGGGA,98,98,0,12,5481,0,0
6086,ACGTCGAATCTAGGGA,98,99,1,13,5482,0,0
6087,ACGTCGAATCTAGGGA,98,104,6,12,5484,0,0
6088,ACGTCGAATCTAGGGA,98,110,12,12,5485,2,0
6089,ACGTCGAATCTAGGGA,98,99,1,12,5540,0,0
6090,ACGTCGAACCTAGGGA,98,99,1,17,5542,0,0
6091,ACGTCGAATCTAGGGA,98,120,22,15,5544,5,0
6092,ACGTCTAATCTAGGGA,98,103,5,16,5545,0,0
6093,ACGTCGAATCTAGGGA,98,103,5,14,5636,0,0
6094,ACGTCGAATCTAGGGA,98,104,6,14,5638,0,0
6095,ACGGCGAATCTAGGGA,98,103,5,14,5639,0,0
6096,ACGTCTAATCTAGGGA,98,110,12,15,5640,2,0
6097,ACGTCGAATCTAGGGA,98,98,0,15,5641,0,0
6098,ACGTCGATTCTAGGGA,98,98,0,15,5642,0,0
6099,ACGTCGAATCAAGGGA,98,104,6,15,5643,0,0
6100,ACGTCGAATCTAGGGA,98,118,20,15,5647,5,0
6101,ACGTCGAATCTAGGGA,98,117,19,8,5648,4,0
6102,ACGTCGAATCTAGGGA,98,113,15,12,5650,3,0
6103,ACGTCGAATCTAGGGA,98,123,25,13,5653,6,0
6104,ATGTCGAATCTAGGGA,98,101,3,17,5657,0,0
6105,ACGTCGAATCTAGGGA,98,102,4,14,5658,0,0
6106,ACGTCGAATCTAGGGA,98,100,2,15,5659,0,0
6107,ACGTCGAATCTAGGGA,98,106,8,15,5662,0,0
6108,ACGTCGAATCTAGGGA,98,101,3,19,5664,0,0
6109,ACGTCGAATCTAGGGA,98,107,9,10,5666,0,0
6110,ACGTCGAATCTAGGGA,98,101,3,16,5668,0,0
6111,ACGTCGAATCTAGGGA,98,99,1,14,5673,0,0
6112,ACGTCGAATCTAGGGA,99,116,17,8,294,4,0
6113,ACGTCGAATCTAGGGA,99,102,3,9,470,0,0
6114,ACGTCGAATCTAGGGA,99,101,2,12,728,0,0
6115,ACGTCGAATCTAGGGA,99,102,3,10,858,0,0
6116,ACGTCGAATCTAGGGA,99,100,1,13,1062,0,0
6117,ACGTCGAATCTAGGGA,99,102,3,9,1562,0,0
6118,ACGTCGAATCTAGGGA,99,100,1,12,1640,0,0
6119,ACGTCGAATCTAGGGA,99,101,2,13,4046,0,0
6120,ACGTCGAATCTAGGGA,99,102,3,12,4051,0,0
6121,ACGTCGAATATAGGGA,99,102,3,12,4582,0,0
6122,ACGTCGAATCTAGGGA,99,102,3,12,4596,0,0
6123,ACGTCGAATCTAGGGA,99,102,3,12,4624,0,0
6124,ACGTCGAATCTAGGGA,99,102,3,11,4627,0,0
6125,ACGTAGAATCTAGGGA,99,102,3,12,4632,0,0
6126,ACGTCGAATCTAGGGA,99,102,3,11,4638,0,0
6127,ACGTCGAATCTAGGGA,99,101,2,12,4771,0,0
6128,ACGGCGAATCTAGGGA,99,102,3,11,4841,0,0
6129,ACGTCGAATCTAGGGA,99,102,3,9,4971,0,0
6130,ACGTCGAATCTAGGGA,99,102,3,13,4972,0,0
6131,ACGTCGAATCTAGGGA,99,101,2,14,4993,0,0
6132,ACGTCGAATAGAGGGA,99,102,3,17,4994,0,0
6133,ACGTCGAATCTAGGGA,99,102,3,14,5170,0,0
6134,ACGTCGAATCTAGGGA,99,99,0,15,5174,0,0
6135,ACGTCGAATCAAGGGA,99,102,3,14,5176,0,0
6136,ACGTCGAATCTAGGGA,99,102,3,11,5177,0,0
6137,ACGTCGAATCTAGGGA,99,100,1,10,5180,0,0
6138,ACGTCGAATCTAGGGA,99,102,3,11,5182,0,0
6139,ACGTCGAATCTACGGA,99,102,3,13,5184,0,0
6140,ACGTCGAATCTAGGGA,99,99,0,11,5186,0,0
6141,ACGTCGAATCTAGGGC,99,99,0,15,5187,0,0
6142,ACGTCGAATCTAGGGA,99,100,1,15,5189,0,0
6143,ACGTCGAATCTAGGGA,99,102,3,12,5344,0,0
6144,AGGTCGAATCTAGGGA,99,102,3,14,5346,0,0
6145,ACGTCGAATCTAGGGA,99,102,3,11,5348,0,0
6146,ACGTCGAATCTAGGGA,99,102,3,15,5351,0,0
6147,ACGTCGAATCTAGGGA,99,102,3,16,5365,0,0
6148,ACGTCGAATCTAGGGA,99,102,3,11,5510,0,0
6149,ACGTCGAATCTAGGGA,99,100,1,12,5513,0,0
6150,ACGTCGAATCTAGGGA,99,102,3,15,5515,0,0
6151,ACGTCGAATCTAGGGA,99,102,3,11,5516,0,0
6152,ACGTCGAATCTAGGGA,99,102,3,19,5518,0,0
6153,ACGTCGAATCTAGGGA,99,100,1,15,5527,0,0
6154,ACGTCGAATCTAGGGA,99,99,0,15,5528,0,0
6155,ACGTCGATTCTAGGGA,99,99,0,11,5533,0,0
6156,ACGTCGAATCTAGGGA,99,102,3,14,5535,0,0
6157,ACGTCGAATCTAGGGA,99,102,3,16,5536,0,0
6158,ACGTCGAATCTAGGGA,99,99,0,15,5538,0,0
6159,ACGTCGAATCTAGGGA,99,102,3,11,5693,0,0
6160,ACGTCGAATCTAGGGA,99,102,3,15,5694,0,0
6161,ACGTCGAATCTAGGGA,99,102,3,19,5697,0,0
6162,ACGTCGAATCTAGGGA,99,102,3,16,5701,0,0
6163,ACGTCGAATCTAGGGA,99,102,3,15,5702,0,0
6164,ACGTCGAATCTCGGGA,99,102,3,15,5706,0,0
6165,ACGTCGAATCTAGGGA,99,102,3,15,5710,0,0
6166,ACGTCGAATCTAGGGA,99,102,3,17,5713,0,0
6167,ACGTCGAATCTAGGGA,99,102,3,15,5715,0,0
6168,ACGTCGAATCTAGGGA,99,102,3,9,5716,0,0
6169,ACGTCGAATCTAGGGA,100,109,9,12,1476,1,0
6170,ACGTCGAATCTAGGGA,100,104,4,12,1506,0,0
6171,ACGTCGAATCTAGGGA,100,114,14,13,1519,3,0
6172,ACGTCGAATCTAGGGA,100,105,5,12,1968,0,0
6173,ACGTCGAATCTAGGGA,100,106,6,13,4140,0,0
6174,ACGTCGAATCTAGGGA,100,103,3,14,4741,0,0
6175,ACGTCGAATCTAGGGA,100,107,7,11,4959,0,0
6176,ACGTCGAATCTAGGGA,100,107,7,12,5031,0,0
6177,ACGTCGAACCTAGGGA,100,114,14,12,5035,3,0
6178,ACGTCGAATCTAGGGA,100,107,7,11,5151,0,0
6179,ACGTCGAATCTAGGGA,100,111,11,16,5158,2,0
6180,ACGTCGAATCTAGGGA,100,113,13,9,5197,2,0
6181,ACGTCGAATCTAGGGA,100,105,5,18,5205,0,0
6182,ACGTCGAATCTAGGGA,100,103,3,12,5206,0,0
6183,ACGTCGAATCTAGGGA,100,110,10,9,5318,1,0
6184,ACGTCGAATCTAGGGA,100,125,25,15,5326,6,0
6185,CCGTCGAATCTAGGGA,100,108,8,13,5329,1,0
6186,ACGTCGAATCTAGGGA,100,108,8,13,5335,1,0
6187,ACGTCGAATCTAGGGA,100,114,14,15,5336,3,0
6188,ACGTCGAATCTAGGGA,100,109,9,10,5338,1,0
6189,ACGTCGAATCTAGGGA,100,106,6,9,5370,0,0
6190,CCGTCGAATCTAGTGA,100,111,11,11,5375,2,0
6191,ACGTCGAATCTAGGGA,100,113,13,10,5376,2,0
6192,ACGTCGAATCTAGGGA,100,100,0,11,5377,0,0
6193,ACGTCGAATCTAGGGA,100,111,11,10,5380,2,0
6194,ACGTAGAATCTAGGGA,100,100,0,12,5382,0,0
6195,ACGTCGAATCTAGGGA,100,100,0,15,5494,0,0
6196,ACGTCGAATCTAGGGA,100,102,2,16,5495,0,0
6197,ACGTCGAATCTAGGGA,100,100,0,15,5498,0,0
6198,ACGTCGAATCTAGGGA,100,101,1,15,5499,0,0
6199,ACGTCGAATCTAGGGA,100,104,4,9,5553,0,0
6200,ACGTCGAATCTAGGGA,100,103,3,12,5556,0,0
6201,ACGTCGAATCTAGGGA,100,142,42,13,5678,12,0
6202,ACGTCGAATCTAGGGA,100,103,3,13,5684,0,0
6203,ACGTCGAATCTAGGGA,100,106,6,11,5686,0,0
6204,ACGTCGAATCTAGGGA,100,104,4,12,5687,0,0
6205,ACGTCGAATCTAGGGA,100,100,0,11,5690,0,0
6206,CCGTCGAATCTAGGGA,100,106,6,10,5735,0,0
6207,ACGTCGAATCTAGGGA,100,114,14,10,5736,3,0
6208,ACGTCGAATCTAGGGA,100,104,4,10,5742,0,0
6209,ACGTCGAATCTAGGGA,100,124,24,13,5863,6,0
6210,ACGTCGAATCTAGGGA,100,100,0,15,5864,0,0
6211,ACGTCGAAGCTAGGAA,100,100,0,17,5867,0,0
6212,ACGTCGAATCTAGGGA,100,114,14,12,5869,3,0
6213,ACGTCGAATCTAGGGA,100,102,2,15,5870,0,0
6214,ACGTCGAATCTAGGGA,100,102,2,14,5871,0,0
6215,ACGTCGAATCTAGGGA,100,105,5,11,5874,0,0
6216,ACGTCGAATCTAGGGA,100,122,22,14,5878,5,0
6217,ACGTCGAATCTAGGGA,100,105,5,11,5879,0,0
6218,ACGTCGAATCTAGGGA,100,100,0,15,5880,0,0
6219,ACGTCGAATCTAGGGA,100,102,2,12,5882,0,0
6220,ACGTCGAATCTAGGGA,101,102,1,8,1467,0,0
6221,ACGTCGAATCTAGGGA,101,115,14,15,2895,3,0
6222,ACGTCGAATCTAGGGA,101,105,4,14,4109,0,0
6223,ACGTCGAATCTAGGGA,101,122,21,10,4422,6,0
6224,ACGTCGAATCTAGGGA,101,101,0,14,4600,0,0
6225,ACGTCGAATCTAGGGA,101,107,6,18,4788,1,0
6226,ACGTCGAATCTAGGGA,101,101,0,14,4956,0,0
6227,ACGTCGAATCTAGGGA,101,101,0,11,5004,0,0
6228,ACGTCGAATCTAGGGA,101,122,21,14,5123,6,0
6229,ACGTCGAATCTAGGGA,101,126,25,15,5124,6,0
6230,ACGTCGAATCTAGGGA,101,103,2,16,5134,0,0
6231,ACGTCGAATCTAGGGA,101,102,1,16,5136,0,0
6232,ACGTCGAATCTAGGGA,101,110,9,14,5138,1,0
6233,ACGTCGAATCTAGGGA,101,103,2,9,5191,0,0
6234,ACGTCGAATCTAGGGA,101,107,6,18,5284,0,0
6235,ACGTCGAATCTAGGGA,101,125,24,14,5288,6,0
6236,ACGTCGAATCTAGGGA,101,118,17,12,5301,4,0
6237,ACGTCGAATCTAGGGA,101,105,4,15,5306,0,0
6238,ACGTCGAATCTAGGGA,101,123,22,14,5309,5,0
6239,ACGTCGAATCTAGGGA,101,134,33,14,5368,9,0
6240,ACGTCGAATCTAGGGA,101,121,20,15,5369,5,0
6241,ACGTCGAATCTAGGGA,101,133,32,13,5447,9,0
6242,ACGTCGAATCGAGGGA,101,107,6,15,5450,0,0
6243,ACGTCGAATCTAGGGA,101,106,5,13,5456,0,0
6244,ACGTCGAATCTAGGGA,101,108,7,14,5457,0,0
6245,ACGTCGAATCTAGGGA,101,127,26,16,5459,7,0
6246,ACGTCGAATCTAGGGA,101,116,15,16,5460,3,0
6247,ACGTCGAATCTAGGGA,101,104,3,11,5469,0,0
6248,ACGTCGAATCTAGGGA,101,104,3,12,5470,0,0
6249,ACGTCGAATCTAGGGA,101,107,6,15,5473,0,0
6250,ACGTCGAATCTAGGGA,101,117,16,9,5476,3,0
6251,ACGTCGAATCTAGGGA,101,131,30,12,5481,8,0
6252,ACGTCGAATCTAGGGA,101,110,9,13,5482,1,0
6253,ACGTCGAATCTAGGGA,101,106,5,12,5484,0,0
6254,ACGTCGAATCTAGGGA,101,130,29,12,5485,8,0
6255,ACGTCGAATCTAGGGA,101,105,4,12,5540,0,0
6256,ACGTCGAATCTAGGGA,101,104,3,14,5636,0,0
6257,ACGGCGAATCTAGGGA,101,101,0,14,5639,0,0
6258,ACGTCTAATCTAGGGA,101,122,21,15,5640,5,0
6259,ACGTCGAATCTAGGGA,101,101,0,15,5647,0,0
6260,ACGTCGAATCTAGGGA,101,104,3,8,5648,0,0
6261,ATGTCGAATCTAGGGA,101,101,0,17,5657,0,0
6262,ACGTCGAATCTAGGGA,101,104,3,14,5658,0,0
6263,ACGTCGAACCTAGGGA,101,103,2,15,5659,0,0
6264,ACGTCGAATCTAGGGA,101,104,3,19,5664,0,0
6265,ACGTCGAATCTAGGGA,101,101,0,16,5668,0,0
6266,ACGTCGAATCTAGGGA,101,104,3,14,5673,0,0
6267,ACGTCGAATCTAGGGA,101,104,3,8,5718,0,0
6268,ACGTCGCATCTAGGGA,101,103,2,13,5721,0,0
6269,ACGTCGAATCTAGGGA,101,104,3,15,5724,0,0
6270,ACGTCGAATCTAGGGA,101,104,3,15,5731,0,0
6271,ACGTCGAATCTAGGGA,101,103,2,13,5817,0,0
6272,ACGTCGAAGCTAGGGA,101,103,2,14,5819,0,0
6273,ACGTCTAATCTAGGGA,101,104,3,15,5820,0,0
6274,ACGTCGAATCTAGGGA,101,104,3,15,5821,0,0
6275,ACGTCGAATCTAGGGA,101,103,2,12,5824,0,0
6276,ACGTCGAATCTAGGGA,101,104,3,8,5827,0,0
6277,ACGTCGAATCTAGGGA,101,104,3,13,5829,0,0
6278,ACGTCGAATCTAGGGA,101,104,3,16,5834,0,0
6279,ACGTCGAATCTAGGGA,101,104,3,17,5835,0,0
6280,ACGTCGAATCTAGGGA,101,104,3,12,5839,0,0
6281,ACGTCGAATCTAGGGA,101,102,1,10,5843,0,0
6282,ACGTCGAATCTAGGGA,101,104,3,10,5850,0,0
6283,ACGTCGAATCTAGGGA,101,104,3,13,5851,0,0
6284,ACGTCGAATCTAGGGA,101,104,3,16,5857,0,0
6285,ACGTCGAATCTAGGGA,101,104,3,16,5859,0,0
6286,ACGTCGAATCTAGGGA,102,107,5,8,294,0,0
6287,ACGTCGAATCTAGGGA,102,133,31,9,470,8,0
6288,ACGTCGAATCTAGGGA,102,102,0,12,728,0,0
6289,ACGTCGAATCTAGGGA,102,116,14,13,1062,3,0
6290,ACGTCGAATCTAGGGA,102,103,1,12,1640,0,0
6291,ACGTCGAATCTAGGGA,102,114,12,13,4046,2,0
6292,ACGTCGAATCTAGGGA,102,106,4,12,4051,0,0
6293,ACGTCGAATCTAGGGA,102,118,16,12,4596,3,0
6294,ACGTCGAATCTAGGGA,102,118,16,12,4624,3,0
6295,ACGTCGAATCTAGGGA,102,118,16,11,4627,3,0
6296,ACGTCGAATCTAGGGA,102,112,10,12,4771,1,0
6297,ACGTCGAATCTAGGGA,102,105,3,11,4841,0,0
6298,ACGTCGAATCTAGGGA,102,102,0,9,4971,0,0
6299,ACGTCGAATCTAGGGA,102,102,0,13,4972,0,0
6300,ACGTCGAATCTAGGGA,102,114,12,14,4993,2,0
6301,ACGTCGAATCTAGGGA,102,104,2,14,5176,0,0
6302,ACGGCGAATCTAGGGA,102,103,1,11,5177,0,0
6303,ACGTCGAATCTAGGGA,102,107,5,10,5180,0,0
6304,ACGTCGAATCTAGGGA,102,104,2,11,5182,0,0
6305,ACGTCGAATCTAGGGA,102,104,2,11,5186,0,0
6306,ACGTCGAATCTAGGGC,102,115,13,15,5187,2,0
6307,ACGTCGAATCTAGGGA,102,102,0,15,5189,0,0
6308,AGGTCGAATCTAGGGA,102,122,20,14,5346,5,0
6309,ACGTCGAATCTAGGGA,102,108,6,11,5348,0,0
6310,ACGTCGAATCTAGGGA,102,106,4,16,5365,0,0
6311,ACATCGAATCTAGGGA,102,110,8,12,5513,1,0
6312,ACGTCGAATCTAGGGA,102,107,5,15,5515,0,0
6313,ACGTCGAATCTAGGGA,102,104,2,11,5516,0,0
6314,ACGTCGAATCTAGGGA,102,105,3,19,5518,0,0
6315,ACGTCGAATCTAGGGA,102,119,17,15,5528,4,0
6316,ACGTCGATTCTAGGGA,102,142,40,11,5533,11,0
6317,ACGTCGAATCTAGGGA,102,109,7,14,5535,0,0
6318,ACGTCGAATCTAGGGA,102,103,1,16,5536,0,0
6319,ACGTCGAATCTAGGGA,102,110,8,15,5538,1,0
6320,ACGTCGAATCTAGGGA,102,114,12,11,5693,2,0
6321,ACGTCGAATCTAGGGA,102,104,2,19,5697,0,0
6322,ACGTCGAATCTAGGGA,102,112,10,16,5701,1,0
6323,ACGTCGAATCTAGGGA,102,125,23,15,5702,6,0
6324,ACGTCGAATCTAGGGA,102,106,4,15,5706,0,0
6325,ACGTCGAATCTAGGGA,102,103,1,17,5713,0,0
6326,ACGTCGAATCTAGGGA,102,112,10,9,5716,1,0
6327,ACGTCGAATCTAGGGA,102,132,30,17,5886,8,0
6328,ACGTCGAATCTAGGGA,102,103,1,17,5887,0,0
6329,ACGTCGAATCTAGGGA,102,106,4,9,5889,0,0
6330,ACGTCGAATCTAGGGA,102,104,2,15,5896,0,0
6331,ACGTCGAATCTAGGGA,102,105,3,15,5898,0,0
6332,ACGTCGAATCTAGGGA,102,105,3,16,5899,0,0
6333,ACGTCGAATCTAGGGA,102,102,0,15,5901,0,0
6334,ACGTCGAATCTAGGGA,102,105,3,12,5902,0,0
6335,ACGTCGAATCTAGGGA,102,105,3,13,5905,0,0
6336,ACGTCGAATCTAGGGA,102,104,2,14,5907,0,0
6337,ACGTCGAATCGAGGGA,102,105,3,16,5908,0,0
6338,ACGTCGAATCTAGGGA,102,105,3,15,5911,0,0
6339,ACGTCGAATCTAGGGA,102,105,3,17,5912,0,0
6340,ACGTCGAATCTAGGGA,102,105,3,17,5913,0,0
6341,ACGTCGAATCTAGGGA,102,105,3,16,5916,0,0
6342,ACGTCGAATATAGGGA,102,105,3,12,5917,0,0
6343,ACGTCGAATCTAGGGA,102,102,0,13,5918,0,0
6344,ACGTCGAATCTAGGGA,102,103,1,14,5922,0,0
6345,ACGTCGAATCTAGGGA,103,106,3,12,1476,0,0
6346,ACGTCGAATCTAGGGA,103,126,23,12,1968,6,0
6347,ACGTCGAATCTAGGGA,103,113,10,13,4140,1,0
6348,ACGTCGAATCTAGGGA,103,108,5,14,4741,0,0
6349,ACGTCGAATCTAGGGA,103,144,41,11,4959,12,0
6350,ACGTCGAATCTAGGGA,103,111,8,12,5035,1,0
6351,ACGTCGAATCTAGGGA,103,106,3,11,5151,0,0
6352,ACGTCGAATCTAGGGA,103,106,3,16,5158,0,0
6353,ACGTCGAATCTAGGGA,103,129,26,9,5197,7,0
6354,ACGTCGAATCTAGGGA,103,108,5,9,5318,0,0
6355,ACGTCGAATCTAGGGA,103,126,23,15,5326,6,0
6356,CCGTCGAATCTAGGGA,103,105,2,13,5329,0,0
6357,ACGTCGAATCTAGGGA,103,109,6,13,5335,0,0
6358,ACGTCGAATCTAGGGA,103,103,0,15,5336,0,0
6359,ACGTCGAATCTAGGGA,103,111,8,9,5370,1,0
6360,CCGTCGAATCTAGTGA,103,115,12,11,5375,2,0
6361,ACGTCGAATCTAGGGA,103,103,0,10,5376,0,0
6362,ACGTCGAATCTAGGGA,103,108,5,10,5380,0,0
6363,ACGTAGAATCTAGGGA,103,111,8,12,5382,1,0
6364,ACGTCGAATCTAGGGA,103,109,6,15,5494,0,0
6365,ACGTCGAATCTAGGGA,103,130,27,16,5495,7,0
6366,ACGTCGAATCTAGGGA,103,104,1,15,5498,0,0
6367,ACGTCGAATCTAGGGA,103,130,27,9,5553,7,0
6368,ACGTCGAATCTAGGGA,103,112,9,13,5678,1,0
6369,ACGTCGAATCTAGGGA,103,106,3,13,5684,0,0
6370,ACGTCGAATCTAGGGA,103,106,3,11,5686,0,0
6371,ACGTCGAATCTAGGGA,103,106,3,11,5690,0,0
6372,ACGTCGAATCTAGGGA,103,106,3,10,5735,0,0
6373,ACGTCGAATCTAGGGA,103,106,3,10,5736,0,0
6374,ACGTCGAATCTAGGGA,103,106,3,13,5863,0,0
6375,ACGTCGAATCTAGGGA,103,106,3,15,5864,0,0
6376,ACGTCGAAGCTAGGAA,103,105,2,17,5867,0,0
6377,ACGTCGAATCTAGGGA,103,103,0,15,5870,0,0
6378,ACGTCGAATCTAGGGA,103,103,0,14,5871,0,0
6379,ACGTCGAATCTAGGGA,103,106,3,11,5874,0,0
6380,ACGTCGAATCTAGGGA,103,106,3,14,5878,0,0
6381,ACGTCGAATCTAGGGA,103,106,3,11,5879,0,0
6382,ACGTCGAATCTAGGGA,103,106,3,15,5880,0,0
6383,ACGTCGAATCTAGGGA,103,106,3,12,5882,0,0
6384,ACGTCGAATCTAGGGA,103,106,3,9,6042,0,0
6385,ACGTCGAATCTAGGGA,103,106,3,13,6043,0,0
6386,ACGTCGAATCTAGGGA,103,106,3,15,6044,0,0
6387,ACGTCGAATCTAGGGA,103,106,3,16,6046,0,0
6388,ACGTCGAAACTAGGGA,103,106,3,15,6048,0,0
6389,ACGTCGAATCTAGGGA,103,103,0,11,6049,0,0
6390,ACGTCGAATCTAGGGA,103,106,3,11,6050,0,0
6391,ACGTCGAATCTAGGGA,103,106,3,15,6051,0,0
6392,ACGTCGAATCAAGGGA,103,103,0,15,6054,0,0
6393,ACGTCGAATCTAGGGA,103,106,3,15,6056,0,0
6394,ACGTCGAATCTAGGGA,103,106,3,16,6057,0,0
6395,ACGTCGAATCTAGGGA,103,106,3,17,6058,0,0
6396,ACGTCGAATCTAGGGA,104,163,59,8,1467,18,0
6397,ACGTCGAATCTAGGGA,104,104,0,15,2895,0,0
6398,ACGTCGAATCTAGGGA,104,109,5,14,4109,0,0
6399,ACGTCGAATCTAGGGA,104,116,12,10,4422,2,0
6400,ACGTCGAATCTAGGGA,104,120,16,18,4788,3,0
6401,ACGTCGAATCTAGGGA,104,120,16,14,4956,3,0
6402,ACGTCGAATCTAGGGA,104,105,1,14,5123,0,0
6403,ACGTCGAATCTAGGGA,104,116,12,15,5124,2,0
6404,ACGTCGAATCTAGGGA,104,111,7,14,5138,0,0
6405,ACGTCGAATCTAGGGA,104,104,0,9,5191,0,0
6406,ACGTCGAATCTAGGGA,104,109,5,18,5284,0,0
6407,ACGTCGAATCTAGGGA,104,105,1,14,5288,0,0
6408,ACGTCGAATCTAGGGA,104,105,1,15,5306,0,0
6409,ACGTCGAATCTAGGGA,104,129,25,14,5309,6,0
6410,ACGTCGAATCTAGGGA,104,113,9,15,5369,1,0
6411,ACGTCGAATCTAGGGA,104,112,8,13,5447,1,0
6412,ACGTCGAATCGAGGGA,104,107,3,15,5450,0,0
6413,ACGTCGAATCTAGGGA,104,117,13,13,5456,2,0
6414,ACGTCGAATCTAGGGA,104,104,0,14,5457,0,0
6415,ACGTCGAATCTAGGGA,104,105,1,16,5459,0,0
6416,ACGTCGAATCTAGGGA,104,113,9,16,5460,1,0
6417,ACGTCGAATCTAGGGA,104,116,12,11,5469,2,0
6418,ACGTCGAATCTAGGGA,104,109,5,12,5470,0,0
6419,ACGTCGAATCTAGGGA,104,110,6,9,5476,0,0
6420,ACGTCGAATCTAGGGA,104,124,20,13,5482,5,0
6421,ACGTCGAATCTAGGGA,104,110,6,12,5484,0,0
6422,ACGTCGAATCTAGGGA,104,108,4,12,5485,0,0
6423,ACGTCGAATCTAGGGA,104,106,2,12,5540,0,0
6424,ACGGCGAATCTAGGGA,104,111,7,14,5639,0,0
6425,ACGTCGAATCTAGGGA,104,107,3,15,5647,0,0
6426,ACGTCGAATCTAGGGA,104,113,9,8,5648,1,0
6427,ATGTCGAATCTAGGGA,104,105,1,17,5657,0,0
6428,ACGTCGAATCTAGGGA,104,107,3,15,5659,0,0
6429,ACGTCGAATCTAGGGA,104,107,3,19,5664,0,0
6430,ACGTCGAATCTAGGGA,104,115,11,16,5668,2,0
6431,ACGTCGAATCTAGGGA,104,104,0,14,5673,0,0
6432,ACGTCGAATCTAGGGA,104,108,4,8,5718,0,0
6433,ACGTCGAATCTAGGGA,104,114,10,13,5721,1,0
6434,ACGTCGAATCTAGGGA,104,119,15,15,5724,3,0
6435,ACGTCGAATCTAGGGA,104,107,3,15,5731,0,0
6436,ACGTCGAATCTAGGGA,104,110,6,13,5817,0,0
6437,ACGTCTAATCTAGGGA,104,125,21,15,5820,5,0
6438,ACGTCGAATCTAGGGA,104,107,3,15,5821,0,0
6439,ACGTCGAATCTAGGGA,104,120,16,12,5824,3,0
6440,ACGTCGAATCTAGGGA,104,105,1,8,5827,0,0
6441,ACGTCGAATCTAGGGA,104,106,2,16,5834,0,0
6442,ACGTCGAATCTAGGGA,104,104,0,17,5835,0,0
6443,ACGTCGAATCTAGGGA,104,104,0,10,5843,0,0
6444,ACGTCGAATCTAGGGA,104,106,2,10,5850,0,0
6445,ACGTCGAATCTAGGGA,104,120,16,13,5851,3,0
6446,ACGTCGAATCTAGGGA,104,107,3,16,5857,0,0
6447,ACGTCGAATCTAGGGA,104,108,4,16,5859,0,0
6448,ACGTCGAATCTAGGGA,104,114,10,14,5997,1,0
6449,ACGTGGAATCTAGGGA,104,118,14,13,5998,3,0
6450,ACGTCGAATCTAGGGA,104,114,10,14,5999,1,0
6451,ACGTCGAATCTAGGGA,104,121,17,15,6000,4,0
6452,ACGTCGAATCTAGGGA,104,106,2,12,6005,0,0
6453,ACGTCGAATCTAGGGA,104,117,13,10,6009,2,0
6454,ACGTCGAATCTAGGGA,104,108,4,13,6011,0,0
6455,CCGTCGAATCTAGGGA,104,106,2,14,6014,0,0
6456,ACGTCGAATCTAGGGA,104,106,2,14,6015,0,0
6457,ACGTCGAATCTAGGGA,104,105,1,10,6019,0,0
6458,ACGTCGAATCTAGGGA,104,118,14,11,6022,3,0
6459,ACGTCGAATCTAGGGA,104,104,0,11,6024,0,0
6460,ACGTAGAATCTAGGGA,104,104,0,13,6025,0,0
6461,ACGTCGAATCTAGGGA,104,107,3,16,6026,0,0
6462,ACGTCGAATCTAGGGA,104,107,3,17,6027,0,0
6463,ACGTCGAATCTAGGGA,104,107,3,16,6029,0,0
6464,ACGTCGAATCTAGGGA,104,107,3,10,6031,0,0
6465,ACGTCGAATCTAGGGA,104,107,3,13,6033,0,0
6466,ACGTCGAATCTAGGGA,104,107,3,14,6034,0,0
6467,ACGTCGAATCTAGGGA,104,107,3,15,6039,0,0
6468,ATGTCGAATCTAGGGA,104,106,2,12,6040,0,0
6469,ACGTCGAATCTAGGGA,105,108,3,8,294,0,0
6470,ACGTCGAATCTAGGGA,105,111,6,9,470,0,0
6471,ACGTCGAATCTAGGGA,105,117,12,12,728,2,0
6472,ACGTCGAATCTAGGGA,105,115,10,13,1062,1,0
6473,ACGTCGAATCTAGGGA,105,106,1,13,4046,0,0
6474,ACGTAGAATCTAGGGA,105,122,17,12,4051,4,0
6475,ACGTCGAATCTAGGGA,105,110,5,13,4972,0,0
6476,ACGTCGAATCTAGGGA,105,105,0,14,5176,0,0
6477,ACGTCGAATCTAGGGA,105,111,6,10,5180,0,0
6478,ACGTCGAATCTAGGGA,105,114,9,11,5182,1,0
6479,ACGTCGAATCTAGGGA,105,125,20,11,5186,5,0
6480,ACGTCGAATCTAGGGA,105,108,3,16,5365,0,0
6481,ACGTCGAATATAGGGA,105,108,3,15,5515,0,0
6482,ACGTCGAATCTAGGGA,105,108,3,11,5516,0,0
6483,ACGTCGAATCTAGGGA,105,106,1,19,5518,0,0
6484,ACGTCGAATCTAGGGA,105,108,3,15,5528,0,0
6485,ACGTCGATTCTAGGGA,105,108,3,11,5533,0,0
6486,ACGTCGAATCTAGGGA,105,108,3,14,5535,0,0
6487,ACGTCGAATCTAGGGA,105,105,0,16,5536,0,0
6488,ACGTCGAATCTAGGGA,105,108,3,11,5693,0,0
6489,ACGTCGAATCTAGGGA,105,105,0,19,5697,0,0
6490,ACGTCGAATCTAGGGA,105,106,1,16,5701,0,0
6491,ACGTCGAATCTAGGGA,105,108,3,15,5706,0,0
6492,ACGTCGAATCTAGGGA,105,105,0,17,5713,0,0
6493,ACGTCGAATCTAGGGA,105,108,3,17,5886,0,0
6494,ACGTCGAATCTAGGGA,105,105,0,17,5887,0,0
6495,ACGTCGAATCTAGGGA,105,108,3,9,5889,0,0
6496,ACGTCGAATCTAGGGA,105,108,3,15,5896,0,0
6497,ACGTCGAATCTAGGGA,105,108,3,16,5899,0,0
6498,ACGTCGAATCTAGGGA,105,108,3,12,5902,0,0
6499,ACGTCGAATCTAGGGA,105,106,1,13,5905,0,0
6500,ACGTCGAATCTAGGGA,105,105,0,14,5907,0,0
6501,ACGTCGAATCGAGGGA,105,107,2,16,5908,0,0
6502,ACGTCGAATCTAGGGA,105,106,1,15,5911,0,0
6503,ACGTCGAATCTAGGGA,105,108,3,17,5913,0,0
6504,ACGTCGAATCTAGGGA,105,105,0,16,5916,0,0
6505,ACGTCGAATCTAGGGA,105,107,2,13,5918,0,0
6506,ACGTCGAATCTAGGGA,105,108,3,14,5922,0,0
6507,ACGTCGAATCTAGGGA,105,106,1,15,6060,0,0
6508,ACGTCGAATCTAGGGA,105,105,0,19,6063,0,0
6509,ACGTCGAATCTAGGGA,105,108,3,13,6065,0,0
6510,ACGTCGAATCTAGGGA,105,108,3,16,6066,0,0
6511,ACGTCGAATCTAGGGA,105,108,3,16,6069,0,0
6512,ACGTCGAATCTAGGGA,105,108,3,13,6070,0,0
6513,ACGTCGAATCTAGGGA,105,108,3,14,6071,0,0
6514,ACGTCGAATCGAGGGA,105,105,0,16,6073,0,0
6515,ACGTCGAATCTAGGGA,105,108,3,17,6076,0,0
6516,ACGTCGAATCTAGGGA,105,106,1,16,6078,0,0
6517,ACGTCGAATCTAGGGA,105,108,3,13,6081,0,0
6518,ACGTCGAATCTAGGGA,105,108,3,13,6088,0,0
6519,ACGTCGAATCTAGGGA,105,106,1,16,6091,0,0
6520,ACGTCTAATCTAGGGA,105,105,0,16,6096,0,0
6521,ACGTCGAATCTAGGGA,105,108,3,16,6100,0,0
6522,ACGTCGAATCTAGGGA,105,108,3,9,6101,0,0
6523,ACGTCGAATCTAGGGA,105,108,3,13,6102,0,0
6524,ACGTCGAATCTAGGGA,105,105,0,14,6103,0,0
6525,ACGTCGAATCTAGGGA,106,109,3,12,1476,0,0
6526,ACGTCGAATCTAGGGA,106,122,16,13,4140,3,0
6527,ACGTCGAATCTAGGGA,106,108,2,14,4741,0,0
6528,ACGTCGAATCTAGGGA,106,112,6,11,4959,0,0
6529,ACGTCGAATCTAGGGA,106,109,3,12,5035,0,0
6530,ACGTCGAATCTAGGGA,106,114,8,11,5151,1,0
6531,ACGTCGAATCTAGGGA,106,110,4,16,5158,0,0
6532,ACGTCGAATCTAGGGA,106,126,20,9,5197,5,0
6533,ACGTCGAATCTAGGGA,106,112,6,9,5318,0,0
6534,ACGTCGAATCTAGGGA,106,127,21,15,5326,5,0
6535,CCGTCGAATCTAGGGA,106,107,1,13,5329,0,0
6536,ACGTCGAATCTAGGGA,106,106,0,13,5335,0,0
6537,ACGTCGAATCTAGGGA,106,109,3,10,5376,0,0
6538,ACGTCGAATCTAGGGA,106,114,8,15,5494,1,0
6539,ACGTCGAATCTAGGGA,106,110,4,16,5495,0,0
6540,ACGTCGAATCTAGGGA,106,109,3,15,5498,0,0
6541,ACGTCGAATCTAGGGA,106,118,12,9,5553,2,0
6542,ACGTCGAATCTAGGGA,106,107,1,13,5678,0,0
6543,ACGTCGAATCTAGGGA,106,107,1,13,5684,0,0
6544,ACGTCGAATCTAGGGA,106,120,14,11,5690,3,0
6545,ACGTCGAATCTAGGGA,106,112,6,10,5735,0,0
6546,ACGTCGAATCTAGGGA,106,109,3,10,5736,0,0
6547,ACGTCGAAGCTAGGAA,106,108,2,17,5867,0,0
6548,ACGTCGAATCTAGGGA,106,117,11,15,5870,2,0
6549,ACGTCGAATCTAGGGA,106,110,4,14,5871,0,0
6550,ACGTCGAATCTAGGGA,106,106,0,11,5874,0,0
6551,ACGTCGAATCTAGGGA,106,109,3,14,5878,0,0
6552,ACGTCGAATCTAGGGA,106,112,6,11,5879,0,0
6553,ACGTCGAATCTAGGGA,106,108,2,15,5880,0,0
6554,ACGTCGAATCTAGGGA,106,108,2,12,5882,0,0
6555,ACGTCGAATCTAGGGA,106,125,19,9,6042,4,0
6556,ACGTCGAATCTAGGGA,106,116,10,16,6046,1,0
6557,ACGTCGAATCTAGGGA,106,130,24,15,6048,6,0
6558,ACGTCGAATCTAGGGA,106,132,26,11,6050,7,0
6559,ACGTCGAAGCTAGGGA,106,116,10,15,6051,1,0
6560,ACGTCGAATCAAGGGA,106,106,0,15,6054,0,0
6561,ACGTCGAATCTAGGGA,106,116,10,15,6056,1,0
6562,ACGTCGAATCTAGGGA,106,111,5,9,6112,0,0
6563,ACGTCGAATCTAGGGA,106,106,0,16,6221,0,0
6564,ACGTCGAATCTAGGGA,106,117,11,11,6223,2,0
6565,ACGTCGAATCTAGGGA,106,109,3,19,6225,0,0
6566,ACGTCGAATCTAGGGA,106,115,9,15,6228,1,0
6567,ACGTCGAATCTAGGGA,107,111,4,8,1467,0,0
6568,ACGTCGAATCTAGGGA,107,107,0,14,4109,0,0
6569,ACGTCGAATCTAGGGA,107,115,8,10,4422,1,0
6570,ACGTCGAATCTAGGGA,107,122,15,18,4788,4,0
6571,ACGTCGAATCTAGGGA,107,157,50,14,4956,15,0
6572,ACGTCGAATCTAGGGA,107,117,10,14,5123,2,0
6573,ACGTCGAATCTAGGGA,107,134,27,15,5124,8,0
6574,ACGTCGAATCTAGGGA,107,108,1,14,5138,0,0
6575,ACGTCGAATCTAGGGA,107,108,1,9,5191,0,0
6576,ACGTCGAATCTAGGGA,107,107,0,18,5284,0,0
6577,ACGTCGAATCTAGGGA,107,131,24,14,5288,7,0
6578,ACGTCGAATCTAGGGA,107,108,1,15,5306,0,0
6579,ACGTCGAATCTAGGGA,107,114,7,14,5309,1,0
6580,ACGTCGAATCTAGGGA,107,112,5,15,5369,0,0
6581,ACGTCGAATCTAGGGA,107,107,0,13,5447,0,0
6582,ACGTCGAATCGAGGGA,107,111,4,15,5450,0,0
6583,ACGTCGAATCTAGGGA,107,121,14,13,5456,3,0
6584,ACGTCGAATCTAGGGA,107,114,7,16,5459,1,0
6585,ACGTCGAATCTAGGGA,107,114,7,16,5460,0,0
6586,ACGTCGAATCTAGGGA,107,109,2,11,5469,0,0
6587,ACGTCGAATCTAGGGA,107,144,37,12,5470,10,0
6588,ACGTCGAATCTAGGGA,107,117,10,9,5476,1,0
6589,ACGTCGAAACTAGGGA,107,109,2,13,5482,0,0
6590,ACGTCGAATCTAGGGA,107,119,12,12,5485,2,0
6591,ACGGCGAATCTAGGGA,107,112,5,14,5639,0,0
6592,ACGTCGAATCTAGGGA,107,121,14,15,5647,3,0
6593,ACGTCGAATCTAGGGA,107,110,3,15,5659,0,0
6594,ACGTCGAATCTAGGGA,107,110,3,19,5664,0,0
6595,ACGTCGAATCTAGGGA,107,110,3,16,5668,0,0
6596,ACGTCGAATCTAGGGA,107,110,3,14,5673,0,0
6597,ACGTCGAATCTAGGGA,107,110,3,8,5718,0,0
6598,ACGTCGAATCTAGGGA,107,110,3,15,5724,0,0
6599,ACGTCGAATCTAGGGA,107,110,3,15,5731,0,0
6600,ACGTCGAATCTAGGGA,107,109,2,13,5817,0,0
6601,ACGTCGAATCTAGGGA,107,110,3,15,5821,0,0
6602,ACGTCGAATCTAGGGA,107,108,1,8,5827,0,0
6603,ACGTCGAATCTAGGGA,107,110,3,16,5834,0,0
6604,ACGTCGAATCTAGGGA,107,110,3,17,5835,0,0
6605,ACGTCGAATCTAGGGA,107,110,3,10,5843,0,0
6606,ACGTCGAATCTAGGGA,107,110,3,10,5850,0,0
6607,ACGTCGAATCTAGGGA,107,110,3,16,5857,0,0
6608,ACGTCGAATCTAGGGA,107,110,3,16,5859,0,0
6609,ACGTCGAATCTAGGGA,107,110,3,14,5997,0,0
6610,ACGTCAAATCTAGGGA,107,110,3,13,5998,0,0
6611,ACGTCGAATCTAGGGA,107,108,1,15,6000,0,0
6612,ACGTCGAATCTAGGGA,107,109,2,14,6015,0,0
6613,ACGTCGAATCTAGGGA,107,110,3,11,6022,0,0
6614,ACGTCGAATCTAGGGA,107,110,3,11,6024,0,0
6615,ACGTCGAATCTAGGGA,107,109,2,17,6027,0,0
6616,ACGTCGAATCTAGGGA,107,107,0,16,6029,0,0
6617,ACGTCGAATCTAGGGA,107,110,3,15,6039,0,0
6618,ATGTCGAATCTAGGGA,107,109,2,12,6040,0,0
6619,ACGTCGAATCTAGGGA,107,110,3,13,6169,0,0
6620,ACGTCGAATCTAGGGA,107,107,0,14,6171,0,0
6621,ACGTCGAACCTAGGGA,107,110,3,13,6177,0,0
6622,ACGTCGAATCTAGGGA,107,108,1,17,6179,0,0
6623,ACGTCGAATCTAGGGA,107,110,3,10,6180,0,0
6624,ACGTCGAATCTAGGGA,107,110,3,10,6183,0,0
6625,ACGTCGAATCTAGGGA,107,110,3,16,6184,0,0
6626,CCGTCGAATCTAGGGA,107,110,3,14,6185,0,0
6627,ACGTCGAATCTAGGGA,107,110,3,14,6186,0,0
6628,ACGTCGAATCTAGGGA,107,110,3,16,6187,0,0
6629,ACGTCGAATCTAGGGA,107,110,3,11,6188,0,0
6630,CCGTCGAATCTAGTGA,107,110,3,12,6190,0,0
6631,ACGTCGAATCTAGGGA,107,110,3,11,6191,0,0
6632,ACGTCGAATCTAGGGA,107,110,3,11,6193,0,0
6633,ACGTCGAATCTAGGGA,107,110,3,14,6201,0,0
6634,ACGTCGAATCTAGGGA,107,110,3,11,6207,0,0
6635,ACGTCGAATCTAGGGA,107,108,1,14,6209,0,0
6636,ACGTCGAATCTAGGGA,107,109,2,13,6212,0,0
6637,ACGTCGAATCTAGGGA,107,108,1,15,6216,0,0
6638,ACGTCGAATCTAGGGA,108,113,5,8,294,0,0
6639,ACGTCGAATCTAGGGA,108,112,4,9,470,0,0
6640,ACGTCGAATCTAGGGA,108,124,16,12,728,3,0
6641,ACGTCGAATCTAGGGA,108,111,3,13,1062,0,0
6642,ACGTCGAATCTAGGGA,108,115,7,13,4046,0,0
6643,ACGTCGAATCTAGGGA,108,108,0,12,4051,0,0
6644,ACGTCGAATCTAGGGA,108,121,13,13,4972,2,0
6645,ACGTCGAATCTAGGGA,108,109,1,14,5176,0,0
6646,ACGTCGAATCTAGGGA,108,121,13,10,5180,2,0
6647,ACGTCGAATCTAGGGA,108,108,0,11,5182,0,0
6648,ACGTCGAATCTAGGGA,108,127,19,16,5365,4,0
6649,ACGTCGAATCTAGGGA,108,115,7,15,5515,0,0
6650,ACGTCGAATCTAGGGA,108,110,2,11,5516,0,0
6651,ACGTCGATTCTAGGGA,108,115,7,11,5533,0,0
6652,ACGTCGAATCTAGGGA,108,126,18,16,5536,4,0
6653,ACGTCGAATCTAGGGA,108,110,2,19,5697,0,0
6654,ACGTCGAATCTAGGGA,108,108,0,16,5701,0,0
6655,ACGTCGAATCTAGGGA,108,108,0,15,5706,0,0
6656,ACGTTGAATCTAGGGA,108,118,10,17,5713,1,0
6657,ACGTCGAATCTAGGGA,108,114,6,17,5886,0,0
6658,ACGTCGAATCTAGGGA,108,142,34,15,5896,9,0
6659,ACGTCGAATCTAGGGA,108,124,16,16,5899,3,0
6660,ACGTCGAATCTAGGGA,108,111,3,12,5902,0,0
6661,ACGTCGAATCTAGGGA,108,108,0,14,5907,0,0
6662,ACGTCGAATCGAGGGA,108,123,15,16,5908,3,0
6663,ACGTCGAATCTAGGGA,108,136,28,15,5911,7,0
6664,ACGTCGAATCTAGGGA,108,119,11,17,5913,2,0
6665,ACGTCGAATCTAGGGA,108,115,7,16,5916,0,0
6666,ACGTCGAATCTAGGGA,108,119,11,13,5918,2,0
6667,ACGTCGAATCTAGGGA,108,112,4,15,6060,0,0
6668,ACGTCGAATCTAGGGA,108,109,1,19,6063,0,0
6669,ACGTCGAATCTAGGGA,108,111,3,13,6065,0,0
6670,ACGTCGAATCTAGGGA,108,122,14,16,6066,3,0
6671,ACGTCGAATCTAGGGA,108,110,2,16,6069,0,0
6672,ACGTCGAATCTAGGGA,108,109,1,13,6070,0,0
6673,ACGTCGAATCTAGGGA,108,122,14,14,6071,3,0
6674,ACGTCGAATCGAGGGA,108,115,7,16,6073,0,0
6675,ACGTCGAATCTAGGGA,108,109,1,16,6078,0,0
6676,ACGTCGAATCTAGGGA,108,113,5,13,6081,0,0
6677,ACGTCGAATCTAGGGA,108,124,16,13,6088,3,0
6678,ACGTCGAATCTAGGGA,108,110,2,16,6091,0,0
6679,ACGTCTAATCTAGGGA,108,109,1,16,6096,0,0
6680,ACGTCGAATCTAGGGA,108,113,5,16,6100,0,0
6681,ACGTCGAATCTAGGGA,108,117,9,9,6101,1,0
6682,ACGTCGAATCTAGGGA,108,120,12,13,6102,2,0
6683,ACGTCGAATCTAGGGA,108,110,2,14,6103,0,0
6684,ACGTCGAATCTAGGGA,108,116,8,16,6229,1,0
6685,ACGTCGAATCTAGGGA,108,115,7,15,6232,0,0
6686,ACGTCGAATCTAGGGA,108,115,7,15,6235,0,0
6687,ACGTCGAATCTAGGGA,108,139,31,13,6236,8,0
6688,ACGTCGAATCTAGGGA,108,113,5,15,6238,0,0
6689,ACGTCGAATCTGGGGA,108,111,3,15,6239,0,0
6690,ACGTCGAATCTAGGGA,108,108,0,16,6240,0,0
6691,ACGTCGAATCTAGGGA,108,114,6,14,6241,0,0
6692,ACGTCGAATCTAGGGA,108,111,3,17,6245,0,0
6693,ACGTCGAATCTAGGGA,108,108,0,17,6246,0,0
6694,ACGTCGAATCTAGGGA,108,108,0,10,6250,0,0
6695,ACGTCGAATCTAGGGA,108,112,4,13,6251,0,0
6696,ACGTCGAATCTAGGGA,108,115,7,14,6252,0,0
6697,ACGTCGAATCTAGGGA,108,125,17,13,6254,4,0
6698,ACGTCTAATCTAGGGA,108,113,5,16,6258,0,0
6699,ACGTCGAATCTAGGGA,109,118,9,12,1476,2,0
6700,ACGTCGAATCTAGGGA,109,113,4,13,4140,0,0
6701,ACGTCGAATCTAGGGA,109,119,10,14,4741,1,0
6702,ACGTCGAATCTAGGGA,109,110,1,12,5035,0,0
6703,ACGTAGAATCTAGGGA,109,136,27,11,5151,7,0
6704,ACGTCGAATCTAGGGA,109,129,20,9,5318,5,0
6705,ACGTCGAATCTAGGGA,109,119,10,15,5326,1,0
6706,ACGTCGAATCTAGGGA,109,120,11,13,5335,2,0
6707,ACGTCGAATCTAGGGA,109,117,8,10,5376,1,0
6708,ACGTCGAATCTAGGGA,109,126,17,16,5495,4,0
6709,ACGTCGAATCTAGGGA,109,114,5,15,5498,0,0
6710,ACGTCGAATCTAGGGA,109,110,1,13,5684,0,0
6711,ACGTCGAATCTAGGGA,109,119,10,11,5690,1,0
6712,ACGTCGAATCTAGGGA,109,112,3,10,5735,0,0
6713,ACGTCGAATCTAGGGA,109,114,5,14,5871,0,0
6714,ACGTCGAATCTAGGGA,109,117,8,11,5874,1,0
6715,ACGTCGAATCTAGGGA,109,115,6,14,5878,0,0
6716,ACGTCGAATCTAGGGA,109,115,6,15,5880,0,0
6717,ACGTCGAATCTAGGGA,109,132,23,12,5882,6,0
6718,ACGTCGAATCTAGGGA,109,121,12,9,6042,2,0
6719,ACGTCGAATCTAGGGA,109,113,4,16,6046,0,0
6720,ACGTCGAATCTAGGGA,109,112,3,15,6048,0,0
6721,ACGTCGAATCTACGGA,109,129,20,11,6050,4,0
6722,ACGTCGAATCAAGGGA,109,112,3,15,6054,0,0
6723,ACGTCGAATCTAGGGA,109,112,3,15,6056,0,0
6724,ACGTCGAATCTAGGGA,109,112,3,9,6112,0,0
6725,ACGTCGAATCTAGGGA,109,110,1,16,6221,0,0
6726,ACGTCGAATCTAGGGA,109,112,3,11,6223,0,0
6727,ACGTCTAATCTAGGGA,109,110,1,15,6228,0,0
6728,ACGTCGAATCTAGGGA,109,109,0,10,6287,0,0
6729,ACGTCGAATCTAGGGA,109,112,3,14,6289,0,0
6730,ACGTCGAATCTAGGGA,109,112,3,14,6291,0,0
6731,ACGTCGAATCTAGGGA,109,112,3,13,6293,0,0
6732,ACGTCGAATCTAGGGA,109,112,3,13,6294,0,0
6733,ACGTCGAATCTAGGGA,109,112,3,12,6295,0,0
6734,ACGTCGAATCTAGGGA,109,109,0,13,6296,0,0
6735,ACGTCGAATCTAGGGA,109,112,3,15,6300,0,0
6736,ACGTCGAATCTAGGGC,109,112,3,16,6306,0,0
6737,AGGTCGAATCTAGGGA,109,112,3,15,6308,0,0
6738,ACATCGAATCTAGGGA,109,112,3,13,6311,0,0
6739,ACGTCGAATCTAGGGA,109,112,3,16,6315,0,0
6740,ACGTCGATTCTAGGGA,109,109,0,12,6316,0,0
6741,ACGTCGAATCTAGGGA,109,112,3,16,6319,0,0
6742,ACGTCGAATCTAGGGA,109,109,0,12,6320,0,0
6743,ACGTCGAATCTAGGGA,109,112,3,17,6322,0,0
6744,ACGTCGAATCTAGGGA,109,110,1,16,6323,0,0
6745,ACGTCGAATCTAGGGA,109,112,3,10,6326,0,0
6746,ACGTCGAATCTAGGGA,109,111,2,18,6327,0,0
6747,ACGTCGAATCTAGGGA,110,139,29,8,1467,8,0
6748,ACGTCGAATCTAGGGA,110,121,11,14,4109,2,0
6749,ACGTCGAATCTAGGGA,110,125,15,18,4788,3,0
6750,ACGTCGAATCTAGGGA,110,115,5,14,4956,0,0
6751,ACGTCGAATCTAGGGA,110,110,0,14,5123,0,0
6752,ACGTCGAATCTAGGGA,110,124,14,15,5124,3,0
6753,ACGTCGAATCTAGGGA,110,115,5,14,5138,0,0
6754,ACGTCGAATCTAGGGA,110,120,10,9,5191,1,0
6755,ACGTCGAATCTAGGGA,110,114,4,18,5284,0,0
6756,ACGTCGAATCTAGGGA,110,151,41,14,5288,12,0
6757,ACGTCGAATCTAGGGA,110,115,5,15,5306,0,0
6758,ACGTCGAATCTAGGGA,110,115,5,14,5309,0,0
6759,ACGTCGAATCTAGGGA,110,112,2,15,5369,0,0
6760,ACGTCGAATCGAGGGA,110,110,0,15,5450,0,0
6761,ACGTCGAATCTAGGGA,110,116,6,13,5456,0,0
6762,ACGTCGAATCTAGGGA,110,118,8,11,5469,1,0
6763,ACGTCGAATCTAGGGA,110,125,15,9,5476,3,0
6764,ACGTCGAATCTAGGGA,110,112,2,13,5482,0,0
6765,ACGTCGAATCTAGGGA,110,110,0,12,5485,0,0
6766,ACGGCGAATCTAGGGA,110,112,2,14,5639,0,0
6767,ACGTCGAATCTAGGGA,110,119,9,15,5659,1,0
6768,ACGTCGAATCTAGGGA,110,113,3,19,5664,0,0
6769,ACGTCGAATCTAGGGA,110,125,15,16,5668,3,0
6770,ACGTCGAATCTAGGGA,110,121,11,14,5673,2,0
6771,ACGTCGAATCTAGGGA,110,138,28,15,5724,7,0
6772,ACGTCGAATCTAGGGA,110,113,3,15,5731,0,0
6773,ACGTCGAATCTAGGGA,110,128,18,13,5817,4,0
6774,ACGTCGAATCTAGGGA,110,121,11,15,5821,2,0
6775,ACGTCGAATCTAGGGA,110,119,9,8,5827,1,0
6776,ACGTCGAATCTAGGGA,110,117,7,17,5835,0,0
6777,ACGTCGAATCTAGGGA,110,112,2,10,5843,0,0
6778,ACGTCGAATCTAGGGA,110,122,12,10,5850,2,0
6779,ACGTCGAATCTAGGGA,110,112,2,16,5857,0,0
6780,ACGTCGAATCTAGGGA,110,113,3,14,5997,0,0
6781,ACGTCGAATCTAGGGA,110,111,1,13,5998,0,0
6782,ACGTCGAATCTAGGGA,110,113,3,14,6015,0,0
6783,ACGTCGAATCTAGGGA,110,111,1,11,6022,0,0
6784,ACGTCGAATCTAGGGA,110,113,3,11,6024,0,0
6785,ACGTCGAATCTAGGGA,110,113,3,17,6027,0,0
6786,ACGTCGAATCTAGGGA,110,113,3,16,6029,0,0
6787,ACGTCGAATCTAGGGA,110,113,3,14,6171,0,0
6788,ACGTCGAACCTAGGGA,110,113,3,13,6177,0,0
6789,ACGTCGAATCTAGGGA,110,113,3,17,6179,0,0
6790,ACGTCGAATCTAGGGA,110,110,0,10,6180,0,0
6791,ACGTCGAATCTAGGGA,110,113,3,16,6184,0,0
6792,ACGTCGAATCTAGGGA,110,110,0,16,6187,0,0
6793,CCGTCGAATCTAGTGG,110,113,3,12,6190,0,0
6794,ACGTCGAATCTAGGGA,110,112,2,11,6191,0,0
6795,ACGTCGAATCTAGGGA,110,113,3,11,6193,0,0
6796,ACGTCGAATCTAGGGA,110,113,3,14,6201,0,0
6797,ACGTCGAATCTAGGGA,110,113,3,11,6207,0,0
6798,ACGTCGAATCTAGGGA,110,111,1,14,6209,0,0
6799,ACGTCGAATCTAGGGA,110,113,3,13,6212,0,0
6800,ACGTCGAATCTAGGGA,110,113,3,15,6216,0,0
6801,ACGTCGAATCTAGGGA,110,113,3,13,6346,0,0
6802,ATGTCGAATCTAGGGA,110,113,3,14,6347,0,0
6803,ACGTCGAATCTAGGGA,110,110,0,12,6349,0,0
6804,ACGTCGAATCTAGGGA,110,113,3,13,6350,0,0
6805,ACGTCGAATCTAGGGA,110,113,3,10,6353,0,0
6806,ACGTCGAATCTAGGGA,110,113,3,16,6355,0,0
6807,ACGTCGAATCTAGGGA,110,113,3,10,6359,0,0
6808,CCGTCGAATCTAGTGA,110,113,3,12,6360,0,0
6809,ACGTAGAATCTAGGGA,110,113,3,13,6363,0,0
6810,ACGTCGAATCTAGGGA,110,113,3,17,6365,0,0
6811,ACGTCGAATCTAGGGA,110,113,3,10,6367,0,0
6812,ACGTCGAATCTAGGGA,110,113,3,14,6368,0,0
6813,ACGTCGAATCTAGGGA,111,112,1,8,294,0,0
6814,ACGTCGAATCTAGGGA,111,113,2,12,728,0,0
6815,ACGTCGAATCTAGGGA,111,116,5,13,4046,0,0
6816,ACGTCGAATCTAGGGA,111,146,35,13,4972,10,0
6817,ACGTCGAATCTAGGGA,111,115,4,14,5176,0,0
6818,ACGTCGAATCTAGGGA,111,115,4,10,5180,0,0
6819,ACGTCGAATCTAGGGA,111,115,4,11,5182,0,0
6820,ACGTCGAATCTAGGGA,111,112,1,16,5365,0,0
6821,ACGTCGAATCTAGGGA,111,131,20,15,5515,5,0
6822,ACGTCGAATCTAGGGA,111,115,4,11,5516,0,0
6823,ACGTCGAATCTAGGGA,111,115,4,16,5536,0,0
6824,ACGTCGAATCTAGGGA,111,113,2,19,5697,0,0
6825,ACGTCGAATCTAGGGA,111,116,5,16,5701,0,0
6826,ACGTCGAATCTAGGGA,111,111,0,15,5706,0,0
6827,ACGTCGAATCTAGGGA,111,118,7,17,5713,0,0
6828,ACGTCGAATCTAGGGA,111,123,12,17,5886,2,0
6829,ACGTCGAATCTAGGGA,111,118,7,15,5896,0,0
6830,ACGTCGAATCTAGGGA,111,111,0,16,5899,0,0
6831,ACGTCGAATCTAGGGA,111,140,29,12,5902,8,0
6832,ACGTCGAATCTAGGGA,111,113,2,14,5907,0,0
6833,ACGTCGAATCGAGGGA,111,112,1,16,5908,0,0
6834,ACGTCGAATCTAGGGA,111,121,10,15,5911,1,0
6835,ACGTCGAATCTAGGGA,111,116,5,16,5916,0,0
6836,ACGTCGAATCTAGGGA,111,113,2,13,5918,0,0
6837,ACGTCGAATCTAGGGA,111,118,7,15,6060,0,0
6838,ACGTCGAATCTAGGGA,111,124,13,13,6065,2,0
6839,ACGTCGAATCTAGGGA,111,119,8,16,6066,1,0
6840,ACGTCGAATCTAGGGA,111,114,3,16,6069,0,0
6841,ACGTCGAATCTAGGGA,111,113,2,14,6071,0,0
6842,ACGTCGAATCGAGGGA,111,124,13,16,6073,2,0
6843,ACGTCGAATCTAGGGA,111,115,4,16,6078,0,0
6844,ACGTCGAATCTAGGGA,111,141,30,16,6091,8,0
6845,ACGTCGAATCTAGGGA,111,111,0,16,6100,0,0
6846,ACGTCGAATCTAGGGA,111,114,3,9,6101,0,0
6847,ACGTCGAATCTAGGGA,111,136,25,13,6102,6,0
6848,ACGTCGAATCTAGGGA,111,120,9,14,6103,1,0
6849,ACGTCGAATCTAGGGA,111,112,1,16,6229,0,0
6850,ACGTCGAATCTAGGGA,111,126,15,15,6235,3,0
6851,ACGTCGAATCTAGGGA,111,125,14,13,6236,3,0
6852,ACGTCGAATCTAGGGA,111,113,2,15,6238,0,0
6853,ACGTCGAATCTAGGGA,111,117,6,15,6239,0,0
6854,ACGTCGAATCTAGGGA,111,134,23,16,6240,6,0
6855,ACGTCGAATCTAGGGA,111,150,39,14,6241,11,0
6856,ACGTCGAATCTAGGGA,111,115,4,17,6245,0,0
6857,ACGTCGAATCTAGGGA,111,112,1,17,6246,0,0
6858,ACGTCGAATCTAGGGA,111,113,2,10,6250,0,0
6859,ACGTCGAATCTAGGGA,111,118,7,13,6251,0,0
6860,ACGTCGAATCTAGGGA,111,115,4,13,6254,0,0
6861,ACGTCTAATCTAGGGA,111,136,25,16,6258,6,0
6862,ACGTCGAATCTAGGGA,111,114,3,9,6396,0,0
6863,ACGTCGAATCTAGGGA,111,119,8,11,6399,1,0
6864,ACGTCGAATCTAGGGA,111,117,6,19,6400,0,0
6865,ACGTCGAATCTAGGGA,111,112,1,15,6401,0,0
6866,ACGTCGAATCTAGGGA,111,113,2,16,6403,0,0
6867,ACGTCGAATCTATGGA,111,149,38,15,6409,11,0
6868,ACGTCGAATCTAGGGA,111,114,3,16,6410,0,0
6869,ACGTCGAATCTAGGGA,111,114,3,14,6411,0,0
6870,ACGTCGAATCTAGGGA,111,112,1,14,6413,0,0
6871,ACGTCGAATCTAGGGA,111,114,3,17,6416,0,0
6872,ACGTCGAATCTAGGGA,111,114,3,12,6417,0,0
6873,ACGTCGAATCTAGGGA,111,114,3,14,6420,0,0
6874,ACGTCGAATCTAGGGA,111,111,0,9,6426,0,0
6875,ACGTCGAATCTAGGGA,111,114,3,17,6430,0,0
6876,ACGTCGAATCTAGGGA,111,114,3,14,6433,0,0
6877,ACGTCGAATCTAGGGA,111,112,1,16,6434,0,0
6878,ACGTCTAATCTAGGGA,111,114,3,16,6437,0,0
6879,ACGTCGAATCTAGGGA,111,114,3,13,6439,0,0
6880,ACGTCGAATCTAGGGA,111,114,3,14,6445,0,0
6881,ACGTCGAATCTAGGGA,111,114,3,15,6448,0,0
6882,ACGTGGAATCTAGGGA,111,114,3,14,6449,0,0
6883,ACGTCGAATCTAGGGA,111,114,3,15,6450,0,0
6884,ACGTCGAATCTAGGGA,111,114,3,16,6451,0,0
6885,ACGTCGAATCTAGGGA,111,114,3,11,6453,0,0
6886,ACGTCGAATCTAGGGA,111,114,3,12,6458,0,0
6887,ACGTCGAATCTAGGGA,112,115,3,13,4140,0,0
6888,ACGTCGAATCTAGGGA,112,119,7,14,4741,0,0
6889,ACGTCGAATCTAGGGA,112,127,15,11,5151,3,0
6890,ACGTCGAATCTAGGGA,112,113,1,13,5335,0,0
6891,ACGTCGAATCTAGGGA,112,114,2,10,5376,0,0
6892,ACGTCGAATCTAGGGA,112,115,3,16,5495,0,0
6893,ACGTCGAATCTAGGGA,112,120,8,15,5498,1,0
6894,ACGTCGAATCTAGGGA,112,114,2,10,5735,0,0
6895,ACGTCGAATCTAGGGA,112,113,1,11,5874,0,0
6896,ACGTCGAATCTAGGGA,112,115,3,14,5878,0,0
6897,ACGTCGAATCTAGGGA,112,114,2,15,5880,0,0
6898,ACGTCGAATCTAGGGA,112,117,5,12,5882,0,0
6899,ACGTCGAATCTAGGGA,112,114,2,9,6042,0,0
6900,ACGTCGAATCTAGGGA,112,114,2,16,6046,0,0
6901,ACGTCGAATCTAGGGA,112,114,2,15,6048,0,0
6902,ACGTCGAATCTAGGGA,112,133,21,11,6050,5,0
6903,ACGTCGAATCAAGGGA,112,115,3,15,6054,0,0
6904,ACGTCGAATCTAGGGA,112,130,18,15,6056,4,0
6905,ACGTCGAATCTAGGGA,112,118,6,9,6112,0,0
6906,ACGTCGAATCTAGGGA,112,113,1,16,6221,0,0
6907,ACGTCGAATCTAGGGA,112,113,1,11,6223,0,0
6908,ACGTCGAATCTAGGGA,112,113,1,15,6228,0,0
6909,ACGTCGAATCTAGGGA,112,115,3,10,6287,0,0
6910,ACGTCGAATCTAGGGA,112,113,1,14,6289,0,0
6911,ACGTCGAATCTAGGGA,112,117,5,14,6291,0,0
6912,ACGTCGAATCTAGGGA,112,131,19,13,6293,4,0
6913,ACGTCGAATCTAGGGA,112,118,6,13,6294,0,0
6914,ACGTCGAATCTAGGGA,112,115,3,12,6295,0,0
6915,ACGTCGAATCTAGGGA,112,112,0,15,6300,0,0
6916,ACGTCGAATCTAGGGC,112,129,17,16,6306,4,0
6917,AGGTCGAATCTAGGGA,112,120,8,15,6308,1,0
6918,ACGTCGAATCTAGGGA,112,112,0,16,6315,0,0
6919,ACGTCGATTCTAGGGA,112,131,19,12,6316,4,0
6920,ACGTCGAATCTAGGGA,112,120,8,12,6320,1,0
6921,ACGTCGAATCTAGGGA,112,136,24,16,6323,6,0
6922,ACGTCGAATCTAGGGA,112,120,8,18,6327,1,0
6923,ACGTCGAATCTAGGGA,112,116,4,13,6471,0,0
6924,ACGTCGAATCTAGGGA,112,115,3,14,6472,0,0
6925,ACGTAGAATCTAGGGA,112,115,3,13,6474,0,0
6926,ACGTCGAATCTAGGGA,112,115,3,12,6478,0,0
6927,ACGTCGAATCTAGGGA,112,115,3,12,6479,0,0
6928,ACGTCGAATCTAGGGA,112,114,2,11,6569,0,0
6929,ACGTCGAATCTAGGGA,112,113,1,19,6570,0,0
6930,ACGTCGAATCTAGGGA,112,112,0,15,6571,0,0
6931,ACGTCGAATCTAGGGA,112,113,1,15,6572,0,0
6932,ACGTCGAATCTAGGGA,112,115,3,16,6573,0,0
6933,ACGTCGAATCTAGGGA,112,115,3,15,6577,0,0
6934,ACGTCGAATCTAGGGA,112,115,3,15,6579,0,0
6935,ACGTCGAATCTAGGGA,112,115,3,14,6583,0,0
6936,ACGTCGAATCTAGGGA,112,114,2,17,6584,0,0
6937,ACGTCGAATCTAGGGA,113,144,31,8,1467,8,0
6938,ACGTCGAATCTAGGGA,113,117,4,14,4109,0,0
6939,ACGTCGAATCTAGGGA,113,120,7,18,4788,0,0
6940,ACGTCGAATCTAGGGA,113,117,4,14,4956,0,0
6941,ACGTCGAATCTAGGGA,113,138,25,15,5124,6,0
6942,ACGTCGAATCTAGGGA,113,115,2,9,5191,0,0
6943,ACGTCGAATCTAGGGA,113,114,1,18,5284,0,0
6944,ACGTCGAATCTAGGGA,113,117,4,14,5288,0,0
6945,ACGTCGAATCTAGGGA,113,127,14,14,5309,3,0
6946,ACGTCGAATCTAGGGA,113,114,1,15,5369,0,0
6947,ACGTCGAATCGAGGGA,113,114,1,15,5450,0,0
6948,ACGTCGAATCTAGGGA,113,118,5,11,5469,0,0
6949,ACGTCGAATCTAGGGA,113,114,1,9,5476,0,0
6950,ACGTCGAATCTAGGGA,113,113,0,12,5485,0,0
6951,ACGGCGAATCTAGGGA,113,115,2,14,5639,0,0
6952,ACGTCGAATCTAGGGA,113,121,8,16,5668,1,0
6953,ACGTCGAATCTAGGGA,113,123,10,14,5673,1,0
6954,ACGTCGAATCTAGGGA,113,127,14,15,5724,3,0
6955,ACGTCGAATCTAGGGA,113,117,4,15,5821,0,0
6956,ACGTCGAATCTAGGGA,113,115,2,17,5835,0,0
6957,ACGTCGAATCTAGGGA,113,145,32,10,5843,9,0
6958,ACGTCGAATCTAGGGA,113,115,2,10,5850,0,0
6959,ACGTCGAATCTAGGGA,113,119,6,14,5997,0,0
6960,ACGTCGAATCTAGGGA,113,113,0,13,5998,0,0
6961,ACGTCGAATCTAGGGA,113,118,5,14,6015,0,0
6962,ACGTCGAATCTAGGGA,113,114,1,11,6022,0,0
6963,ACGTCGAATCTAGGGA,113,115,2,16,6029,0,0
6964,ACGTCGAATCTAGGGA,113,113,0,14,6171,0,0
6965,ACGTCGAACCTAGGGA,113,114,1,13,6177,0,0
6966,ACGTCGAATCTAGGGA,113,115,2,16,6184,0,0
6967,ACGTCGAATCTAGGGA,113,114,1,16,6187,0,0
6968,ACGTCGAATCTAGGGA,113,115,2,14,6201,0,0
6969,ACGTCGAATCTAGGGA,113,116,3,11,6207,0,0
6970,ACGTCGAATCTAGGGA,113,141,28,14,6209,7,0
6971,ACGTCGAATCTAGGGA,113,127,14,13,6212,3,0
6972,ACGTCGAATCTAGGGA,113,128,15,15,6216,3,0
6973,ACGTCGAATCTAGGGA,113,113,0,13,6346,0,0
6974,ACGTCGAATCTAGGGA,113,114,1,12,6349,0,0
6975,ACGTCGAATCTAGGGA,113,118,5,10,6353,0,0
6976,ACGTCGAATCTAGGGA,113,136,23,16,6355,6,0
6977,CCGTCGAATCTAGTGA,113,125,12,12,6360,2,0
6978,ACGTCGAATCTAGGGA,113,116,3,17,6365,0,0
6979,ACGTCGAATCTAGGGA,113,116,3,10,6367,0,0
6980,ACGTCGAATCTAGGGA,113,132,19,14,6526,4,0
6981,ACGTCGAATCTAGGGA,113,113,0,12,6530,0,0
6982,ACGTCGAATCTAGGGA,113,122,9,10,6532,1,0
6983,ACGTCGAATCTAGGGA,113,127,14,16,6534,3,0
6984,ACGTCGAATCTAGGGA,113,124,11,16,6538,2,0
6985,ACGTCGAATCTAGGGA,113,126,13,10,6541,2,0
6986,ACGTCGAATCTAGGGA,113,122,9,12,6544,1,0
6987,ACGTCGAATCTAGGGA,113,116,3,16,6548,0,0
6988,ACGTCGAATCTAGGGA,113,125,12,10,6555,2,0
6989,ACGTCGAATCTAGGGA,113,116,3,17,6556,0,0
6990,ACGTCGAATCTAGGGA,113,116,3,16,6557,0,0
6991,ACGTCGAATCTAGGGA,113,116,3,12,6558,0,0
6992,ACGTCGAAGCTAGGGA,113,116,3,16,6559,0,0
6993,ACGTCGAATCTAGGGA,113,115,2,16,6561,0,0
6994,ACGTCGAATCTAGGGA,113,113,0,12,6564,0,0
6995,ACGTCGAATCTAGGGA,113,116,3,16,6566,0,0
6996,ACGTCGAATCTAGGGA,114,121,7,8,294,0,0
6997,ACGTCGAATCTAGGGA,114,117,3,13,4046,0,0
6998,ACGTCGAATCTAGGGA,114,125,11,13,4972,2,0
6999,ACGTCGAATCTAGGGA,114,114,0,14,5176,0,0
7000,ACGTCGAATCTAGGGA,114,119,5,10,5180,0,0
7001,ACGTCGAATCTAGGGA,114,131,17,11,5182,4,0
7002,ACGTCGAATCTAGGGA,114,114,0,16,5365,0,0
7003,ACGTCGAATCTAGGGA,114,122,8,15,5515,1,0
7004,ACGTCGAATCTAGGGA,114,116,2,11,5516,0,0
7005,ACGTCGAATCTAGGGA,114,117,3,16,5536,0,0
7006,ACGTCGAATCTAGGGA,114,125,11,19,5697,2,0
7007,ACGTCGAATCTAGGGA,114,114,0,16,5701,0,0
7008,ACGTCGAATCTAGGGA,114,125,11,15,5706,2,0
7009,ACGTCGAATCTAGGGA,114,116,2,16,5899,0,0
7010,ACGTCGAATCTAGGGA,114,115,1,12,5902,0,0
7011,ACGTCGAATCTAGGGA,114,143,29,15,5911,8,0
7012,ACGTCGAATCTAGGGA,114,114,0,16,5916,0,0
7013,ACGTCGAATCTAGGGA,114,122,8,13,5918,1,0
7014,ACGTCGAATCTAGGGA,114,127,13,15,6060,2,0
7015,ACGTCGAATCTAGGGA,114,119,5,16,6066,0,0
7016,ACGTCGAATCTAGGGA,114,118,4,16,6069,0,0
7017,ACGTCGAATCTAGGGA,114,126,12,16,6078,2,0
7018,ACGTCGAATCTAGGGA,114,116,2,16,6091,0,0
7019,ACGTCGAATCTAGGGA,114,116,2,16,6100,0,0
7020,ACGTCGAATCTAGGGA,114,119,5,9,6101,0,0
7021,ACGTCGAATCTAGGGA,114,117,3,14,6103,0,0
7022,ACGTCGAATCTAGGGA,114,167,53,16,6229,16,0
7023,ACGTCGAATCTAGGGA,114,126,12,15,6235,2,0
7024,ACGTCGAATCTAGGGA,114,116,2,13,6236,0,0
7025,ACGTCGAATCTAGGGA,114,118,4,15,6238,0,0
7026,ACGTCGAATCTAGGGA,114,124,10,15,6239,1,0
7027,ACGTCGAATCTAGGGA,114,127,13,16,6240,2,0
7028,ACGTCGAATCTAGGGA,114,126,12,14,6241,2,0
7029,CCGTCGAATCTAGGGA,114,114,0,17,6245,0,0
7030,ACGTCGAATCTAGGGA,114,116,2,17,6246,0,0
7031,ACGTCGAATCTAGGGA,114,142,28,10,6250,7,0
7032,ACGTCGAATCTAGGGA,114,121,7,13,6251,0,0
7033,ACGTCGAATCTAGGGA,114,121,7,13,6254,0,0
7034,ACGTCTAATCTAGGGA,114,153,39,16,6258,11,0
7035,ACGTCGAATCTAGGGA,114,116,2,9,6396,0,0
7036,ACGTCGAATCTAGGGA,114,114,0,11,6399,0,0
7037,ACGTCGAATCTAGGGA,114,117,3,19,6400,0,0
7038,ACGTCGAATCTAGGGA,114,117,3,15,6401,0,0
7039,ACGTCGAATCTAGGGA,114,117,3,16,6403,0,0
7040,ACGTCGAATCTAGGGA,114,114,0,15,6409,0,0
7041,ACGTCGAATCTAGGGA,114,117,3,14,6413,0,0
7042,ACGTCGAATCTAGGGA,114,117,3,12,6417,0,0
7043,ACGTCGAATCTAGGGA,114,117,3,14,6420,0,0
7044,ACGTCGAATCTAGGGA,114,117,3,17,6430,0,0
7045,ACGTCGAATCTAGGGA,114,117,3,16,6434,0,0
7046,ACGTCTAATCTAGGGA,114,117,3,16,6437,0,0
7047,ACGTCGAATCTAGGGA,114,117,3,13,6439,0,0
7048,ACGTCGAATCTAGGGA,114,117,3,14,6445,0,0
7049,ACGTGGAATCTAGGGA,114,114,0,14,6449,0,0
7050,ACGTCGAATCTAGGGA,114,114,0,16,6451,0,0
7051,ACGTCGAATCTAGGGA,114,115,1,11,6453,0,0
7052,ACGTCGAATCTAGGGA,114,114,0,12,6458,0,0
7053,ACGTCGAATCTAGGGA,114,117,3,13,6587,0,0
7054,ACGTCGAATCTAGGGA,114,117,3,10,6588,0,0
7055,ACGTCGAATCTAGGGA,114,117,3,13,6590,0,0
7056,ACGTCGAATCTAGGGA,114,114,0,16,6592,0,0
7057,ACGTCGAATCTAGGGA,114,115,1,13,6699,0,0
7058,CCGTCGAATCTAGGGA,115,130,15,13,4140,3,0
7059,ACGTCGAATCTAGGGA,115,115,0,11,5151,0,0
7060,ACGTCGAATCTAGGGA,115,115,0,13,5335,0,0
7061,ACGTCGAATCTAGGGA,115,119,4,10,5376,0,0
7062,ACGTCGAATCTAGGGA,115,139,24,15,5498,6,0
7063,ACGTCGAATCTAGGGA,115,116,1,10,5735,0,0
7064,ACGTCGAATCTAGGGA,115,116,1,11,5874,0,0
7065,ACGTCGAATCTAGGGA,115,117,2,14,5878,0,0
7066,ACGTCGAATCTAGGGA,115,122,7,12,5882,0,0
7067,ACGTCGAATCTAGGGA,115,124,9,9,6042,1,0
7068,ACGTCGAATCTAGGGA,115,120,5,16,6046,0,0
7069,ACGTCGAATCTAGGGA,115,115,0,15,6048,0,0
7070,ACGTCGAATCAAGGGA,115,115,0,15,6054,0,0
7071,ACGTCGAATCTAGGGA,115,118,3,15,6056,0,0
7072,ACGTCGAATCTAGGGA,115,118,3,9,6112,0,0
7073,ACGTCGAATCTAGGGA,115,149,34,11,6223,9,0
7074,ACGTCGAATCTAGGGA,115,117,2,15,6228,0,0
7075,ACGTCGAATCTAGGGA,115,127,12,10,6287,2,0
7076,ACGTCGAATCTAGGGA,115,119,4,14,6289,0,0
7077,ACGTCGAATCTAGGGA,115,130,15,13,6293,3,0
7078,ACGTCGAATCTAGGGA,115,122,7,13,6294,0,0
7079,ACGTCGAATCTAGGGA,115,116,1,12,6295,0,0
7080,AGGTCGAATCTAGGGA,115,117,2,15,6308,0,0
7081,ACGTCGAATCTAGGGA,115,122,7,16,6315,0,0
7082,ACGTCGATTCTAGGGA,115,116,1,12,6316,0,0
7083,ACGTCGTATCTAGGGA,115,119,4,16,6323,0,0
7084,ACGTCGAATCTAGGGA,115,136,21,18,6327,5,0
7085,ACGTCGAATCTAGGGA,115,115,0,13,6471,0,0
7086,ACGTAGAATCTAGGGA,115,136,21,13,6474,5,0
7087,ACGTCGAATCTAGGGA,115,121,6,12,6479,0,0
7088,ACGTCGAATCTAGGGA,115,116,1,19,6570,0,0
7089,ACGTCGAATCTAGGGA,115,115,0,15,6571,0,0
7090,ACGTCGAATCTAGGGA,115,121,6,15,6572,0,0
7091,ACGTCGAATCTAGGGA,115,117,2,16,6573,0,0
7092,ACGTCGAATCTAGGGA,115,127,12,15,6577,2,0
7093,ACGTCGAATCTAGGGA,115,139,24,14,6583,6,0
7094,ACGTCGAATCTAGGGA,115,118,3,13,6640,0,0
7095,ACGTCGAATCTAGGGA,115,115,0,14,6644,0,0
7096,ACGTCGAATCTAGGGA,115,128,13,11,6646,2,0
7097,ACGTCGAATCTAGGGA,115,116,1,17,6648,0,0
7098,ACGTCGAATCTAGGGA,115,117,2,17,6652,0,0
7099,ACGTTGAATCTAGGGA,115,115,0,18,6656,0,0
7100,ACGTCGAATCTAGGGA,115,125,10,16,6658,1,0
7101,ACATCGAATCTAGGGA,115,116,1,17,6659,0,0
7102,ACGTCGAATCGAGGGA,115,125,10,17,6662,1,0
7103,ACGTCGAATCTAGGGA,115,121,6,16,6663,0,0
7104,ACGTCGAATCTAGGGA,115,118,3,18,6664,0,0
7105,ACGTCGAATCTAGGGA,115,119,4,14,6666,0,0
7106,ACGTCGAATCTAGGGA,115,120,5,17,6670,0,0
7107,ACGTCGAATCTAGGGA,115,120,5,15,6673,0,0
7108,ACGTCGAATCTAGGGA,115,124,9,14,6677,1,0
7109,ACGTCGAATCTAGGGA,115,120,5,10,6681,0,0
7110,ACGTCGAATCTAGGGA,115,116,1,14,6682,0,0
7111,ACGTCGAATCTAGGGA,115,118,3,17,6684,0,0
7112,ACGTCGAATCTAGGGA,115,117,2,14,6687,0,0
7113,ACGTCGAATCTAGGGA,115,125,10,14,6697,1,0
7114,ACGTCGAATCTAGGGA,116,137,21,8,1467,6,0
7115,ACGTCGAATCTAGGGA,116,131,15,14,4109,3,0
7116,ACGTCGAATCTAGGGA,116,131,15,15,5124,3,0
7117,ACGTCGAATCTAGGGA,116,125,9,9,5191,1,0
7118,ACGTCGAATCTAGGGA,116,141,25,18,5284,6,0
7119,ACGTCGAATCTAGGGA,116,119,3,14,5288,0,0
7120,ACGTCGAATCTAGGGA,116,117,1,14,5309,0,0
7121,ACGTCGAATCGAGGGA,116,117,1,15,5450,0,0
7122,ACGTCGAATCTAGGGA,116,119,3,11,5469,0,0
7123,ACGTCGAATATAGGGA,116,124,8,12,5485,1,0
7124,ACGGCGAATTTAGGGA,116,129,13,14,5639,2,0
7125,ACGTCGAATCTAGGGA,116,126,10,16,5668,1,0
7126,ACGTCGAATCTAGGGA,116,117,1,15,5724,0,0
7127,ACGTCGAATCTAGGGA,116,122,6,10,5850,0,0
7128,ACGTCGAATCTAGGGA,116,132,16,13,5998,3,0
7129,ACGTCGAATCTAGGGA,116,122,6,16,6029,0,0
7130,ACGTCGAATCTAGGGA,116,121,5,16,6184,0,0
7131,ACGTCGAATCTAGGGA,116,128,12,14,6201,2,0
7132,ACGTCGAATCTAGGGA,116,125,9,14,6209,1,0
7133,ACGTCGAATCTAGGGA,116,121,5,15,6216,0,0
7134,ACGTCGAATCTAGGGA,116,116,0,13,6346,0,0
7135,ACGTCGAATCTAGGGA,116,116,0,12,6349,0,0
7136,ACGTCGAATCTAGGGA,116,119,3,10,6353,0,0
7137,ACGTCGAATCTAGGGA,116,119,3,16,6355,0,0
7138,ACGTCGAATCTAGGGA,116,119,3,17,6365,0,0
7139,ACGTCGAATCTACGGA,116,116,0,10,6367,0,0
7140,ACGTCGAATCTAGGGA,116,119,3,14,6526,0,0
7141,ACGTCGAATCTAGGGA,116,119,3,10,6532,0,0
7142,ACGTCGAATCTAGGGA,116,119,3,16,6534,0,0
7143,ACGTCGAATCTAGGGA,116,116,0,10,6541,0,0
7144,ACGTCGAATCTAGGGA,116,116,0,12,6544,0,0
7145,ACGTCGAATCTAGGGA,116,119,3,16,6548,0,0
7146,ACGTCGAATCTAGGGA,116,119,3,10,6555,0,0
7147,ACGTCGAATCTAGGGA,116,118,2,16,6557,0,0
7148,ACGTCGAATCTAGGGA,116,118,2,12,6558,0,0
7149,ACGTCGAATCTAGGGA,116,117,1,12,6564,0,0
7150,ACGTCGAATCTAGGGA,116,117,1,15,6701,0,0
7151,ACGTAGAATCTAGGGA,116,119,3,12,6703,0,0
7152,ACGTCGAATCTAGGGA,116,116,0,10,6704,0,0
7153,ACGTCGAATCTAGGGA,116,118,2,16,6705,0,0
7154,ACGTCGAATCTAGGGA,116,119,3,14,6706,0,0
7155,ACGTCGAATCTAGGGA,116,116,0,11,6707,0,0
7156,ACGTCGAATCTAGGGA,116,116,0,17,6708,0,0
7157,ACGTCGAATCTAGGGA,116,119,3,12,6711,0,0
7158,ACGTCGAATCTAGGGA,116,119,3,12,6714,0,0
7159,ACGTCGAATCTAGGGA,116,119,3,13,6717,0,0
7160,ACGTCGAATCTAGGGA,116,119,3,10,6718,0,0
7161,ACGTCGAATCTAGGGA,117,117,0,10,5180,0,0
7162,ACGTCGAATCTAGGGA,117,117,0,11,5182,0,0
7163,ACGTCGAATCTAGGGA,117,117,0,16,5365,0,0
7164,ACGTCGAATCTAGGGA,117,137,20,11,5516,5,0
7165,ACGTCGAATCTAGGGA,117,122,5,16,5536,0,0
7166,ACGTCGAATCTAGGGA,117,124,7,16,5701,0,0
7167,ACGTCGAATCTAGGGA,117,124,7,15,5706,0,0
7168,ACGTCGAATCTAGGGA,117,118,1,12,5902,0,0
7169,ACGTCGAATCTAGGGA,117,117,0,15,5911,0,0
7170,ACGTCGAATCTAGGGA,117,120,3,13,5918,0,0
7171,ACGTCGAATCTAGGGA,117,121,4,15,6060,0,0
7172,ACGTCGAATCTAGGGA,117,122,5,16,6066,0,0
7173,ACGTCGAATCTAGGGA,117,128,11,16,6091,2,0
7174,ACGTCGTATCTAGGGA,117,142,25,16,6100,6,0
7175,ACGTCGAATCTAGGGA,117,121,4,14,6103,0,0
7176,ACGTCGAATCTAGGGA,117,122,5,16,6229,0,0
7177,ACGTCGAATCTAGGGA,117,132,15,15,6235,3,0
7178,ACGTCGAATCTAGGGA,117,121,4,13,6236,0,0
7179,CCGTCGAATCTAGGGA,117,123,6,15,6238,0,0
7180,ACGTCGAATCTAGGGA,117,140,23,15,6239,6,0
7181,ACGTCGAATCTAGGGA,117,118,1,16,6240,0,0
7182,ACGTCGCATCTAGGGA,117,153,36,14,6241,10,0
7183,ACGTCGAATCTAGGGA,117,117,0,17,6245,0,0
7184,ACGTCCAATCTAGGGA,117,118,1,13,6251,0,0
7185,ACGTCGAATCTAGGGA,117,118,1,13,6254,0,0
7186,ACGTCTAATCTAGGGA,117,121,4,16,6258,0,0
7187,ACGTCGAATCTAGGGA,117,127,10,9,6396,1,0
7188,ACGTCGAATCTAGGGA,117,137,20,19,6400,5,0
7189,ACGTCGAATCTAGGGA,117,118,1,15,6401,0,0
7190,ACGTCGAATCTAGGGA,117,120,3,15,6409,0,0
7191,ACGTCGAATCTAGGGA,117,140,23,14,6420,6,0
7192,ACGTCGAATCTAGGGA,117,119,2,16,6434,0,0
7193,ACGTCTAATCTAGGGA,117,125,8,16,6437,1,0
7194,ACGTCGAATCTAGGGA,117,117,0,13,6439,0,0
7195,ACGTCGAATCTAGGGA,117,121,4,14,6445,0,0
7196,ACGTGGAATCTAGGGA,117,133,16,14,6449,3,0
7197,ACGTCGAATCTAGGGA,117,126,9,16,6451,1,0
7198,ACGTCGAATCTAGGGA,117,136,19,12,6458,4,0
7199,ACGTCGAATCTAGGGA,117,123,6,13,6587,0,0
7200,ACGTCGAATCTAGGGA,117,130,13,13,6590,2,0
7201,ACGTCGAATCTAGGGA,117,122,5,16,6592,0,0
7202,ACGTCGAATCTAGGGA,117,118,1,13,6699,0,0
7203,ACGTCGAATCTACGGA,117,124,7,12,6721,0,0
7204,ACGTCGAATCTAGGGA,117,123,6,9,6747,0,0
7205,ACGTCGAATCTAGGGA,117,150,33,15,6748,9,0
7206,ACGTCGAATCTAGGGA,117,121,4,19,6749,0,0
7207,ACGTCGAATCTAGGGA,117,124,7,16,6752,0,0
7208,ACGTCGAATCTAGGGA,117,128,11,10,6754,2,0
7209,ACGTCGAATCTAGGGA,117,141,24,15,6756,6,0
7210,ACGTCGAATCTAGGAA,117,138,21,12,6762,5,0
7211,ACGTCGAATCTAGGGA,117,133,16,10,6763,3,0
7212,ACGTCGAATCTAGGGA,117,130,13,16,6767,2,0
7213,ACGTCGAATCTAGGGA,117,117,0,17,6769,0,0
7214,ACGTCGAATCTAGGGA,117,120,3,15,6770,0,0
7215,ACGTCGAATCTAGGGA,117,124,7,16,6771,0,0
7216,ACGTCGAATCTAGGGA,117,119,2,14,6773,0,0
7217,ACGTCGAATCTAGGGA,117,140,23,16,6774,6,0
7218,ACGTCGAATCTAGGGA,117,126,9,9,6775,1,0
7219,ACGTCGAATCTAGGGA,118,145,27,11,5151,7,0
7220,ACGTCGAATCTAGGGA,118,118,0,13,5335,0,0
7221,ACGTCGAATCTAGAGA,118,121,3,10,5376,0,0
7222,ACGTCGAATCTAGGGA,118,122,4,15,5498,0,0
7223,ACGTCGAATCTAGGGA,118,135,17,11,5874,4,0
7224,ACGTCGAATCTAGGGA,118,132,14,14,5878,3,0
7225,ACGTCGAATCTAGGGA,118,129,11,12,5882,2,0
7226,ACGTCGAATCTAGGGA,118,121,3,9,6042,0,0
7227,ACGTCGAATCTAGGGA,118,139,21,16,6046,5,0
7228,ACGTCGAATCTAGGGA,118,122,4,15,6048,0,0
7229,ACGTCGAATCTAGGGA,118,120,2,11,6223,0,0
7230,ACGTCGAATCTAGGGA,118,121,3,15,6228,0,0
7231,ACGTCGAATCTAGGGA,118,118,0,10,6287,0,0
7232,AGGTCGAATCTAGGGA,118,121,3,15,6308,0,0
7233,ACGTCGAATCTAGGGA,118,120,2,16,6315,0,0
7234,ACGTCGATTCTAGGGA,118,121,3,12,6316,0,0
7235,ACGTCGAATCTAGGGA,118,121,3,16,6323,0,0
7236,ACGTCGAATCTAGGGA,118,121,3,18,6327,0,0
7237,ACGTAGAATCTAGGGA,118,121,3,13,6474,0,0
7238,ACGTCGAATCTAGGGA,118,118,0,12,6479,0,0
7239,ACGTCGAATCTAGGGA,118,121,3,19,6570,0,0
7240,ACGTCGAATCTAGGGA,118,121,3,15,6571,0,0
7241,AAGTCGAATCTAGGGA,118,121,3,16,6573,0,0
7242,ACGTCGAATCTAGGGA,118,121,3,15,6577,0,0
7243,ACGTCGAATCTAGGGA,118,121,3,14,6583,0,0
7244,ACGTCGAATCTAGGGA,118,121,3,13,6640,0,0
7245,ACGTCGAATCTAGGGA,118,118,0,14,6644,0,0
7246,ACGTCGAATCTAGTGA,118,121,3,11,6646,0,0
7247,ACGTCGAATCTAGGGA,118,121,3,17,6648,0,0
7248,ACGTCGAATCTAGGGA,118,121,3,17,6652,0,0
7249,ACGTCGAATCTAGGGA,118,121,3,16,6658,0,0
7250,ACGTCGAATCTAGGGA,118,118,0,17,6659,0,0
7251,ACGTCGAATCGAGGGA,118,121,3,17,6662,0,0
7252,ACGTCGAATCTAGGGA,118,119,1,16,6663,0,0
7253,ACGTCGAATCTAGGGA,118,119,1,18,6664,0,0
7254,ACGTCGAATCTAGGGA,118,121,3,14,6666,0,0
7255,ACGTCGAATCTAGGGA,118,119,1,17,6670,0,0
7256,ACGTCGAATCTAGGGA,118,118,0,15,6673,0,0
7257,ACGTCGAATCTAGGGA,118,118,0,14,6677,0,0
7258,ACGTCGAATCTAGGGA,118,121,3,14,6682,0,0
7259,ACGTCGAATCTAGGGA,118,121,3,14,6687,0,0
7260,ACGTCGAATCTAGGGA,118,118,0,14,6697,0,0
7261,ACGTCGAATCTAGGGA,118,121,3,11,6778,0,0
7262,ACGTCGAATCTAGGGA,118,121,3,14,6816,0,0
7263,ACGTCGAATCTAGGGA,118,121,3,16,6821,0,0
7264,ACGTCGAATCTAGGGA,118,121,3,18,6828,0,0
7265,ACGTCGAATCTAGGGA,118,118,0,13,6831,0,0
7266,ACGTCGAATCTAGGGA,118,120,2,16,6834,0,0
7267,ACGTCGAATCTAGGGA,118,121,3,14,6838,0,0
7268,ACGTCGAATCTAGGGA,118,121,3,17,6839,0,0
7269,ACGTCGAATCGAGGGA,118,121,3,17,6842,0,0
7270,ACGTCGAATCTAGGGA,118,121,3,17,6844,0,0
7271,ACGTCGAAACTAGGGA,118,120,2,14,6847,0,0
7272,ACGTCGAATCTAGGGA,118,121,3,15,6848,0,0
7273,ACGTCGAATCTAGGGA,118,120,2,16,6850,0,0
7274,ACGTCGAATCTAGGGA,118,121,3,14,6851,0,0
7275,ACGTCGAATCTAGGGA,118,120,2,17,6854,0,0
7276,ACGTCGAATCTAGGGA,118,118,0,15,6855,0,0
7277,ACGTCTAATCTAGGGA,118,120,2,17,6861,0,0
7278,ACGTCGAATCTAGGGA,118,121,3,12,6863,0,0
7279,ACGTCGAATCTATGGA,118,121,3,16,6867,0,0
7280,ACGTCGAATCTAGGGA,119,124,5,8,1467,0,0
7281,ACGTCGCATCTAGGGA,119,120,1,14,4109,0,0
7282,ACGTCGAATCTAGGGA,119,128,9,15,5124,1,0
7283,ACGTCGAATCTAGGGA,119,128,9,18,5284,1,0
7284,ACGTCGAATCTAGGGA,119,121,2,14,5288,0,0
7285,ACGTCGAATCTAGGGA,119,121,2,14,5309,0,0
7286,ACGTCGAATCGAGGGA,119,140,21,15,5450,5,0
7287,ACGTCGAATCTAGGGA,119,167,48,11,5469,14,0
7288,ACGTCGACTCTAGGGA,119,131,12,12,5485,2,0
7289,ACGTCGAATCTAGGGA,119,129,10,16,5668,1,0
7290,ACGTCGAATCTAGGGA,119,122,3,15,5724,0,0
7291,ACGTCGAATCTAGGGA,119,126,7,13,5998,0,0
7292,ACGTCGAATCTAGGGA,119,122,3,16,6029,0,0
7293,ACGTCGAATCTAGGGA,119,128,9,16,6184,1,0
7294,ACGTCGAATCTAGGGA,119,127,8,14,6201,1,0
7295,ACGTCGAATCTAGGGA,119,126,7,14,6209,0,0
7296,ACGTCGAATCTAGGGA,119,120,1,15,6216,0,0
7297,ACGTCGAATCTAGGGA,119,129,10,13,6346,1,0
7298,ACGTCGAATCTAGGGA,119,125,6,12,6349,0,0
7299,ACGTCGAATCTAGGGA,119,142,23,10,6353,6,0
7300,ACGTCGAATCTAGGGA,119,119,0,16,6355,0,0
7301,AAGTCGAATCTAGGGA,119,119,0,17,6365,0,0
7302,ACGTCGAATCTAGGGA,119,120,1,10,6367,0,0
7303,ACGTCGAATCTAGGGA,119,119,0,14,6526,0,0
7304,ACGTCGAATCTAGGGA,119,152,33,10,6532,9,0
7305,ACGTCGAATCTAGGGA,119,136,17,16,6534,4,0
7306,ACGTCGAATCTAGGGA,119,136,17,12,6544,4,0
7307,ACGTCGAATCTAGGGA,119,132,13,10,6555,2,0
7308,ACGTCGAATCTAGGGA,119,195,76,16,6557,23,0
7309,ACGTTGAATCTAGGGA,119,122,3,12,6558,0,0
7310,ACGTAGAATCTAGGGA,119,138,19,12,6703,4,0
7311,ACGTCGAATCTAGGGA,119,122,3,10,6704,0,0
7312,ACGTCGAATCTAGGGA,119,128,9,14,6706,1,0
7313,ACGTCGAATCTAGGGA,119,130,11,17,6708,2,0
7314,ACGTCGAATCTAGGGA,119,125,6,13,6717,0,0
7315,ACGTCGAATCTAGGGA,119,121,2,10,6718,0,0
7316,ACGTCGAATCTAGGGA,119,125,6,12,6889,0,0
7317,ACGTCGAATCTAGGGA,119,138,19,16,6893,4,0
7318,ACGTCGAATCTAGGGA,119,123,4,12,6902,0,0
7319,ACGTCGAATCTAGGGA,119,123,4,16,6904,0,0
7320,ACGTCGAATCTAGGGA,119,121,2,14,6912,0,0
7321,ACGTCGAATCTAGGGC,119,124,5,17,6916,0,0
7322,AGGTCGAATCTAGGGA,119,119,0,16,6917,0,0
7323,ACGTCGATTCTAGGGA,119,128,9,13,6919,1,0
7324,ACGTCGAATCTAGGGA,119,128,9,13,6920,1,0
7325,ACGTCGAATCTAGGGA,119,129,10,17,6921,1,0
7326,ACGTCGAATCTAGGGA,119,131,12,19,6922,2,0
7327,ACGTCGAATCTAGGGA,120,126,6,11,5182,1,0
7328,ACGTCGAATCTAGGGA,120,134,14,16,5365,3,0
7329,ACGTCGAATCTAGGGA,120,142,22,11,5516,6,0
7330,ACGTCGAATCTAGGGA,120,133,13,15,5706,3,0
7331,ACGTCGAATCTAGGGA,120,124,4,12,5902,0,0
7332,ACGTCGAATCTAGGGA,120,148,28,15,6060,8,0
7333,ACGTCGAATCTAGGGA,120,145,25,16,6066,7,0
7334,ACGTCGAATCTAGGGA,120,126,6,14,6103,1,0
7335,ACGTCGAATCTAGGGA,120,121,1,16,6229,0,0
7336,ACGTCGAATCTAGGGA,120,142,22,15,6235,6,0
7337,ACGTCGAATCTAGGGA,120,130,10,15,6238,2,0
7338,ACGTCGAATCTAGGGA,120,122,2,15,6239,0,0
7339,ACGTCGAATCTAGGGA,120,129,9,16,6240,2,0
7340,ACGTCGAATCTAGGGA,120,126,6,14,6241,1,0
7341,ACGTCGAATCTAGGGA,120,121,1,17,6245,0,0
7342,ACGTCGAATCTAGGGA,120,127,7,13,6251,1,0
7343,ACGTCGAATCTAGGGA,120,121,1,13,6254,0,0
7344,ACGTCTAATCTAGGGA,120,123,3,16,6258,0,0
7345,ACGTCGAATCTAGGGA,120,124,4,9,6396,0,0
7346,ACGTCGAATCTAGGGA,120,124,4,15,6409,0,0
7347,ACGTCGAATCTAGGGA,120,121,1,14,6420,0,0
7348,ACGTCTAATCTAGGGA,120,121,1,16,6437,0,0
7349,ACGTCGAATCTAGGGA,120,121,1,16,6451,0,0
7350,ACGTCGAATCTAGGGA,120,121,1,13,6587,0,0
7351,ACGTCGAATCTAGGGA,120,133,13,16,6592,3,0
7352,ACGTCGAATCTACGGA,120,126,6,12,6721,1,0
7353,ACGTCGAATCTAGGGA,120,122,2,9,6747,0,0
7354,ACGTCGAATCTAGGGA,120,121,1,15,6748,0,0
7355,ACGTCGAATCTAGGGA,120,128,8,19,6749,1,0
7356,ACGTCGAATCTAGGGA,120,121,1,16,6752,0,0
7357,ACGTCGAATCTAGGGA,120,127,7,15,6756,1,0
7358,ACGTCGAATCTAGGGA,120,140,20,10,6763,5,0
7359,ACGTCGAATCTAGGGA,120,130,10,17,6769,2,0
7360,ACGTCGAATCTAGGGA,120,123,3,15,6770,0,0
7361,ACGTCGAATCTAGGGA,120,121,1,16,6771,0,0
7362,ACGTCGAATCTAGGGA,120,131,11,14,6773,2,0
7363,ACGTCGAATCTAGGGA,120,136,16,16,6774,4,0
7364,ACGTCGAATCTAGGGA,120,120,0,9,6937,0,0
7365,ACGTCGAATCTAGGGA,120,141,21,16,6941,5,0
7366,ACGTCGAATCTAGGGA,120,126,6,15,6945,0,0
7367,ACGTCGAATCTAGGGA,120,127,7,17,6952,0,0
7368,ACGTCGAATCTAGGGA,120,135,15,15,6953,3,0
7369,ACGTCGAATCTAGGGA,120,149,29,16,6954,8,0
7370,ACGTCGAATCTAGGGA,120,123,3,11,6957,0,0
7371,ACGTCGAATCTAGGGA,120,121,1,15,6970,0,0
7372,ACGTCGAATCTAGGGA,120,121,1,14,6971,0,0
7373,ACGTCGAATCTAGGGA,120,133,13,16,6972,2,0
7374,ACGTCGAATCTAGGGA,120,124,4,17,6976,0,0
7375,CCGTCGAATCTAGTGA,120,121,1,13,6977,0,0
7376,ACGTCGAATCTAGGGA,120,122,2,15,6980,0,0
7377,ACGTCGAATCTAGGGA,120,126,6,11,6982,0,0
7378,ACGTCGAATCTAGGGA,120,128,8,17,6983,0,0
7379,ACGTCGAATCTAGGGA,120,120,0,17,6984,0,0
7380,ACGTCGAATCTAGGGA,120,123,3,11,6985,0,0
7381,ACGTCGAATCTAGGGA,120,123,3,13,6986,0,0
7382,ACGTCGAATCTAGGGA,121,121,0,10,5376,0,0
7383,ACGTCGAATCTAGGGA,121,123,2,15,5498,0,0
7384,CCGTCGAATCTAGGGA,121,122,1,14,5878,0,0
7385,ACGTCGAATCTAGGGA,121,128,7,9,6042,0,0
7386,ACGTCGAATCTAGGGA,121,133,12,16,6046,2,0
7387,ACGTCGAATCTAGGGA,121,125,4,15,6048,0,0
7388,ACGTCGAATCTAGGGA,121,131,10,11,6223,1,0
7389,ACGTCGAATCTAGGGA,121,122,1,15,6228,0,0
7390,ACGTCGAATCTAGGGA,121,123,2,10,6287,0,0
7391,AGGTCGAATCTAGGGT,121,124,3,15,6308,0,0
7392,ACGTCGATTCTAGGGA,121,122,1,12,6316,0,0
7393,ACGTCGAATCTAGGGA,121,121,0,16,6323,0,0
7394,ACGTCGAATCTAGGGA,121,126,5,18,6327,0,0
7395,ACGTAGAATCTAGGGA,121,125,4,13,6474,0,0
7396,ACGTCGAATCTAGGGA,121,124,3,12,6479,0,0
7397,ACGTCGAATCTAGGGA,121,128,7,19,6570,0,0
7398,ACGTCGAATCTAGGGA,121,124,3,15,6571,0,0
7399,ACGTCGAATCTAGGGA,121,124,3,16,6573,0,0
7400,ACGTCGAATCTAGGGA,121,122,1,15,6577,0,0
7401,ACGTAGAATCTAGGGA,121,124,3,13,6640,0,0
7402,ACGTCGAATCTAGGGA,121,124,3,17,6648,0,0
7403,ACGTCGAATCTAGGGA,121,124,3,17,6652,0,0
7404,ACGTCGAATCTAGGGA,121,124,3,16,6658,0,0
7405,ACGTCGAATCTTGGGA,121,124,3,17,6659,0,0
7406,ACGTCGAATCGAGGGA,121,124,3,17,6662,0,0
7407,ACGTCGAATCTAGGGA,121,124,3,16,6663,0,0
7408,ACGTCGAATCTAGGGA,121,122,1,17,6670,0,0
7409,ACGTCGAATCTAGGGA,121,122,1,15,6673,0,0
7410,ACGTCGAATCTAGGGA,121,124,3,14,6677,0,0
7411,ACGTCGAATCTAGGGA,121,121,0,14,6687,0,0
7412,ACGTCGAATCTAGGGA,121,124,3,14,6697,0,0
7413,ACGTCGAATCTAGGGA,121,121,0,11,6778,0,0
7414,ACGTCGAATCTAGGGA,121,124,3,14,6816,0,0
7415,ACGTCGAATCTAGGGA,121,124,3,16,6821,0,0
7416,ACGTCGAATCTAGGGA,121,122,1,18,6828,0,0
7417,ACGTCGAATCTAGGGA,121,124,3,13,6831,0,0
7418,ACGTCGAATCTAGGGA,121,124,3,14,6838,0,0
7419,ACGTTGAATCGAGGGA,121,124,3,17,6842,0,0
7420,ACGTCGAATCTAGGGA,121,124,3,17,6844,0,0
7421,ACGTCGAATCTAGGGA,121,122,1,14,6847,0,0
7422,ACGTCGAATCTAGGGA,121,124,3,16,6850,0,0
7423,ACGTCGAATCTAGGGA,121,121,0,14,6851,0,0
7424,ACGTCGAATCTAGGGA,121,124,3,17,6854,0,0
7425,ACGTCGAATCTAGGGA,121,124,3,15,6855,0,0
7426,ACGTCTAATCTAGGGA,121,124,3,17,6861,0,0
7427,ACGTCGAATCTATGGA,121,124,3,16,6867,0,0
7428,ACGTCGAATCTAGGGA,121,124,3,11,6988,0,0
7429,ACGTCGAATCTAGGGA,121,124,3,14,6998,0,0
7430,ACGTCGAATCTAGGGA,121,124,3,12,7001,0,0
7431,ACGTCGAATCTAGGGA,121,124,3,16,7003,0,0
7432,ACGTCGAATCTAGGGA,121,124,3,20,7006,0,0
7433,ACGTCGAATCTAGGGA,121,124,3,16,7008,0,0
7434,ACGTCGAATCTAGGGA,121,124,3,16,7011,0,0
7435,ACGTCGAATCTAGGGA,121,124,3,14,7013,0,0
7436,ACGTCGAATCTAGGGA,121,124,3,16,7014,0,0
7437,ACGTCGAATCTAGGGA,121,124,3,17,7017,0,0
7438,ACGTCGAATCTAGGGA,121,123,2,17,7022,0,0
7439,ACGTAGAATCTAGGGA,121,122,1,16,7023,0,0
7440,ACGTCGAATCTAGGGA,121,124,3,16,7026,0,0
7441,ACGTCGAATCTAGGGA,121,124,3,17,7027,0,0
7442,ACGTCGAATCTAGGGA,121,124,3,15,7028,0,0
7443,ACGTCGAATCTAGGGA,121,124,3,11,7031,0,0
7444,ACGTCGAATCTAGGGA,121,124,3,9,7114,0,0
7445,ACGTCGAATCTAGGGA,122,122,0,8,1467,0,0
7446,ACGTCGAATCTAGGGA,122,139,17,14,4109,4,0
7447,ACGTCGAATCTAGGGA,122,145,23,15,5124,6,0
7448,ACGTCGAATCTAGGGA,122,138,16,18,5284,3,0
7449,ACGTCGAATCTAGGGA,122,125,3,14,5288,0,0
7450,ACGTCGAATCTAGGGA,122,132,10,14,5309,1,0
7451,ACGTCGAATCTAGGGA,122,124,2,16,5668,0,0
7452,ACGTCGAATCTAGGGA,122,127,5,15,5724,0,0
7453,ACGTCGAATCTAGGGA,122,135,13,13,5998,2,0
7454,ACGTCGAATCTAGGGA,122,123,1,16,6029,0,0
7455,ACGTCGAATCTAGGGA,122,124,2,16,6184,0,0
7456,ATGTCGAATCTAGGGA,122,127,5,14,6201,0,0
7457,ATGTCGAATCTAGGGA,122,127,5,14,6209,0,0
7458,ACGTCGAATCTAGGGA,122,136,14,13,6346,3,0
7459,ACGTCGAATCTAGGGA,122,129,7,12,6349,0,0
7460,ACGTCGAATCTAGGGA,122,128,6,10,6353,0,0
7461,ACGTCGAATCTAGGGA,122,131,9,16,6355,1,0
7462,ACGTCGAATCTAGGGA,122,149,27,17,6365,7,0
7463,ACGTCGAATCTAGGGA,122,127,5,10,6367,0,0
7464,ACGTCGAATCTAGGGA,122,153,31,10,6532,8,0
7465,ACGTCGAATCTAGGGA,122,130,8,16,6534,1,0
7466,ACGTCGAATCTAGGGA,122,128,6,10,6555,0,0
7467,ACGTCGAATCTAGGGA,122,132,10,16,6557,1,0
7468,ACGTCGAATCTAGGGA,122,122,0,12,6558,0,0
7469,ACGTAGAATCTAGGGA,122,140,18,12,6703,4,0
7470,ACGTCGAATCTAGGGA,122,136,14,10,6704,3,0
7471,ACGTCGAATCTAGGGA,122,128,6,17,6708,0,0
7472,ACGTCGAATCTAGGGA,122,125,3,13,6717,0,0
7473,ACGTCGAATCTAGGGA,122,131,9,12,6889,1,0
7474,ACGTCGAATCTAGGGA,122,145,23,12,6902,6,0
7475,ACGTCGAATCTAGGGA,122,130,8,16,6904,1,0
7476,ACGTCGAATCTAGGGA,122,126,4,14,6912,0,0
7477,ACGTCGAATCTAGGGC,122,122,0,17,6916,0,0
7478,ACGTCGATTCTAGGGA,122,122,0,13,6919,0,0
7479,ACGTCGAATCTAGGGA,122,147,25,17,6921,6,0
7480,ACGTCTAATCTAGGGA,122,140,18,17,7034,4,0
7481,CCGTCGAATCTAGGGA,122,122,0,14,7058,0,0
7482,ACGTCGACTCTAGGGA,122,122,0,16,7062,0,0
7483,ACGTCGAATCTAGGGA,122,123,1,10,7067,0,0
7484,ACGTCGAATCTAGGGA,122,127,5,12,7073,0,0
7485,ACGTCGAATCTCGGGA,122,124,2,11,7075,0,0
7486,ACGTCGAATCTAGGGA,122,122,0,14,7077,0,0
7487,ACGTCGAATCTAGGGA,122,130,8,19,7084,1,0
7488,ACGTAGAATCTAGGGA,122,137,15,14,7086,3,0
7489,ACGTCGAATCTAGGGA,122,126,4,16,7092,0,0
7490,ACGTCGAATCTAGGGA,122,122,0,15,7093,0,0
7491,ACGTCGAATCTAGGGA,122,124,2,12,7096,0,0
7492,ACGTCGAATCTAGGGA,122,127,5,17,7100,0,0
7493,ACGTCGAATCGAGGGA,122,123,1,18,7102,0,0
7494,ACGTCGAATCTAGGGA,122,131,9,15,7108,1,0
7495,ACGTCGAATCTAGGGA,122,130,8,15,7113,1,0
7496,ACGTCGAATCTAGGGA,122,132,10,15,7115,1,0
7497,ACGTCGAATCTAGGGA,123,147,24,11,5182,7,0
7498,ACGTCGAATCTAGGGA,123,130,7,16,5365,1,0
7499,ACGTCGAATCTAGGGA,123,151,28,11,5516,8,0
7500,ACGTCGAATCTAGGGA,123,123,0,15,5706,0,0
7501,ACGTCGAATCTAGGGA,123,132,9,15,6060,2,0
7502,ACGTCGAATCTAGGGA,123,131,8,16,6066,1,0
7503,ACGTCGAATCTAGGGA,123,129,6,16,6229,1,0
7504,ACGTCGAATCTAGGGA,123,124,1,15,6235,0,0
7505,ACGTCGAATCTAGGGA,123,158,35,15,6239,10,0
7506,ACGTCGAATCTAGGGA,123,136,13,14,6241,3,0
7507,ACGTCGAATCTAGGGA,123,134,11,17,6245,2,0
7508,ACGTCGAATCTAGGGA,123,131,8,13,6251,1,0
7509,ACGTCGAATCTAGGGA,123,136,13,13,6254,3,0
7510,ACGTCGAATCTAGGGA,123,142,19,9,6396,5,0
7511,ACGTCGAATCTAGGGA,123,135,12,15,6409,3,0
7512,ACGTCGAATCTAGGGA,123,133,10,14,6420,2,0
7513,ACGTCTAATCTAGGGA,123,146,23,16,6437,6,0
7514,ACGTCGAATCTAGGGA,123,128,5,13,6587,0,0
7515,ACGTCGAATCTACGGA,123,129,6,12,6721,1,0
7516,ACGTCGAATCTAGGGA,123,130,7,9,6747,1,0
7517,ACGTCGAATCTAGGGA,123,126,3,19,6749,0,0
7518,ACGTCGAATCTAGGGA,123,125,2,16,6752,0,0
7519,ACGTCGAATCTAGGGA,123,131,8,15,6756,1,0
7520,ACGTCGAATCTAGGGA,123,139,16,10,6763,4,0
7521,ACGTCGAATCTAGGGA,123,124,1,17,6769,0,0
7522,ACGTCGAATCTAGGGA,123,133,10,16,6771,1,0
7523,ACGTCGAATCTAGGGA,123,127,4,14,6773,0,0
7524,ACGTCGAATCTAGGGA,123,124,1,9,6937,0,0
7525,ACGTCGAATCTAGGGA,123,143,20,16,6941,5,0
7526,ACGTCGAATCTAGGGA,123,129,6,15,6945,0,0
7527,ACGTCGAATCTAGGGA,123,125,2,16,6954,0,0
7528,ACGTCGAATCTAGGGA,123,129,6,11,6957,0,0
7529,ACGTCGAATCTAGGGA,123,124,1,15,6970,0,0
7530,ACGTCGAATCTAGGGA,123,140,17,14,6971,4,0
7531,ACGTCGAATCTAGGGA,123,145,22,16,6972,5,0
7532,ACGTCGAATCTAGGGA,123,134,11,17,6976,2,0
7533,CCGTCGAATCTAGTGA,123,130,7,13,6977,0,0
7534,ACGTCGAATCTAGGGA,123,138,15,15,6980,3,0
7535,ACGTCGAATCTAGGGA,123,147,24,17,6983,6,0
7536,ACGTCGAATCTAGGGA,123,130,7,17,6984,0,0
7537,ACGTCGAATCTAGGGA,123,127,4,11,6985,0,0
7538,ACGTCGAATCTAGGGA,123,126,3,16,7116,0,0
7539,ACGTCGAATCTAGGGA,123,126,3,10,7117,0,0
7540,ACGTCGAATCTAGGGA,123,126,3,19,7118,0,0
7541,ACGTCGAATATAGGGA,123,126,3,13,7123,0,0
7542,ACGGCGAATTTAGGGA,123,126,3,15,7124,0,0
7543,ACGTCGAATCTAGGGA,123,124,1,17,7125,0,0
7544,ACGTCGAATCTAGGGA,123,126,3,14,7128,0,0
7545,ACGTCGAATCTAGGGA,123,126,3,15,7131,0,0
7546,ACGTCGAATCTAGGGA,123,126,3,15,7132,0,0
7547,ACGTCGAATCTAGGGA,124,125,1,15,5498,0,0
7548,ACGTCGAATCTAGGGA,124,155,31,9,6042,8,0
7549,ACGTCGAATCTAGGGA,124,130,6,16,6046,0,0
7550,ACGTCGAATCTAGGGA,124,136,12,15,6048,2,0
7551,ACGTCGAATCTAGGGA,124,137,13,10,6287,2,0
7552,ACGTCGATTCTAGGGA,124,142,18,12,6316,4,0
7553,ACGTCGAATCTAGGGA,124,125,1,16,6323,0,0
7554,ACGTCGAATCTAGGGA,124,141,17,18,6327,4,0
7555,ACGTCGAATCTAGGGA,124,131,7,12,6479,0,0
7556,ACGTCAAATCTAGGGA,124,124,0,15,6571,0,0
7557,ACGTCGAATCTAGGGA,124,153,29,16,6573,8,0
7558,ACGTCGAATCTAGGGA,124,135,11,15,6577,2,0
7559,ACGTCGAATCTAGGGA,124,131,7,17,6648,0,0
7560,ACGTCGAATCTAGGGA,124,127,3,17,6652,0,0
7561,ACGTCGAATCTAGGGA,124,127,3,16,6658,0,0
7562,ACGTCGAATCTAGGGA,124,136,12,16,6663,2,0
7563,ACGTCGAATCTAGGGA,124,145,21,14,6687,5,0
7564,ATGTCGAATCTAGGGA,124,145,21,14,6697,5,0
7565,ACGTCGAATCTAGGGA,124,159,35,14,6816,10,0
7566,ACGTCGAATCTAGGGA,124,150,26,16,6821,7,0
7567,ACGTCGAATCTAGGGA,124,135,11,13,6831,2,0
7568,ACGTCGAATCTAGGGA,124,140,16,17,6844,3,0
7569,ACGTCGAATCTAGGGA,124,128,4,14,6847,0,0
7570,ACGTCGAATCTAGGGA,124,137,13,16,6850,2,0
7571,ACGTCGAATCTAGGGA,124,144,20,14,6851,5,0
7572,ACGTCGAATCTAGGGA,124,136,12,17,6854,2,0
7573,ACGTCGAATCTAGGGA,124,126,2,15,6855,0,0
7574,ACGTCTAATCTAGGGA,124,127,3,17,6861,0,0
7575,ACGTCGAATCTATGGA,124,127,3,16,6867,0,0
7576,ACGTCGAATCTAGGGA,124,127,3,11,6988,0,0
7577,ACGTCGAATCTAGGGA,124,127,3,14,6998,0,0
7578,ACGTCGAATCTAGGGA,124,125,1,12,7001,0,0
7579,ACGTCGAATCTAGGGA,124,127,3,20,7006,0,0
7580,ACGTCGAATCTAGGGA,124,127,3,16,7008,0,0
7581,ACGTCGAATCTAGGGA,124,124,0,16,7011,0,0
7582,ACGTCGAATCTAGGGT,124,127,3,16,7014,0,0
7583,ACGTCGAATCTAGGGA,124,127,3,17,7017,0,0
7584,ACGTCGAATCTAGGGA,124,127,3,17,7022,0,0
7585,ACGTCGAATCTAGGGA,124,127,3,16,7023,0,0
7586,ACGTCGAATCTAGGGA,124,127,3,17,7027,0,0
7587,ACGTCGAATCTAGGGA,124,127,3,15,7028,0,0
7588,ACGTCGAATCTAGGGA,124,124,0,11,7031,0,0
7589,ACGTCGAATCTAGGGA,124,127,3,9,7114,0,0
7590,ACGTCGAATCTAGGGA,124,125,1,12,7164,0,0
7591,ACGTCGAATCTAGGGA,124,124,0,17,7173,0,0
7592,ACGTCGTATCTAGGGA,124,127,3,17,7174,0,0
7593,ACGTCGAATCTAGGGA,124,127,3,16,7177,0,0
7594,ACGTCGAATCTAGGGA,124,124,0,16,7180,0,0
7595,ACGTCGCATCTAGGGA,124,124,0,15,7182,0,0
7596,ACGTCGAATCTAGGGA,124,125,1,10,7187,0,0
7597,ACGTCGAATCTAGGGA,124,124,0,20,7188,0,0
7598,ACGTCGAATCTAGGGA,124,125,1,15,7191,0,0
7599,ACGTCTAATCTAGGGA,124,125,1,17,7193,0,0
7600,ACGTGGAATCTAGGGA,124,124,0,15,7196,0,0
7601,ACGTCGAATCTAGGGA,124,125,1,17,7197,0,0
7602,ACGTCGAATCTACGGA,124,127,3,13,7198,0,0
7603,ACGTCGAATCTAGGGA,124,125,1,14,7200,0,0
7604,ACGTCGAATCTAGGGA,124,127,3,16,7205,0,0
7605,ACGTCGAATCTAGGGA,124,127,3,11,7208,0,0
7606,ACGTCGAATCTAGGGA,124,127,3,16,7209,0,0
7607,ACGTCGAATCTAGGAA,124,127,3,13,7210,0,0
7608,ACGTCGAATCTAGGGA,124,127,3,11,7211,0,0
7609,ACGTCGAATCTAGGGA,124,127,3,17,7212,0,0
7610,ACGTCGAATCTAGGGA,124,127,3,17,7217,0,0
7611,ACGTCGAATCTAGGGA,124,127,3,10,7218,0,0
7612,ACGTCGAATCTAGGGA,124,127,3,12,7219,0,0
7613,ACGTCGAATCTAGGGA,125,131,6,14,4109,0,0
7614,ACGTCGAATCTAGGGA,125,135,10,15,5124,1,0
7615,ACGTCGAATCTAGGGA,125,127,2,14,5309,0,0
7616,ACGTCGAATCTAGGGA,125,125,0,13,5998,0,0
7617,ACGTCGAATCTAGGGA,125,128,3,14,6201,0,0
7618,ACGTCGAATCTAGGGA,125,126,1,13,6346,0,0
7619,ACGTCGAATCTAGGGA,125,142,17,12,6349,4,0
7620,ACGTCGAATCTAGGGA,125,127,2,10,6353,0,0
7621,ACGTCGAATCTAGGGA,125,128,3,16,6355,0,0
7622,GCGTCGAATCTAGGGA,125,127,2,17,6365,0,0
7623,ACGTCGAATCTAGGGA,125,129,4,10,6367,0,0
7624,ACGTCGAATCTAGGGA,125,148,23,10,6532,6,0
7625,ACGTCGAATCTAGGGA,125,139,14,16,6534,3,0
7626,ACGTCGAATCTAGGGA,125,127,2,16,6557,0,0
7627,ACGTCGTATCTAGGGA,125,150,25,12,6558,6,0
7628,ACGTAGAATCTAGGGA,125,125,0,12,6703,0,0
7629,ACGTCGAATCTAGGGA,125,131,6,10,6704,0,0
7630,ACGTCGAATCTAGGGA,125,137,12,17,6708,2,0
7631,ACGTCGAATCTAGGGA,125,148,23,13,6717,6,0
7632,ACGTCGAATCTAGGGA,125,128,3,12,6889,0,0
7633,ACGTCGAATCTAGGGA,125,134,9,12,6902,1,0
7634,ACGTCGAATCTAGGGA,125,129,4,16,6904,0,0
7635,ACGTCGAATCGAGGGA,125,134,9,14,6912,1,0
7636,ACGTCGAATCTAGGGC,125,139,14,17,6916,3,0
7637,ACGTCGATTCTAGGGA,125,127,2,13,6919,0,0
7638,ACGTCGAATCTAGGGA,125,136,11,17,6921,2,0
7639,ACGTCTAATCTAGGGA,125,125,0,17,7034,0,0
7640,CCGTCGAATCTAGGGA,125,126,1,14,7058,0,0
7641,ACGTCGAATCTAGGGA,125,149,24,16,7062,6,0
7642,ACGTCGAATCTAGGGA,125,125,0,12,7073,0,0
7643,ACGTCGAATCTAGGGA,125,139,14,11,7075,3,0
7644,ACGTCGAATCTAGGGA,125,135,10,14,7077,1,0
7645,ACGTCGAATCTAGGGA,125,129,4,19,7084,0,0
7646,ACGTAGAATCTAGGGA,125,130,5,14,7086,0,0
7647,ACGTCGAATCTAGGGA,125,144,19,16,7092,4,0
7648,ACGTCGAATCTAGGGA,125,133,8,15,7093,1,0
7649,ACGTCGAATCTAGGGA,125,127,2,12,7096,0,0
7650,ACGTCGAATCTAGGGA,125,126,1,15,7115,0,0
7651,ACGTCGAATCTAGGGA,125,132,7,12,7223,0,0
7652,ACGTCGAATCTAGGGA,125,142,17,15,7224,4,0
7653,ACGTCGAATCTAGGGA,125,127,2,13,7225,0,0
7654,ACGTCGAATCTAGGGA,125,126,1,17,7227,0,0
7655,ACGTCGAATCTAGGGA,125,135,10,12,7327,1,0
7656,ACGTCGAATCTAGGGA,125,140,15,17,7328,3,0
7657,ACGTCGAATCTAGGGA,125,141,16,12,7329,3,0
7658,ACGTCGAATCTAGGGA,125,125,0,16,7330,0,0
7659,ACGTCGAATCTAGGGA,125,137,12,16,7332,2,0
7660,ACGTCGAATCTAGGGA,125,127,2,17,7333,0,0
7661,ACGTCGAATCTAGGGA,125,145,20,15,7334,5,0
7662,ACGTCGAATCTAGGGA,125,125,0,16,7336,0,0
7663,ACGTCGAATCTAGGGA,125,126,1,16,7337,0,0
7664,ACGTCGAATCTAGGGA,125,141,16,17,7339,3,0
7665,ACGTCGAATCTAGGGA,125,156,31,15,7340,8,0
7666,ACGTCGAATCTAGGGA,125,135,10,14,7342,1,0
7667,ACGTCGAATCTAGGGA,125,126,1,17,7351,0,0
7668,ACGTCGAATCTACGGA,125,130,5,13,7352,0,0
7669,ACGTCGAATCTAGGGA,125,127,2,20,7355,0,0
7670,ACGTCGAATCTAGGGA,125,136,11,16,7357,2,0
7671,ACGTCGAATCTAGGGA,125,127,2,11,7358,0,0
7672,ACGTCGAATCTAGGGA,125,127,2,18,7359,0,0
7673,ACGTCGAATCTAGGGA,125,134,9,15,7362,1,0
7674,ACGTCGAATCTAGGGA,125,130,5,17,7363,0,0
7675,ACGTCGAATCTAGGGA,126,133,7,16,5365,1,0
7676,ACGTCGAATCTAGGGA,126,135,9,11,5516,2,0
7677,ACGTCGAATCTAGGGA,126,167,41,15,5706,12,0
7678,ACGTCGAATCTAGGGA,126,134,8,15,6060,1,0
7679,ACGTCGAATCTAGGGA,126,139,13,16,6066,3,0
7680,ACGTCGAATCTAGGGA,126,128,2,15,6239,0,0
7681,ACGTCGAATCTAGGGA,126,135,9,14,6241,2,0
7682,ACGTCGAATCTCGGGA,126,149,23,17,6245,6,0
7683,ACGTCGAATCTAGGGA,126,130,4,13,6251,0,0
7684,ACGTCGAATCTAGGGA,126,136,10,13,6254,1,0
7685,ACGTCGAATCTAGGGA,126,127,1,9,6396,0,0
7686,ACGTCGAATCTAGGGA,126,134,8,15,6409,1,0
7687,ACGGCGAATCTAGGGA,126,133,7,13,6587,0,0
7688,ACGTCGAATCTACGGA,126,129,3,12,6721,0,0
7689,ACGTCGAATCTAGGGA,126,137,11,9,6747,2,0
7690,ACGTCGAATCTAGGGA,126,161,35,15,6756,10,0
7691,ACGTCGAATCTAGGGA,126,154,28,16,6771,7,0
7692,ACGTCGAATCTAGGGA,126,134,8,14,6773,1,0
7693,ACGTCGAATCTAGGGA,126,155,29,9,6937,8,0
7694,ACGTCGAATCTAGGGA,126,129,3,16,6941,0,0
7695,ACGTCGAATCTAGGGA,126,129,3,15,6945,0,0
7696,ACGTCGAATCTAGGGA,126,129,3,16,6954,0,0
7697,ACGTCGAATCTAGGGA,126,127,1,11,6957,0,0
7698,ACGTCGAATCTAGGGA,126,127,1,15,6970,0,0
7699,ACGTCGAATCTAGGGA,126,126,0,14,6971,0,0
7700,ACGTCGAATCTAGGGA,126,129,3,16,6972,0,0
7701,ACGTCGAATCTAGGGA,126,129,3,17,6976,0,0
7702,ACGTCGAATCTAGGGA,126,129,3,15,6980,0,0
7703,ACGTCGAATCTAGGGA,126,129,3,17,6983,0,0
7704,ACGTCGAATCTAGGGA,126,128,2,16,7116,0,0
7705,ACGTCGAATCTAGGGA,126,129,3,19,7118,0,0
7706,ACGGCGAATTTAGGGA,126,127,1,15,7124,0,0
7707,ACGTCGAATCTAGGGA,126,129,3,14,7128,0,0
7708,ACGTCGAATCTAGGGA,126,127,1,15,7131,0,0
7709,ACGTCGAATCTAGGGA,126,128,2,16,7282,0,0
7710,ACGTCGAATCTAGGGA,126,129,3,19,7283,0,0
7711,ACGTCGAATCGAGGGA,126,129,3,16,7286,0,0
7712,ACGTCGAATCTAGGGA,126,129,3,12,7287,0,0
7713,ACGTCGACTCTAGGGA,126,128,2,13,7288,0,0
7714,ACGTCGAATCTAGGGA,126,127,1,17,7289,0,0
7715,ACGTCGAATCTAGGGA,126,129,3,17,7293,0,0
7716,ACGTCGAATCTAGGGA,126,127,1,15,7294,0,0
7717,ACGTCGAATCTAGGGA,126,129,3,14,7297,0,0
7718,ACGTCGAATCTAGGGA,126,129,3,11,7299,0,0
7719,ACGTCGAATCTAGGGA,126,129,3,11,7304,0,0
7720,ACGTCGAATCTAGGGA,126,128,2,17,7305,0,0
7721,ACGTCGAATCTAGGGA,126,129,3,13,7306,0,0
7722,ACGTCGAATCTAGGGA,126,128,2,11,7307,0,0
7723,ACGTCGAATCTAGGGA,126,126,0,17,7308,0,0
7724,ACGTAGAATCTAGGGA,126,127,1,13,7310,0,0
7725,ACGTCGAATCTAGGGA,126,129,3,15,7312,0,0
7726,ACGTCGAATCTAGGGA,126,129,3,18,7313,0,0
7727,ACGTCGAATCTAGGGA,126,129,3,17,7317,0,0
7728,ACGTCGATTCTAGGGA,126,129,3,14,7323,0,0
7729,ACGTCGAATCTAGGGA,126,129,3,14,7324,0,0
7730,ACGTCGAATCTAGGGA,126,129,3,18,7325,0,0
7731,ACGTCGAATCTAGGGA,126,129,3,20,7326,0,0
7732,ACGTCGAATCTAGGGA,127,135,8,15,5498,1,0
7733,ACGTCGAATCTAGGGA,127,134,7,16,6046,0,0
7734,ACGTCGAATCTAGGGA,127,127,0,15,6048,0,0
7735,ACGTCGAATCTAGGGA,127,133,6,10,6287,0,0
7736,ACGTCGATTCTAGGGA,127,127,0,12,6316,0,0
7737,ACGTCGAATCTAGGGA,127,130,3,18,6327,0,0
7738,ACGTCGAATCTAGGGA,127,139,12,15,6571,2,0
7739,ACGTCGAATCTAGGGA,127,131,4,16,6573,0,0
7740,ACGTCGAATCTAGGGA,127,135,8,15,6577,1,0
7741,ACGTCGAATCTAGGGA,127,129,2,16,6658,0,0
7742,ACGTCGAATCTAGGGA,127,156,29,16,6663,8,0
7743,ACGTCGAATCTAGGGA,127,128,1,14,6687,0,0
7744,ACGTCGAATCTAGGGA,127,130,3,14,6816,0,0
7745,ACGTCGAATCTAGGGA,127,133,6,16,6821,0,0
7746,ACGTCGAATCTAGGGA,127,145,18,13,6831,4,0
7747,ACGTCGAATCTAGGGA,127,134,7,17,6844,0,0
7748,ACGTCGAATCTAGGGA,127,127,0,14,6847,0,0
7749,ACGTCGAATCTAGGGA,127,143,16,17,6854,3,0
7750,ACGTCGAATCTAGGGA,127,133,6,15,6855,0,0
7751,ACGTCTAATCTAGGGA,127,129,2,17,6861,0,0
7752,ACGTCGAATCTATGGA,127,132,5,16,6867,0,0
7753,ACGTCGAATCTAGGGA,127,145,18,12,7001,4,0
7754,ACGTCGAATCTAGGGA,127,127,0,16,7011,0,0
7755,ACGTCGAATCTAGGGA,127,147,20,17,7022,5,0
7756,ACGTCGAATCTAGGGA,127,161,34,11,7031,9,0
7757,ACGTCGAATCTAGGGA,127,140,13,9,7114,2,0
7758,ACGTCGAATCTAGGGA,127,150,23,12,7164,6,0
7759,ACGTCGAATCTAGGGA,127,130,3,17,7173,0,0
7760,ACGTCGTATCTAGGGA,127,131,4,17,7174,0,0
7761,ACGTCGAATCTAGGGA,127,160,33,16,7177,9,0
7762,ACGTCGAATCTAGGGA,127,143,16,16,7180,3,0
7763,ACGTCGCATCTAGGGA,127,127,0,15,7182,0,0
7764,ACGTCGAATCTAGGGA,127,130,3,20,7188,0,0
7765,ACGTCGAATCTAGGGA,127,132,5,15,7191,0,0
7766,ACGTGGAATCTAGGGA,127,128,1,15,7196,0,0
7767,ACGTCGAATCTAGGGA,127,144,17,13,7198,4,0
7768,ACGTCGAATCTAGGGA,127,143,16,14,7200,3,0
7769,ACGTCGAATCTAGGGA,127,134,7,16,7205,0,0
7770,ACGTCGAATCTAGGGA,127,128,1,11,7208,0,0
7771,ACGTCGAATCTAGGGA,127,128,1,16,7209,0,0
7772,ACGTCGAATCTAGGAA,127,136,9,13,7210,1,0
7773,ACGTCGAATCTAGGGA,127,134,7,11,7211,0,0
7774,ACGTCGAATCTAGGGA,127,128,1,17,7212,0,0
7775,ACGTCGAATCTAGGGA,127,129,2,17,7217,0,0
7776,ACGTCGAATCTAGGGA,127,131,4,12,7219,0,0
7777,ACGTCGAATCTAGGGA,127,129,2,17,7365,0,0
7778,ACGTCGAATCTAGGGA,127,143,16,16,7368,3,0
7779,ACGTCGAATCTAGGGA,127,166,39,17,7369,11,0
7780,ACGTCGAATCTAGGGA,127,133,6,17,7373,0,0
7781,ACGTCGAATCTAGGGA,128,130,2,14,4109,0,0
7782,ACGTCGAATCTAGGGA,128,144,16,15,5124,4,0
7783,ACGTCGAATCTAGGGA,128,135,7,14,6201,1,0
7784,ACGTCGAATCTAGGGA,128,128,0,12,6349,0,0
7785,ACGTCGAATCTAGGGA,128,134,6,10,6353,1,0
7786,ACGTCGAATCTAGGGA,128,178,50,17,6365,15,0
7787,ACGTCGAATCTAGGGA,128,134,6,10,6367,1,0
7788,ACGTCGAATCTAGGGA,128,143,15,16,6557,4,0
7789,ACGTCGAATCTAGGGA,128,159,31,12,6558,8,0
7790,ACGTAGAATCTAGGGA,128,137,9,12,6703,1,0
7791,ACGTCGAATCTAGGGA,128,130,2,10,6704,0,0
7792,ACGTCGAATCTAGGGA,128,129,1,13,6717,0,0
7793,ACGTCGAATCTAGGGA,128,131,3,12,6902,0,0
7794,ACGTCGAATCTAGGGA,128,131,3,16,6904,0,0
7795,ACGTCGAATCTAGGGA,128,129,1,14,6912,0,0
7796,ACGTCGAATCTAGGGC,128,128,0,17,6916,0,0
7797,ACGTCGATTCTAGGGA,128,131,3,13,6919,0,0
7798,ACGTCGAATCTAGGGA,128,131,3,17,6921,0,0
7799,ACGTCTAATCTAGGGA,128,131,3,17,7034,0,0
7800,CCGTCGAATCTAGGGA,128,131,3,14,7058,0,0
7801,ACGTCGAATCTAGGGA,128,128,0,16,7062,0,0
7802,ACGTCGAATCTAGGGA,128,130,2,12,7073,0,0
7803,ACGTCGAATCTAGGGA,128,128,0,14,7077,0,0
7804,ACGTCGAATCTAGGGA,128,131,3,19,7084,0,0
7805,ACGTAGAATCGAGGGA,128,131,3,14,7086,0,0
7806,ACGTCGAATCTAGGGA,128,131,3,15,7093,0,0
7807,ACGTCGAATCTAGGGA,128,128,0,15,7115,0,0
7808,ACGTCGAATCTAGGGA,128,131,3,12,7223,0,0
7809,ACGTCGAATCTAGGGA,128,131,3,15,7224,0,0
7810,ACGTCGAATCTAGGGA,128,128,0,13,7225,0,0
7811,ACGTCGAATCTAGGGA,128,131,3,17,7227,0,0
7812,ACGTCGAATCTAGGGA,128,129,1,17,7328,0,0
7813,ACGTCGAATCTAGGGA,128,131,3,12,7329,0,0
7814,ACGTCGAATCTAGGGA,128,131,3,16,7330,0,0
7815,ACGTCGAATCTAGGGA,128,131,3,16,7332,0,0
7816,ACGTCGAATCTAGGGA,128,131,3,17,7333,0,0
7817,ACGTCGAATCTAGGGA,128,129,1,16,7336,0,0
7818,ACGTCGAATCTAGGGA,128,131,3,16,7337,0,0
7819,ACGTCGAATCTAGGGA,128,131,3,17,7339,0,0
7820,ACGTCGAATCTAGGGA,128,131,3,17,7351,0,0
7821,ACGTCGAATCTAGGGA,128,131,3,11,7358,0,0
7822,ACGTCGAATCTAGGGA,128,131,3,18,7359,0,0
7823,ACGTCGAATCTAGGGA,128,131,3,15,7362,0,0
7824,ACGTCGAATCTAGGGA,128,129,1,17,7363,0,0
7825,ACGTCGAATCTAGGGA,128,128,0,17,7386,0,0
7826,ACGTCGAATCTAGGGA,128,131,3,12,7388,0,0
7827,ACGTCGAATCTAGGGA,128,131,3,12,7497,0,0
7828,ACGTCGAATCTAGGGA,128,128,0,17,7498,0,0
7829,ACGTCGAATCTAGGGA,128,131,3,12,7499,0,0
7830,ACGTCGAATCTAGGGA,128,131,3,16,7501,0,0
7831,ACGTCGAATCTAGGGA,128,130,2,17,7502,0,0
7832,ACGTCGAATCTAGGGA,128,131,3,17,7503,0,0
7833,ACGTCGAATCTAGGGA,128,131,3,16,7505,0,0
7834,ACGTCGAATCTAGGGA,128,131,3,15,7506,0,0
7835,ACGTCGAATCTAGGGA,128,131,3,18,7507,0,0
7836,ACGTCGAATCTAGGGA,128,129,1,14,7508,0,0
7837,ACGTCGAATCTAGGGA,128,131,3,14,7509,0,0
7838,ACGTCGAATCTAGGGA,128,128,0,10,7510,0,0
7839,ACGTCGAATCTAGGGA,128,129,1,16,7511,0,0
7840,ACGTCGAATCTAGGGA,128,130,2,15,7512,0,0
7841,ACGTCTAATCTAGGGA,128,129,1,17,7513,0,0
7842,ACGTCGAATCTACGGA,128,129,1,13,7515,0,0
7843,ACGTCGAATCTAGGGA,128,130,2,10,7516,0,0
7844,ACGTCGAATCTAGGGA,128,131,3,16,7519,0,0
7845,ACGTCGAATCTAGGGA,128,131,3,11,7520,0,0
7846,ACGTCGAATCTAGGGA,129,129,0,15,5706,0,0
7847,ACGTCGAATCTAGGGA,129,131,2,15,6060,0,0
7848,ACGTCGAATCTAGGGA,129,139,10,16,6066,1,0
7849,ACGTCGAATCTAGGGA,129,131,2,15,6239,0,0
7850,ACGTCGAATCTAGGGA,129,130,1,14,6241,0,0
7851,ACGTCGAATCTAGGGA,129,130,1,13,6251,0,0
7852,ACGTCGAATCTAGGGA,129,157,28,13,6254,7,0
7853,ACGTCGAATCTAGGGA,129,132,3,9,6396,0,0
7854,ACGTCGAATCTAGGGA,129,134,5,13,6587,0,0
7855,ACGTCGAATCTAGGCA,129,133,4,9,6747,0,0
7856,ACGTCGAATCTAGGGA,129,132,3,15,6756,0,0
7857,ACGTCGAATCTAGGGA,129,145,16,16,6771,3,0
7858,ACGTCGAATCTAGGGA,129,133,4,9,6937,0,0
7859,ACGTCGAATCTAGGGA,129,131,2,16,6941,0,0
7860,ACGTCGAATCTAGGGA,129,130,1,11,6957,0,0
7861,ACGTCGAATCTAGGGA,129,137,8,15,6970,1,0
7862,ACGTCGAATCTAGGGA,129,137,8,17,6976,1,0
7863,ACGTCGAATCTAGGGA,129,139,10,15,6980,1,0
7864,ACGTCGAATCTAGGGA,129,132,3,16,7116,0,0
7865,ACGTCGAATCTAGGGA,129,130,1,19,7118,0,0
7866,ACGTCGAATCTAGGGA,129,149,20,14,7128,5,0
7867,ACGTCGAATCGAGGGA,129,136,7,16,7286,0,0
7868,ACGTCGAATCTAGGGA,129,131,2,12,7287,0,0
7869,ACGTCGACTCTAGGGA,129,142,13,13,7288,2,0
7870,ACGTCGAATCTAGGGA,129,136,7,11,7299,0,0
7871,ACGTCGAATCTAGGGA,129,133,4,11,7304,0,0
7872,ACGTCGAATCTAGGGA,129,135,6,17,7305,0,0
7873,ACGTCGAATCTAGGGA,129,141,12,13,7306,2,0
7874,ACGTCGAATCTAGGGA,129,144,15,11,7307,3,0
7875,ACGTCGAATCTAGGGA,129,129,0,17,7308,0,0
7876,ACGTAGAATCTAGGGA,129,152,23,13,7310,6,0
7877,ACGTCGAATCTAGGGA,129,142,13,18,7313,2,0
7878,ACGTCGAATCTAGGGA,129,137,8,17,7317,1,0
7879,ACGTCGAATCTAGGGA,129,138,9,20,7326,1,0
7880,ACGTCGAATCTAGGGA,129,140,11,15,7446,2,0
7881,ACGTCGAATCTAGGGA,129,137,8,16,7447,1,0
7882,ACGTCGAATCTAGGGA,129,130,1,19,7448,0,0
7883,ACGTCGAATCTAGGGA,129,133,4,15,7450,0,0
7884,ACGTCGAATCTAGGGA,129,143,14,14,7453,3,0
7885,ACGTCGAATCTAGGGA,129,131,2,14,7458,0,0
7886,ACGTCGAATCTAGGGA,129,135,6,17,7461,0,0
7887,ACGTCGAATCTAGGGA,129,145,16,18,7462,3,0
7888,ACGTCGAATCTAGGGA,129,147,18,11,7464,4,0
7889,ACGTCGAATCTAGGGA,129,131,2,17,7465,0,0
7890,ACGTCGAATCTAGGGA,129,154,25,17,7467,6,0
7891,ACGTAGAATCTAGGGA,129,133,4,13,7469,0,0
7892,ACGTCGAATCTAGGGA,129,132,3,11,7470,0,0
7893,ACGTCGAATCTAGGGA,129,135,6,13,7473,0,0
7894,ACGTCGAATCTAGGGA,129,133,4,13,7474,0,0
7895,ACGTCGAATCTAGGGA,129,139,10,17,7475,1,0
7896,ACGTCGAATCTAGGGA,129,129,0,18,7479,0,0
7897,ACGTCTAATCTAGGGA,129,145,16,18,7480,3,0
7898,ACGTCGAATCTAGGGA,129,131,2,20,7487,0,0
7899,ACGTAGAATCTAGGGA,129,131,2,15,7488,0,0
7900,ACGTCGAATCTAGGGA,129,137,8,16,7494,1,0
7901,ACGTCGAATCTAGGGA,129,158,29,16,7495,8,0
7902,ACGTCGAATCTAGGGA,129,137,8,16,7496,1,0
7903,ACGTCGAATCTAGGGA,130,150,20,15,5498,5,0
7904,ACGTCGAATCTAGGGA,130,145,15,15,6048,4,0
7905,ACGTCGAATCTAGGGA,130,135,5,10,6287,0,0
7906,ACGTCGATTCTAGGGA,130,146,16,12,6316,4,0
7907,ACGTCGAATCTAGGGA,130,136,6,18,6327,0,0
7908,ACGTCGAATCTAGGGA,130,132,2,15,6571,0,0
7909,ACGTCGAATCTAGGGA,130,133,3,16,6573,0,0
7910,ACGTCGAATCTAGGGA,130,156,26,15,6577,7,0
7911,ACGTCGAATCTAGGGA,130,134,4,16,6658,0,0
7912,ACGTCGAATCTAGGGA,130,138,8,16,6663,1,0
7913,ACGTCGAATCTAGGGA,130,133,3,14,6687,0,0
7914,ACGTCGAATCTAGGGA,130,131,1,14,6816,0,0
7915,ACGTCGAATCTAGGGA,130,141,11,16,6821,2,0
7916,ACGTCGAATCTAGGGA,130,147,17,13,6831,4,0
7917,ACGTCGAATCTAGGGA,130,163,33,17,6844,9,0
7918,ACGTCGAATCTAGGGA,130,136,6,14,6847,0,0
7919,ACGTCGAATCTAGGGA,130,138,8,17,6854,1,0
7920,ACGTCGAATCTAGGGA,130,136,6,15,6855,0,0
7921,ACGTCTAATCTAGGGA,130,163,33,17,6861,9,0
7922,ACGTCGAATCTATGGA,130,137,7,16,6867,0,0
7923,ACGTCGAATCTAGGGA,130,136,6,12,7001,0,0
7924,ACGTCGAATCTAGGGA,130,130,0,16,7011,0,0
7925,ACGTCGAATCTAGGGA,130,130,0,17,7022,0,0
7926,ACGTCGAATCTAGGGA,130,134,4,11,7031,0,0
7927,ACGTCGAATCTAGGGA,130,142,12,9,7114,2,0
7928,ACGTCGAATCTAGGGA,130,132,2,12,7164,0,0
7929,ACGTCGTATCTAGGGA,130,153,23,17,7174,6,0
7930,ACGTCGAATCTAGGGA,130,130,0,16,7177,0,0
7931,ACGTCGAATCTAGGGA,130,130,0,16,7180,0,0
7932,ACGTCGCATCTAGGGA,130,140,10,15,7182,1,0
7933,ACGTCGAATCTAGGGA,130,171,41,20,7188,12,0
7934,ACGTCGAATCTAGGGA,130,132,2,15,7191,0,0
7935,ACGTGGAATCTAGGGA,130,133,3,15,7196,0,0
7936,ACGTCGAATCTAGGGA,130,133,3,13,7198,0,0
7937,ACGTCGAATCTAGGGA,130,133,3,16,7205,0,0
7938,ACGTCGAATCTAGGGA,130,133,3,16,7209,0,0
7939,ACGTCGAATCTAGGAA,130,133,3,13,7210,0,0
7940,ACGTCGAATCTAGGGA,130,133,3,11,7211,0,0
7941,ACGTCGAATCTAGGGA,130,133,3,17,7217,0,0
7942,ACGTCGAATCTAGGGA,130,133,3,12,7219,0,0
7943,ACGTCGAATCTAGGGA,130,133,3,17,7365,0,0
7944,ACGTCGAATCTAGGGA,130,133,3,16,7368,0,0
7945,ACGTCGAATCTAGGGA,130,130,0,17,7369,0,0
7946,ACGTCGAATCTAGGGA,130,133,3,17,7373,0,0
7947,ACGTCGAATCTAGGGA,130,133,3,17,7522,0,0
7948,ACGTCGAATCTAGGGA,130,133,3,17,7525,0,0
7949,ACCTCGAATCTAGGGA,130,133,3,15,7530,0,0
7950,ACGTCGAATCTAGGGA,130,133,3,17,7531,0,0
7951,ACGTCGAATCTAGGGA,130,133,3,18,7532,0,0
7952,ACGTCGAATCTAGGGA,130,133,3,16,7534,0,0
7953,ACTTCGAATCTAGGGA,130,133,3,18,7535,0,0
7954,ACGTCGAATCTTGGGA,131,137,6,15,5124,0,0
7955,ACGTCGAATCTAGGGA,131,139,8,14,6201,1,0
7956,ACGTCGAATCTAGGGA,131,131,0,12,6349,0,0
7957,ACGTCGAATCTAGGGA,131,135,4,12,6558,0,0
7958,ACGTAGAATCTAGGGA,131,135,4,12,6703,0,0
7959,ACGTCGAATCTAGGGA,131,134,3,13,6717,0,0
7960,ACGTCGAATCTAGGGA,131,135,4,12,6902,0,0
7961,ACGTCGAATCTAGGGA,131,137,6,17,6921,0,0
7962,ACGTCTAATCTAGGGA,131,139,8,17,7034,1,0
7963,ACGTCGAATCTAGGGA,131,137,6,16,7062,0,0
7964,ACGTCGAATCTAGGGA,131,145,14,12,7073,3,0
7965,ACGTCGAATCTAGGGA,131,147,16,19,7084,3,0
7966,ACGTAGAATCTAGGGA,131,152,21,14,7086,5,0
7967,ACGTCGAATCTAGGGA,131,145,14,15,7093,3,0
7968,ACGTCGAATCTAGGGA,131,156,25,12,7223,6,0
7969,ACGTCGAATCTAGGGA,131,136,5,15,7224,0,0
7970,ATGTCGAATCTAGGGA,131,136,5,17,7227,0,0
7971,ACGTCGAATCTAGGGA,131,142,11,17,7328,2,0
7972,ACGTCGAATCTAGGGA,131,131,0,12,7329,0,0
7973,ACGTCGAATCTAGGGA,131,135,4,16,7330,0,0
7974,ACGTCGAATCTAGGGA,131,149,18,16,7332,4,0
7975,ACGTCGAATCTAGGGA,131,132,1,17,7333,0,0
7976,ACGTCGAATCTAGGGA,131,133,2,16,7336,0,0
7977,ACGTCGAATCTAGGGA,131,138,7,17,7351,0,0
7978,ACGTCGAATCTAGGGA,131,135,4,11,7358,0,0
7979,ACGTCGAATCTAGGGA,131,137,6,17,7363,0,0
7980,ACGTCGAATCTAGGGA,131,138,7,17,7386,0,0
7981,ACGTCGAATCTAGGGA,131,141,10,12,7497,1,0
7982,ACGTCGAATCTAGGGA,131,141,10,12,7499,1,0
7983,ACGTCGAATCTAGGGA,131,137,6,16,7501,0,0
7984,ACGTCGAATCTAGGGA,131,131,0,16,7505,0,0
7985,ACGTCGAATCTAGGGA,131,164,33,15,7506,9,0
7986,ACGTCGAATCTAGGGA,131,132,1,18,7507,0,0
7987,ACGTCGAATCTAGGGA,131,133,2,14,7509,0,0
7988,ACGTCGAATCTAGGGA,131,144,13,10,7510,2,0
7989,ACGTCGAATCTAGGGA,131,159,28,16,7511,7,0
7990,ACGTCGAATCTAGGGA,131,160,29,15,7512,7,0
7991,AGGTCTAATCTAGGGA,131,162,31,17,7513,8,0
7992,ACGTCGAATCTAGGGA,131,137,6,11,7520,0,0
7993,ACGTCGAATCTAGGGA,131,134,3,10,7548,0,0
7994,ACGTCGAATCTAGGGA,131,134,3,16,7550,0,0
7995,ACGTCGAATCTAGGGA,131,134,3,11,7551,0,0
7996,ACGTCGATTCTAGGGA,131,134,3,13,7552,0,0
7997,ACGTCGAATCTAGGGA,131,134,3,19,7554,0,0
7998,ACGTCGAATCTAGGGA,131,131,0,17,7557,0,0
7999,ACGTCGAATCTAGGGA,131,134,3,16,7558,0,0
8000,ACGTCGAATCTAGGGA,131,134,3,17,7562,0,0
8001,ACGTCGAATCTAGGGA,131,134,3,15,7563,0,0
8002,ATGTCGAATCTAGGGA,131,131,0,15,7564,0,0
8003,ACGTCGAATCTAGGGA,131,132,1,15,7565,0,0
8004,ACGTCGAATCTAGGGA,131,132,1,17,7566,0,0
8005,ACGTCGAATCTAGGGA,131,134,3,14,7567,0,0
8006,ACGTCGAATCTAGGGA,131,134,3,18,7568,0,0
8007,ACGTCGAATCTAGGGA,131,132,1,17,7570,0,0
8008,ACGTCGAATCTAGGGA,131,134,3,15,7571,0,0
8009,ACGTCGAATCTAGGGA,131,134,3,17,7675,0,0
8010,ACGTCGAATCTAGGGA,131,134,3,12,7676,0,0
8011,ACGTCGAATCTAGGGA,131,133,2,16,7677,0,0
8012,ACGTCGAATCTAGGGA,131,134,3,16,7678,0,0
8013,ACGTCGAATCTAGGGA,131,132,1,17,7679,0,0
8014,ACGTCGAATCTAGGGA,131,134,3,15,7681,0,0
8015,ACGTCGAATCTCGGGA,131,134,3,18,7682,0,0
8016,ACGTCGAATCTAGGGA,132,132,0,15,6060,0,0
8017,ACGTCGAATCTAGGGA,132,136,4,15,6239,0,0
8018,TCGTCGAATCTAGGGA,132,135,3,14,6241,0,0
8019,ACGTCGAATCTAGGGA,132,142,10,9,6396,1,0
8020,ACGTCGAATCTAGGGA,132,137,5,13,6587,0,0
8021,ACGTCGAATCTAGGGA,132,143,11,9,6747,2,0
8022,ACGTCGAATCTAGGGA,132,144,12,15,6756,2,0
8023,ACGTCGAATCTAGGGA,132,149,17,16,6771,4,0
8024,ACGTCGAATCTAGGGA,132,147,15,9,6937,3,0
8025,ACGTCGAATCTAGGGA,132,134,2,16,6941,0,0
8026,ACGTCGAATCTAGGGA,132,157,25,11,6957,6,0
8027,ACGTCGAATCTAGGGA,132,145,13,15,6970,2,0
8028,ACGTCGAATCTAGGGA,132,148,16,17,6976,3,0
8029,ACGTCGAATCTAGGGA,132,143,11,19,7118,2,0
8030,ACGTCGAATCGAGGGA,132,148,16,16,7286,3,0
8031,ACGTCGAATCTAGGGA,132,138,6,12,7287,0,0
8032,ACGTTGAATCTAGGGA,132,136,4,11,7299,0,0
8033,ACGTCGAATCTAGGGA,132,133,1,11,7304,0,0
8034,ACGTCGAATCAAGGGA,132,136,4,17,7305,0,0
8035,ACGTCGAATCTAGGGA,132,139,7,13,7306,0,0
8036,ACGTCGAATCTAGGGA,132,138,6,17,7308,0,0
8037,ACGTAGAATCTAGGGA,132,133,1,13,7310,0,0
8038,ACGTCGAATCTAGGGA,132,147,15,17,7317,3,0
8039,ACGTCGAATCTAGGGA,132,138,6,15,7446,0,0
8040,ACGTCGAATCTAGGGA,132,135,3,16,7447,0,0
8041,ACGTCGAATCTAGGGA,132,135,3,19,7448,0,0
8042,ACGTCGAATCTAGGGA,132,135,3,14,7453,0,0
8043,ACGTCGAATCTAGGGA,132,133,1,14,7458,0,0
8044,ACGTCGAATCTAGGGA,132,135,3,18,7462,0,0
8045,ACGTCGAATCTAGGGA,132,135,3,11,7464,0,0
8046,ACGTAGAATCTAGGGA,132,132,0,13,7469,0,0
8047,ACGTCGAATCTAGGGA,132,135,3,11,7470,0,0
8048,ACGTCGAATCTAGGGA,132,135,3,13,7474,0,0
8049,ACGTCGAATCTAGGGA,132,132,0,18,7479,0,0
8050,ACGTCTAATCTAGGGA,132,134,2,18,7480,0,0
8051,ACGTAGAATCTAGGGA,132,135,3,15,7488,0,0
8052,ACGTCGAATCTAGGGA,132,134,2,18,7572,0,0
8053,ACGTCGAATCTAGGGA,132,132,0,16,7614,0,0
8054,ACGTCGAATCTAGGGA,132,135,3,13,7619,0,0
8055,ACGTCGAATCTAGGGA,132,135,3,11,7624,0,0
8056,ACGTCGAATCTAGGGA,132,135,3,17,7625,0,0
8057,ACGTCGTATCTAGGGA,132,135,3,13,7627,0,0
8058,ACGTCGAATCTAGGGA,132,134,2,18,7630,0,0
8059,ACGTCGAATCTAGGGA,132,135,3,14,7631,0,0
8060,ACGTCGAATCTAGGGA,132,135,3,13,7633,0,0
8061,ACGTCGAATCGAGGGA,132,135,3,15,7635,0,0
8062,ACGTCGAATCTAGGGC,132,135,3,18,7636,0,0
8063,ACGTCGAATCTAGGGA,132,132,0,18,7638,0,0
8064,ACGTCGAATCTAGGGA,132,134,2,17,7641,0,0
8065,ACGTCGAATCTAGGGA,132,134,2,12,7643,0,0
8066,ACGTCGAATCTAGGGA,132,135,3,15,7644,0,0
8067,ACGTCGAATCTAGGGA,132,135,3,17,7647,0,0
8068,ACGTCGAATCTAGGGA,132,135,3,16,7648,0,0
8069,ACGTCGAATCTAGGGA,132,135,3,16,7652,0,0
8070,ACGTCGAATCTAGGGA,132,135,3,13,7655,0,0
8071,ACGTCGAATCTAGGGA,132,135,3,18,7656,0,0
8072,ACGTCGAATCTAGGGA,132,135,3,13,7657,0,0
8073,ACGTCGAATCTAGGGA,132,135,3,17,7659,0,0
8074,ACGTCGAATCTAGGGA,132,135,3,16,7661,0,0
8075,ACGTCGAATCTAGGGA,132,132,0,18,7664,0,0
8076,ACGTCGAATCTAGGGA,132,135,3,16,7665,0,0
8077,ACGTCGAATCTCGGGA,132,133,1,15,7666,0,0
8078,ACGTCGAATCTAGGGA,132,135,3,17,7670,0,0
8079,ACGTCGAATCTAGGGA,132,135,3,16,7673,0,0
8080,ACGTCGAATCTAGGGA,133,151,18,15,6048,4,0
8081,ACGTCGATTCTAGGGA,133,146,13,12,6316,2,0
8082,ACGTCGAATCTAGGGA,133,136,3,15,6571,0,0
8083,ACGTCGAATCTAGGGA,133,136,3,16,6573,0,0
8084,ACGTCGAATCTAGGGA,133,135,2,16,6658,0,0
8085,ACGTCGAATCTAGGGA,133,147,14,16,6663,3,0
8086,ACGTCGAATCTAGGGA,133,135,2,14,6687,0,0
8087,ACGTCGAATCTAGGGA,133,133,0,14,6816,0,0
8088,ACGTCGAATCTAGGGA,133,137,4,13,6831,0,0
8089,ACGTCGAATCTAGGGA,133,142,9,17,6844,1,0
8090,ACGTCGAATCTAGGGA,133,136,3,14,6847,0,0
8091,ACGTCGAATCTAGGGA,133,142,9,17,6854,1,0
8092,ACGTCGAATCTAGGGA,133,133,0,15,6855,0,0
8093,ACGTCTAATCTAGGGA,133,141,8,17,6861,1,0
8094,ACGTCGAATCTATGGA,133,160,27,16,6867,7,0
8095,ACGTCGAATCTAGGGA,133,141,8,16,7011,1,0
8096,ACGCCGAATCTAGGGA,133,137,4,17,7022,0,0
8097,ACGTCGAATCTAGGGA,133,141,8,11,7031,1,0
8098,ACGTCGAATCTAGGGA,133,136,3,9,7114,0,0
8099,ACGTCGAATCTAGGGA,133,145,12,12,7164,2,0
8100,ACGTCGTATCTAGGGA,133,191,58,17,7174,17,0
8101,ACGTCGAATCTAGGGA,133,133,0,16,7180,0,0
8102,ACGTCGCATCTAGGGA,133,144,11,15,7182,2,0
8103,ACGTCGAATCTAGGGA,133,136,3,20,7188,0,0
8104,ACGTCGAATCTAGGGA,133,136,3,15,7191,0,0
8105,ACGTCGAATCTAGGGA,133,137,4,13,7198,0,0
8106,ACGTCGAATCTAGGGA,133,135,2,16,7205,0,0
8107,ACGTCGAATCTAGGGA,133,135,2,16,7209,0,0
8108,ACGTCGAATCTAGGAA,133,141,8,13,7210,1,0
8109,ACGTCGAATCTAGGGA,133,144,11,17,7217,2,0
8110,ACGTCGAATCTAGGGA,133,135,2,12,7219,0,0
8111,ACGTCGAATCTAGGGA,133,141,8,17,7365,1,0
8112,ACGTCGAATCTAGGGA,133,154,21,16,7368,5,0
8113,ACGTCGAATCTAGGGA,133,152,19,17,7369,4,0
8114,ACGTCGAATCTAGGGA,133,150,17,17,7525,4,0
8115,ACGTCGAATCTAGGGA,133,150,17,15,7530,4,0
8116,ACGTCGAATCTAGGGA,133,170,37,17,7531,10,0
8117,ACGTCGAATCTAGGGA,133,137,4,18,7532,0,0
8118,ACGTCGAATCTAGGGA,133,138,5,16,7534,0,0
8119,ACGTCGAATCTAGGGA,133,146,13,18,7535,2,0
8120,ACGTCGAATCTAGGGA,133,141,8,14,7684,1,0
8121,ACGTCGAATCTAGGGA,133,138,5,16,7686,0,0
8122,ACGTCGAATCTAGGGA,133,144,11,10,7689,2,0
8123,ACGTCGAATCTAGGGA,133,143,10,16,7690,1,0
8124,ACGTCGAATCTAGGGA,133,176,43,17,7691,12,0
8125,ACGTAGAATCTAGGGA,133,143,10,15,7692,1,0
8126,ACGTCGAATCTAGGGA,133,136,3,10,7693,0,0
8127,ACGTCGAATCTAGGGA,133,136,3,16,7782,0,0
8128,ACGTCGAATCTAGGGA,133,133,0,15,7783,0,0
8129,ACGTCGAATCTAGGGA,133,136,3,11,7785,0,0
8130,ACGTCGAATCTAGGGA,133,134,1,18,7786,0,0
8131,ACGTCGAATCTAGGGA,133,136,3,11,7787,0,0
8132,ACGTCGAATCTAGGGA,133,136,3,17,7788,0,0
8133,ACGTCGAATCTAGGGA,134,141,7,15,5124,0,0
8134,ACGTCGAATCTAGGGA,134,137,3,14,6201,0,0
8135,ACGTTGAATCTAGGGA,134,137,3,12,6349,0,0
8136,ACGTAGAATCTAGGGA,134,150,16,12,6703,3,0
8137,ACGTCGAATCTAGGGA,134,148,14,17,6921,3,0
8138,ACGTCTAATCTAGGGA,134,144,10,17,7034,1,0
8139,ACGTCGAATCTAGGGA,134,155,21,16,7062,5,0
8140,ACGTCGAATCTAGGGA,134,161,27,12,7073,7,0
8141,ACGTCGAATCTAGGGA,134,137,3,19,7084,0,0
8142,ACGTAGAATCTAGGGA,134,153,19,14,7086,4,0
8143,ACGTCGAATCTAGGGA,134,137,3,15,7093,0,0
8144,ACGTCGAATCAAGGGA,134,135,1,12,7223,0,0
8145,ACGTCGAATCTAGGGA,134,137,3,17,7227,0,0
8146,ACGTCGAATCTAGGGA,134,137,3,12,7329,0,0
8147,ACGTCGAATCTAGGGA,134,137,3,16,7332,0,0
8148,ACGTCGAATCTAGGGA,134,137,3,17,7333,0,0
8149,ACGTCGAATCTAGGGA,134,137,3,16,7336,0,0
8150,ACGTCGAATCTAGAGA,134,137,3,11,7358,0,0
8151,ACGTCGAATCTAGGGA,134,137,3,17,7363,0,0
8152,ACGTCGAATCTAGGGA,134,137,3,12,7497,0,0
8153,ACGTCGAATCTAGGGA,134,134,0,12,7499,0,0
8154,ACGTCGAATCTAGGGA,134,137,3,16,7505,0,0
8155,ACGTCGAATCTAGGGA,134,137,3,15,7506,0,0
8156,ACGTCGAATCTAGGGA,134,134,0,14,7509,0,0
8157,ACGTCGAATCTAGGGA,134,137,3,10,7510,0,0
8158,ACGTCGAATCTAGGGA,134,137,3,16,7511,0,0
8159,ACGTCTAATCTAGGGA,134,134,0,17,7513,0,0
8160,ACGTCGAATCTAGGGA,134,137,3,11,7520,0,0
8161,ACGTCGAATCTAGGGA,134,134,0,10,7548,0,0
8162,ACGTCGATTCTAGGGA,134,137,3,16,7550,0,0
8163,ACGTCGAATCTAGGGA,134,137,3,11,7551,0,0
8164,ACGTCGATTCTAGGGA,134,135,1,13,7552,0,0
8165,ACGTCGAATCTAGGGA,134,137,3,19,7554,0,0
8166,ACGTCGAATCTAGGGA,134,137,3,17,7557,0,0
8167,ACGTCGAATCTAGGGA,134,137,3,16,7558,0,0
8168,ACGTCGAATCTAGGGA,134,137,3,17,7562,0,0
8169,ACGTCGAATCTAGGGA,134,137,3,15,7563,0,0
8170,ATGTCGAATCTAGGGA,134,137,3,15,7564,0,0
8171,ACGTCGAATCTAGGGA,134,137,3,15,7565,0,0
8172,ACGTCGAATCTAGGGA,134,135,1,17,7566,0,0
8173,ACGTCGAATCTAGGGA,134,137,3,14,7567,0,0
8174,ACGTCGAATCTAGGGA,134,137,3,18,7568,0,0
8175,ACGTCGAATCTAGGGA,134,137,3,17,7570,0,0
8176,ACGTCGAATCTAGGGA,134,135,1,15,7571,0,0
8177,ACGTCGAATCTAGGGA,134,137,3,12,7676,0,0
8178,ACGTCGAATCTAGGGA,134,137,3,16,7677,0,0
8179,ACGTCGAATCTAGGGA,134,137,3,17,7679,0,0
8180,ACGTCGAATCTAGGGA,134,137,3,15,7681,0,0
8181,ACGTCGAATCTCGGGA,134,137,3,18,7682,0,0
8182,ACGTCGAATCTAGGGA,134,137,3,16,7732,0,0
8183,ACGTCGAATCTAGGGA,134,137,3,16,7738,0,0
8184,ACGTCGAATCTAGGGA,134,137,3,16,7740,0,0
8185,ACGTCGAATCTAGGGA,134,134,0,17,7742,0,0
8186,ACGTCGAATCTAGGGA,134,137,3,14,7746,0,0
8187,ACGTCGAATCTAGGGA,134,137,3,18,7749,0,0
8188,ACGTCGAATCTAGGGA,134,134,0,13,7753,0,0
8189,ACGTCGAATCTAGGGA,134,134,0,18,7755,0,0
8190,ACGTCGAATCTAGGGA,134,137,3,12,7756,0,0
8191,ACGTCGAATCTAGGGA,134,137,3,10,7757,0,0
8192,ACGTCGAATCTAGGGA,134,137,3,13,7758,0,0
8193,ACGTCGAATCTAGGGA,134,135,1,17,7761,0,0
8194,ACGTCGAATCTAGGGA,134,134,0,17,7762,0,0
8195,ACGTCGAATCTAGGGA,134,137,3,14,7767,0,0
8196,ACGTCGAATCTAGGGA,134,137,3,15,7768,0,0
8197,ACGTCGAATCTAGGAA,134,136,2,14,7772,0,0
8198,ACGTCGAATCTAGGGA,134,135,1,17,7778,0,0
8199,ACGTCGATTCTAGGGA,134,137,3,18,7779,0,0
8200,ACGTCGAATCTAGGGA,135,139,4,15,6060,0,0
8201,ACGTCGAATCTAGGGA,135,146,11,9,6396,2,0
8202,ACGTCGAATCTAGGGA,135,163,28,13,6587,7,0
8203,ACGTCGAATCTAGGGA,135,138,3,9,6747,0,0
8204,ACGTCGAATCTAGGGA,135,139,4,15,6756,0,0
8205,ACGTCGAATCTAGGGA,135,140,5,16,6771,0,0
8206,ACGTCGAATCTAGGGA,135,150,15,9,6937,3,0
8207,ACGTCGAATCTAGGGA,135,151,16,16,6941,3,0
8208,ACGTCGAATCTAGGGA,135,136,1,11,6957,0,0
8209,ACGTCGAATCTAGGGA,135,166,31,15,6970,8,0
8210,ACGTCGAATCTAGGGA,135,137,2,17,6976,0,0
8211,ACGTCGAATCTAGGGA,135,148,13,19,7118,2,0
8212,ACGTCGAATCGAGGGA,135,146,11,16,7286,2,0
8213,ACGTCGAATCTAGGGA,135,147,12,12,7287,2,0
8214,ACGTCGAATCTAGGGA,135,138,3,11,7299,0,0
8215,ACGTCGAATCTAGGGA,135,140,5,11,7304,0,0
8216,ACGTCGAATCTAGGGA,135,139,4,17,7305,0,0
8217,ACGTCGAATCTAGGGA,135,140,5,13,7306,0,0
8218,ACGTCGAATCTAGGGA,135,152,17,17,7308,4,0
8219,ACGTAGAATCTAGGGA,135,158,23,13,7310,6,0
8220,ACGTCGAATCTAGGGA,135,145,10,17,7317,1,0
8221,ACGTCGAATCTAGGGA,135,170,35,15,7446,10,0
8222,ACGTCGAATCTAGGGA,135,149,14,16,7447,3,0
8223,ACGTCGAATCTAGGGA,135,135,0,19,7448,0,0
8224,ACGTCGAATCTAGGGA,135,140,5,14,7458,0,0
8225,ACGTCGAATCTAGGGA,135,142,7,18,7462,0,0
8226,ACGTCGAATCTAGGGA,135,159,24,11,7464,6,0
8227,ACGTAGAATCTAGGGA,135,136,1,13,7469,0,0
8228,ACGTCGAATCTAGGGA,135,138,3,11,7470,0,0
8229,ACGTCGAATCTAGGGA,135,135,0,13,7474,0,0
8230,ACGTCGAATCTAGGGA,135,136,1,18,7479,0,0
8231,ACGTCTAATCTAGGGA,135,140,5,18,7480,0,0
8232,ACGTAGAATCTAGGGA,135,153,18,15,7488,4,0
8233,ACGTCGAATCTAGGGA,135,143,8,18,7572,1,0
8234,ACGTCGAATCTAGGGA,135,153,18,13,7619,4,0
8235,ACGTCGAATCTAGGGA,135,154,19,11,7624,4,0
8236,ACGTCGAATCTAGGGA,135,135,0,17,7625,0,0
8237,ACGTCGTATCTAGGGA,135,148,13,13,7627,2,0
8238,ACGTCGAATCTAGGGA,135,137,2,18,7630,0,0
8239,ACGTCGAATCTAGGGA,135,135,0,14,7631,0,0
8240,ACGTCGAATCTAGAGC,135,153,18,18,7636,4,0
8241,ACGTCGAATCTAGGGA,135,147,12,18,7638,2,0
8242,ACGTCGAATCTAGGGA,135,140,5,17,7641,0,0
8243,ACGTCGAATCTAGGGA,135,141,6,12,7643,0,0
8244,ACGTCGAATCTAGGGA,135,137,2,17,7647,0,0
8245,ACGTCGAATCTAGGGA,135,143,8,16,7652,1,0
8246,ACGTCGAATCTAGGGA,135,142,7,18,7656,0,0
8247,ACGTCGAATCTAGGGA,135,135,0,13,7657,0,0
8248,ACGTCGAATCTAGGGA,135,175,40,17,7659,11,0
8249,ACGTCGAATCTAGGGA,135,148,13,16,7661,2,0
8250,ACGTCGAATCTAGGGA,135,139,4,18,7664,0,0
8251,ACGTCGACTCTAGGGA,135,145,10,16,7665,1,0
8252,ACGTCGAATCTAGGGA,135,135,0,17,7670,0,0
8253,ACGTCGAATCTAGGGA,135,135,0,13,7789,0,0
8254,ACGTAGGATCTAGGGA,135,138,3,13,7790,0,0
8255,ACGTCGAATCTAGGGA,135,149,14,16,7903,3,0
8256,ACGTCGAATCTAGGGA,135,135,0,16,7904,0,0
8257,ACGTCGATTCTAGGGA,135,136,1,13,7906,0,0
8258,ACGTCGATTCTAGGGA,136,138,2,12,6316,0,0
8259,ACGTCGAATCTAGGGA,136,181,45,15,6571,14,0
8260,ACGTCGAATCTAGGGA,136,165,29,16,6658,8,0
8261,ACGTCGAATCTAGGGA,136,137,1,14,6687,0,0
8262,ACGTCGAATCTAGGGA,136,139,3,14,6816,0,0
8263,ACGTCGAATCTAGGGA,136,150,14,13,6831,3,0
8264,ACGTCGAATCTAGGGA,136,143,7,17,6844,0,0
8265,ACGTCGAATCTAGGGA,136,136,0,15,6855,0,0
8266,ACGTCGAATCTATGGA,136,146,10,16,6867,1,0
8267,ACGTCGAATCTAGGGA,136,142,6,16,7011,0,0
8268,ACGTCGAATCTAGGGA,136,144,8,17,7022,1,0
8269,ACGTCGAATCTAGGGA,136,153,17,11,7031,4,0
8270,ACGTCGAATCTAGGGA,136,137,1,9,7114,0,0
8271,ACGTCGAATCTAGGGA,136,142,6,12,7164,0,0
8272,ACGTCGTATCTAGGGA,136,143,7,17,7174,0,0
8273,ACGTCGAATCTAGGGA,136,136,0,16,7180,0,0
8274,ACGTCGCATCTAGGGA,136,154,18,15,7182,4,0
8275,ACGTCGAATCTAGGGA,136,158,22,20,7188,5,0
8276,ACGTCGAATCTAGGGA,136,136,0,15,7191,0,0
8277,ACGTCGAATCTAGGGA,136,143,7,16,7205,0,0
8278,ACGTCGAATCTAGGGA,136,151,15,16,7209,3,0
8279,ACGTCGAATCTAGGAA,136,144,8,13,7210,1,0
8280,ACGTCGAATCTAGGGA,136,138,2,17,7217,0,0
8281,ACGTCGAATCTAGGGA,136,136,0,12,7219,0,0
8282,ACGTCGAATCTAGGGA,136,150,14,17,7365,3,0
8283,ACGTCGAATCTAGGGA,136,139,3,17,7369,0,0
8284,ACGTCGAATCTAGGGA,136,139,3,17,7525,0,0
8285,ACGTCGAATCTAGGGA,136,173,37,15,7530,10,0
8286,ACGTCGAATCTAGGGA,136,147,11,17,7531,2,0
8287,ACGTCGAATCTAGTGA,136,145,9,16,7534,1,0
8288,ACGTCGAATCTAGGGA,136,146,10,18,7535,1,0
8289,ACGTCGAATCTAGGGA,136,138,2,10,7689,0,0
8290,ACGTCGAATCTAGGGA,136,139,3,16,7690,0,0
8291,ACGTCGAATCTAGGGA,136,147,11,17,7691,2,0
8292,ACGTCGAATCTAGGGA,136,146,10,10,7693,1,0
8293,ACGTCGAATCTAGGGA,136,136,0,16,7782,0,0
8294,ACGTCGAATCTAGGGA,136,202,66,18,7786,20,0
8295,ACGTCGAATCTAGGGA,136,157,21,17,7788,5,0
8296,ACGTCGAATCTAGGGA,136,136,0,17,7848,0,0
8297,ACGTCGAATCTAGGGA,136,151,15,14,7852,3,0
8298,ACGTCGAATCTAGGGA,136,141,5,17,7857,0,0
8299,ACGTCGAATCTAGGGA,136,149,13,16,7861,2,0
8300,ACGTCGAATCTAGGGA,136,144,8,18,7862,0,0
8301,ACGTCGAATCTAGGGA,136,144,8,16,7863,0,0
8302,ACGTCGAATCTAGGGA,136,137,1,15,7866,0,0
8303,ACGTCGACTCTAGGGA,136,153,17,14,7869,3,0
8304,ACGTCGAATCTCGGGA,136,145,9,14,7873,0,0
8305,ACGTCGAATCTAGGTA,136,140,4,12,7874,0,0
8306,ACGTACAATCTAGGGA,136,137,1,14,7876,0,0
8307,ACGTCGAATCTAGGGA,136,144,8,19,7877,0,0
8308,ACGTCGAATCTAGGGA,136,140,4,18,7878,0,0
8309,ACGTCGAATCTAGGGA,136,139,3,21,7879,0,0
8310,ACGTCGAATCTAGGGA,136,139,3,16,7880,0,0
8311,ACGTCGAATCTAGGGA,136,139,3,17,7881,0,0
8312,ACGTCGAATCTAGGGA,136,139,3,15,7884,0,0
8313,ACGTCGAATCTAGGGA,136,138,2,19,7887,0,0
8314,ACGTCGAATCTAGGGA,136,139,3,12,7888,0,0
8315,ACGTCGAATCTAGGGA,136,139,3,18,7890,0,0
8316,ACGTCGAATCTAGGGA,136,139,3,18,7895,0,0
8317,ACGTCTAATCTAGGGA,136,139,3,19,7897,0,0
8318,ACGTCGAATCTAGGGA,136,139,3,17,7900,0,0
8319,ACGTCGAATCTAGGGA,136,139,3,17,7901,0,0
8320,ACGTCGAATCTAGGGA,136,139,3,17,7902,0,0
8321,ACGTCGAATCTAGGGA,137,153,16,15,5124,3,0
8322,ACGTCGAATCTAGGGA,137,145,8,14,6201,1,0
8323,ACGTCGAATCTAGGGA,137,148,11,12,6349,2,0
8324,ACGTCTAATCTAGGGA,137,140,3,17,7034,0,0
8325,ACGTCGAATCTAGGGA,137,156,19,16,7062,4,0
8326,ACGTCGAATCTAGGGA,137,142,5,12,7073,0,0
8327,ACGTCGAATCTAGGGA,137,141,4,15,7093,0,0
8328,ACGTCGAATCTAGGGA,137,137,0,17,7227,0,0
8329,ACGTCGAATCTAGGGA,137,140,3,12,7329,0,0
8330,ACGTCGAATCTAGGGA,137,154,17,16,7332,4,0
8331,ACGTCGAATCTAGGGA,137,155,18,17,7333,4,0
8332,ACGTCGAATCTAGGGA,137,153,16,16,7336,3,0
8333,ACGTCGAATCTAGGGA,137,143,6,11,7358,0,0
8334,ACGTCGAATCTAGGGA,137,137,0,12,7497,0,0
8335,ACGTCGAATCTAGGGA,137,157,20,12,7499,5,0
8336,ACGTCGAATCTAGGGA,137,193,56,16,7505,16,0
8337,ACGTCGAATCTAGGGA,137,140,3,10,7510,0,0
8338,ACGTCTAATCTAGGGA,137,140,3,17,7513,0,0
8339,ACGTCGAATCTAGGGA,137,140,3,11,7520,0,0
8340,ACGTCGAATCTAGGGA,137,140,3,10,7548,0,0
8341,ACGTCGATTCTAGGGA,137,140,3,13,7552,0,0
8342,ACGTCGAATCTAGGGA,137,140,3,19,7554,0,0
8343,ACGTCGAATCTAGGGA,137,140,3,17,7557,0,0
8344,ACGTCGAATCTAGGGA,137,140,3,15,7563,0,0
8345,ATGTCGAATCTAGGGA,137,137,0,15,7564,0,0
8346,ACGTCGAATCTAGGGA,137,139,2,15,7565,0,0
8347,ACGTCGAATCTAGGGA,137,140,3,17,7566,0,0
8348,ACGTCGAATCTAGGGA,137,140,3,18,7568,0,0
8349,ACGTCGAATCTAGGGA,137,138,1,15,7571,0,0
8350,ACGTCGAATCTAGGGA,137,139,2,16,7677,0,0
8351,ACGTCGAATCTAGGGA,137,138,1,17,7679,0,0
8352,ACGTCGAATCTCGGGA,137,138,1,18,7682,0,0
8353,ACGTCGAATCTAGGGA,137,139,2,16,7738,0,0
8354,ACGTCGAATCTAGGGA,137,140,3,17,7742,0,0
8355,ACGTCGAATCTAGGGA,137,140,3,14,7746,0,0
8356,ACGTCGAATCTAGGGA,137,140,3,18,7749,0,0
8357,ACGTCGAATCTAGGGA,137,139,2,13,7753,0,0
8358,ACGTCGAATCTAGGGA,137,140,3,18,7755,0,0
8359,ACGTCGAATCTAGGGA,137,140,3,12,7756,0,0
8360,ACGTCGAATCTAGGGA,137,140,3,10,7757,0,0
8361,ACGTCGAATCTAGGGA,137,140,3,13,7758,0,0
8362,ACGTCGAGTCTAGGGA,137,140,3,17,7761,0,0
8363,ACGTCGAATCTAGGGA,137,139,2,17,7762,0,0
8364,ACGTCGAATCTAGGGA,137,140,3,14,7767,0,0
8365,ACGTCGAATCTAGGGA,137,137,0,15,7768,0,0
8366,ACGTCGAATCTAGGGA,137,140,3,17,7778,0,0
8367,ACGTCGAATCTAGGGA,137,139,2,18,7779,0,0
8368,ACGTCGAATCTAGGGA,137,140,3,16,7910,0,0
8369,ACGTCGAATCTAGGGA,137,140,3,17,7912,0,0
8370,ACGTCGAATCTAGGGA,137,138,1,17,7915,0,0
8371,ACGTCGAATCTAGGGA,137,140,3,14,7916,0,0
8372,ACGTAGAATCTAGGGA,137,137,0,18,7917,0,0
8373,ACGTCGAATCTAGGGA,137,140,3,18,7919,0,0
8374,ACGTCTAATCTAGGGA,137,140,3,18,7921,0,0
8375,ACGTCGAATCTAGGGA,137,140,3,10,7927,0,0
8376,ACGTCGTATCTAGGGA,137,137,0,18,7929,0,0
8377,ACGTCGCATCTAGGGA,137,140,3,16,7932,0,0
8378,ACGTCGAATCTAGGGA,137,138,1,21,7933,0,0
8379,ACGTCGAATCTAGGGA,138,151,13,15,6060,2,0
8380,ACGTCGAATCTAGGGA,138,144,6,9,6396,0,0
8381,ACGTCGAATCTAGGGA,138,142,4,13,6587,0,0
8382,ACGTCGAATCTAGGGA,138,163,25,9,6747,6,0
8383,ACGTCGAATCTAGGGA,138,143,5,15,6756,0,0
8384,ACGTCGAATCTACGGA,138,142,4,9,6937,0,0
8385,ACGTCGAATCTAGGGA,138,145,7,11,6957,0,0
8386,ACGTCGAATCTAGGGA,138,140,2,15,6970,0,0
8387,ACGTCGAATCTAGGGA,138,164,26,19,7118,7,0
8388,ACGTCGAATCGAGGGA,138,151,13,16,7286,2,0
8389,ACGTCGAATCTAGGGA,138,140,2,12,7287,0,0
8390,ACGTCGAATCTAGAGA,138,138,0,11,7299,0,0
8391,ACGTCGAATCTAGGGA,138,140,2,11,7304,0,0
8392,ACGTCGAATCTAGGGA,138,144,6,17,7308,0,0
8393,ACGTCGAATCTAGGGA,138,138,0,15,7446,0,0
8394,ACGTCGAATCTAGGGA,138,145,7,16,7447,0,0
8395,ACGTCGAATCTAGGGA,138,138,0,18,7462,0,0
8396,ACGTCGAATCTAGGGA,138,147,9,11,7464,1,0
8397,ACGTAGAATCTAGGGA,138,148,10,13,7469,1,0
8398,ACGTCGAATCTAGGGA,138,154,16,13,7474,3,0
8399,ACGTCGAATCTAGGGA,138,152,14,18,7479,3,0
8400,ACGTCTAATCTAGGGA,138,151,13,18,7480,2,0
8401,ACGTCGAATCTAGGGA,138,149,11,13,7619,2,0
8402,ACGTCGAATCTAGGGA,138,144,6,11,7624,0,0
8403,ACGTCGAATCTAGGGA,138,138,0,17,7625,0,0
8404,ACGTCGTATCTAGGGA,138,145,7,13,7627,0,0
8405,ACGTCGAATCTAGGGA,138,141,3,14,7631,0,0
8406,ACGTCGAATCTAGGGC,138,138,0,18,7636,0,0
8407,ACGTCGAATCTAGGGA,138,144,6,17,7641,0,0
8408,ACGTTGAATCTAGGGA,138,147,9,12,7643,1,0
8409,ACGTCGAATCTAGGGA,138,140,2,17,7647,0,0
8410,ACGTTGAATCTAGGGA,138,141,3,16,7652,0,0
8411,ACGTCGAATCTAGGGA,138,139,1,18,7656,0,0
8412,ACGTCGAATCTAGGGA,138,145,7,13,7657,0,0
8413,ACGTCGAATCTAGGGA,138,177,39,16,7661,11,0
8414,ACGTCGAATCTAGGGA,138,141,3,18,7664,0,0
8415,ACGTCGAATCTAGGGA,138,141,3,16,7665,0,0
8416,ACGTCGAATCTAGGGA,138,142,4,13,7789,0,0
8417,ACGTCGAATCTAGGGA,138,157,19,16,7903,4,0
8418,ACGTCGAATCTAGGGA,138,150,12,16,7904,1,0
8419,ACGTCGATTCTAGGGA,138,138,0,13,7906,0,0
8420,ACGTCGAATCTAGGGA,138,140,2,15,7955,0,0
8421,ACGTCTAATCTAGGGA,138,138,0,18,7962,0,0
8422,ACGTCGAATCTAGGGA,138,138,0,13,7964,0,0
8423,ACGTCGAATCTAGGGA,138,138,0,20,7965,0,0
8424,ACGTAGAATCTAGGGA,138,138,0,15,7966,0,0
8425,ACGTCGAATCTAGGGA,138,140,2,16,7967,0,0
8426,ACGTCGAATCTAGGGA,138,138,0,13,7968,0,0
8427,ACGTCGAATCTAGGGA,138,146,8,18,7971,0,0
8428,ACGTCGAATCTAGGGA,138,162,24,17,7974,5,0
8429,ACGTCGAATCTAGGGA,138,146,8,13,7981,0,0
8430,ACGTCGAATCTAGGGA,138,146,8,13,7982,0,0
8431,ACGTCGAATCTAGGGA,138,146,8,16,7985,0,0
8432,ACGTCGAATCTAGGGA,138,141,3,11,7988,0,0
8433,ACGTCGAATCTGGGGA,138,143,5,17,7989,0,0
8434,ACGTCGATTCTAGGGA,139,148,9,12,6316,1,0
8435,ACGTCGAATCTAGGGA,139,147,8,15,6571,1,0
8436,ACGTCGAATCTAGGGA,139,140,1,16,6658,0,0
8437,ACGTCGAATCTAGGGA,139,148,9,14,6816,1,0
8438,ACGTCGAATCTAGGGA,139,143,4,13,6831,0,0
8439,ACGTCGAATCTAGGGA,139,142,3,17,6844,0,0
8440,ACGTCGAATCTAGGGA,139,142,3,15,6855,0,0
8441,ACGTCGAATCTATGGA,139,139,0,16,6867,0,0
8442,ACGTCGAATCTAGGGA,139,142,3,16,7011,0,0
8443,ACGTCGAATCTAGGGA,139,142,3,17,7022,0,0
8444,ACGTCGAATCTAGGGA,139,141,2,11,7031,0,0
8445,ACGTCGTATCTAGGGA,139,142,3,17,7174,0,0
8446,ACGTCGCATCTAGGGA,139,142,3,16,7180,0,0
8447,ACGTCGCATCTAGGGA,139,142,3,15,7182,0,0
8448,ACGTCGAATCTAGGGA,139,142,3,15,7191,0,0
8449,ACGTCGAATCTAGGGA,139,142,3,16,7205,0,0
8450,ACGTCGAATCTAGGGA,139,139,0,16,7209,0,0
8451,ACGTCGAATCTAGGGA,139,142,3,17,7217,0,0
8452,ACGTCGAATCTAGGGA,139,142,3,12,7219,0,0
8453,ACGTCGAATCTAGGGA,139,139,0,17,7365,0,0
8454,ACGTCGAATCTAGGGA,139,139,0,17,7369,0,0
8455,ACGTCGAATCTAGGGA,139,139,0,17,7525,0,0
8456,ACGTCGAATCCAGGGA,139,142,3,15,7530,0,0
8457,ACGTCGAATCTAGGGA,139,140,1,17,7531,0,0
8458,ACGTCGAATCTAGGGA,139,141,2,18,7535,0,0
8459,ACGTCGAATCTAGGGA,139,139,0,16,7690,0,0
8460,ACGTCGAATCTAGGGA,139,142,3,17,7691,0,0
8461,ACGTCGAATCTAGGGA,139,140,1,10,7693,0,0
8462,ACGTCGAATCTAGGGA,139,142,3,16,7782,0,0
8463,ACGTCGAATCTAGGGA,139,141,2,18,7786,0,0
8464,ACGTCGAATCTAGGGA,139,141,2,17,7788,0,0
8465,ACGTCGAATCTAGGGA,139,141,2,14,7852,0,0
8466,ACGTCGAATCTAGGGA,139,142,3,17,7857,0,0
8467,ACGTCGAATCTAGGGA,139,141,2,15,7866,0,0
8468,ACGTCGACTCTAGGGA,139,142,3,14,7869,0,0
8469,ACGTCGAATCGAGGGA,139,139,0,14,7873,0,0
8470,ACGTCGAATCTAGGGA,139,142,3,12,7874,0,0
8471,ACGTAGAATCTAGGGA,139,142,3,14,7876,0,0
8472,ACGTCGAATCTAGGGA,139,141,2,19,7877,0,0
8473,ACGTCGAATCTAGGGA,139,141,2,16,7880,0,0
8474,ACGTCGAATCCAGGGA,139,140,1,15,7884,0,0
8475,ACGTCGAATCTAGGGA,139,142,3,19,7887,0,0
8476,ACGTCGAATCTAGGGA,139,142,3,12,7888,0,0
8477,ACGTTGAATCTAGGGA,139,142,3,18,7890,0,0
8478,ACGTCTAATCTAGGGA,139,142,3,19,7897,0,0
8479,ACGTCGAATCTAGGGA,139,142,3,17,7901,0,0
8480,ACGTCGAATCTAGGGA,139,140,1,10,8019,0,0
8481,ACGTCGAATCTAGGGA,139,142,3,10,8021,0,0
8482,ACGTCGAATCTAGGGA,139,142,3,16,8022,0,0
8483,ACGTCGAATCTAGGGA,139,142,3,17,8023,0,0
8484,ACGTCGAATCTAGGGA,139,142,3,10,8024,0,0
8485,ACGTCGAATCTAGGGA,139,142,3,12,8026,0,0
8486,ACGTCGAATCTAGGGA,139,142,3,16,8027,0,0
8487,ACGTCGAATCTAGGGA,139,142,3,18,8028,0,0
8488,ACGTCGAATTTAGGGA,139,141,2,20,8029,0,0
8489,ACGTCGAATCGAGGGA,139,142,3,17,8030,0,0
8490,ACGTCGAGTCTAGGGA,139,142,3,18,8038,0,0
8491,ACGTCGAATCTAGGGA,140,140,0,14,6201,0,0
8492,ACGTCGAATCTAGGGA,140,149,9,12,6349,1,0
8493,ACGTCTAATCTAGGGA,140,142,2,17,7034,0,0
8494,ACGTCGAATCTAGGGA,140,142,2,12,7073,0,0
8495,ACGTCTAATCTAGGGA,140,146,6,12,7329,0,0
8496,ACGTCGAATCTAGGGA,140,144,4,16,7332,0,0
8497,ACGTCGAATCTAGGGA,140,160,20,17,7333,5,0
8498,ACGTCGAATCTAGGGA,140,161,21,16,7336,5,0
8499,ACGTCGAATCTAGGGA,140,141,1,12,7497,0,0
8500,ACGTCGAATCTAGGGA,140,154,14,12,7499,3,0
8501,ACGTCGAATCTAGGGA,140,141,1,16,7505,0,0
8502,ACGTCGAATCTAGGGA,140,151,11,10,7510,2,0
8503,ACGTCTAATCTAGGGA,140,140,0,17,7513,0,0
8504,ACGTCGAATCTAGGGA,140,144,4,10,7548,0,0
8505,ACGTCGATTCTAGGGA,140,142,2,13,7552,0,0
8506,ACGTCGAATCTAGGGA,140,160,20,19,7554,5,0
8507,ACGTCGAATCTAGAGA,140,142,2,17,7557,0,0
8508,ACGTCGAATCTAGGGA,140,146,6,15,7563,0,0
8509,ATGTCGAATCTAGGGA,140,140,0,15,7564,0,0
8510,ACGTCGAATCTAGGGA,140,140,0,15,7565,0,0
8511,ACGTCGAATCTAGGGA,140,143,3,17,7566,0,0
8512,ACGTCGAATCTAGGGA,140,145,5,15,7571,0,0
8513,ACGTCGAATCTAGGGA,140,140,0,16,7677,0,0
8514,ACGTCGAATCTCGGGA,140,167,27,18,7682,7,0
8515,ACGTCGAATCTAGGGA,140,149,9,17,7742,1,0
8516,ACGTCGAATCTAGGGA,140,163,23,14,7746,6,0
8517,ACGTCGAATCTAGGGA,140,142,2,18,7749,0,0
8518,ACGTCGAATCTAGGGA,140,167,27,13,7753,7,0
8519,ACGTCGAATCTAGGGA,140,144,4,18,7755,0,0
8520,ACGTCGAATCTAGGGA,140,145,5,12,7756,0,0
8521,ACGTCGAATCTAGGGA,140,168,28,13,7758,7,0
8522,ACGTCGAATCTAGGGA,140,149,9,17,7761,1,0
8523,ACGTCGAATCTAGGGA,140,151,11,17,7762,2,0
8524,ACGTCGAATCTAGGGA,140,141,1,14,7767,0,0
8525,ACGTCGAATCTAGGGA,140,158,18,15,7768,4,0
8526,ACGTCGAATCTAGGGA,140,147,7,17,7778,0,0
8527,ACGTCGAATCTAGGGA,140,152,12,18,7779,2,0
8528,CCGTCGAATCTAGGGA,140,148,8,16,7910,1,0
8529,ACGTCGAATCTAGGGA,140,156,16,17,7915,3,0
8530,ACGTCGAATCTAGGGA,140,150,10,14,7916,1,0
8531,ACGTCGAATCTAGGGA,140,143,3,18,7917,0,0
8532,ACGTCTAATCTAGGGA,140,149,9,18,7921,1,0
8533,ACGTCGAATCTAGGGA,140,146,6,10,7927,0,0
8534,ACGTCGTATCTAGGGA,140,142,2,18,7929,0,0
8535,ACGTCGAATCTAGGGA,140,160,20,21,7933,5,0
8536,ACGTCGAATCTAGGGA,140,152,12,16,7990,2,0
8537,AGGTCTAATCTAGGGA,140,141,1,18,7991,0,0
8538,ACGTCGAATCTAGGGA,140,155,15,16,8080,3,0
8539,ACGTCGATTCTAGGGA,140,142,2,13,8081,0,0
8540,ACGTCGAATCTAGGGA,140,146,6,17,8085,0,0
8541,ACGTCGAATCTAGGGA,140,150,10,18,8089,1,0
8542,ACGTCGAATCTAGGGA,140,142,2,18,8091,0,0
8543,ACGTCTAATCTAGGGA,140,142,2,18,8093,0,0
8544,ACGTCGAATCTATGGA,140,141,1,17,8094,0,0
8545,ACGTCTAATCTAGGGA,140,141,1,17,8095,0,0
8546,ACGTCGAATCTAGGGA,140,161,21,12,8097,5,0
8547,ACGTCGAATCTAGGGA,140,170,30,13,8099,8,0
8548,ACGTCGTATCTAGGGA,140,140,0,18,8100,0,0
8549,ACGTCGCATCTAGGGA,140,146,6,16,8102,0,0
8550,ACGTCGAACCTAGGAA,140,141,1,14,8108,0,0
8551,ACGTCGAATCTAGGGA,140,143,3,18,8109,0,0
8552,ACGTCGAATCTAGGGA,140,148,8,18,8111,1,0
8553,ACGTCGAATCTGGGGA,140,144,4,17,8112,0,0
8554,ACGTCGAATCTAGGGA,140,145,5,18,8113,0,0
8555,ACGTCGAATCTAGGGA,140,147,7,18,8114,0,0
8556,ACGTCGAATCTAGGGA,140,151,11,16,8115,1,0
8557,ACGTCGAATCTAGGGA,140,144,4,18,8116,0,0
8558,ACGTCGAATCTAGGGA,140,168,28,19,8119,7,0
8559,ACGTCGAATCTAGGGA,140,141,1,15,8120,0,0
8560,ACGTCGAATCTAGGGA,140,140,0,11,8122,0,0
8561,ACGTCGAATCTAGGGA,140,183,43,17,8123,12,0
8562,ACGTCGAATCTAGGGA,140,145,5,18,8124,0,0
8563,ACGTAGAATCTAGGGA,140,145,5,16,8125,0,0
8564,ACGTCGAATCTAGGGA,141,148,7,15,6060,0,0
8565,ACGTCGAATCTAGGGA,141,143,2,9,6396,0,0
8566,ACGTCGAATCTAGGGA,141,142,1,13,6587,0,0
8567,ACGTCGAATCTAGGGA,141,144,3,15,6756,0,0
8568,ACGTCGAATCTAGGGA,141,150,9,9,6937,1,0
8569,ACGTCGAATCTAGGGA,141,150,9,11,6957,1,0
8570,ACGTAGAATCTAGGGA,141,148,7,12,7287,0,0
8571,ACGTCGAATCTAGGGA,141,142,1,11,7299,0,0
8572,ACGTCGAATCTAGGGA,141,174,33,11,7304,9,0
8573,ACGTCGAATCTAGGGA,141,148,7,17,7308,0,0
8574,ACGTCGAATCTAGGGA,141,156,15,16,7447,3,0
8575,ACGTCGAATCTAGGGA,141,146,5,18,7462,0,0
8576,ACGTCGAATCTAGGGA,141,161,20,11,7464,5,0
8577,ACGTCGAATCTAGGGA,141,154,13,13,7474,2,0
8578,ACGTCGAATCTAGGGA,141,144,3,18,7479,0,0
8579,ACGTCGAATCTAGGGA,141,144,3,13,7619,0,0
8580,ACGTCGAATCTAGGGA,141,141,0,11,7624,0,0
8581,ACGTCGTATCTAGGGA,141,144,3,13,7627,0,0
8582,ACGTCGAATCTAGGGA,141,143,2,14,7631,0,0
8583,ACGTCGAATCTAGGGA,141,144,3,17,7641,0,0
8584,ACGTCGAATCTAGGGA,141,144,3,17,7647,0,0
8585,ACGTCGAATCTAGGGA,141,142,1,16,7652,0,0
8586,ACGTCGAATCTAGGGA,141,144,3,16,7661,0,0
8587,ACGTCGAATCTAGGGA,141,144,3,16,7665,0,0
8588,ACGTCGAATCTAGGGA,141,144,3,13,7789,0,0
8589,ACGTCGAATCTAGGGA,141,144,3,16,7903,0,0
8590,ACGTCGAATCTAGGGA,141,143,2,16,7904,0,0
8591,ACGTCGATTCTAGGGA,141,142,1,13,7906,0,0
8592,ACGTCGAATCTAGGGA,141,144,3,13,7964,0,0
8593,ACGTCGAATCTAGGGA,141,144,3,20,7965,0,0
8594,ACGTAGAATCTAGGGA,141,141,0,15,7966,0,0
8595,ACGTCGAATCTAGGGA,141,141,0,16,7967,0,0
8596,ACGTCGAATCTAGGGA,141,144,3,13,7968,0,0
8597,ACGTCGAATCTAGGGA,141,144,3,18,7971,0,0
8598,ACGTCGAATCTAGGGA,141,141,0,17,7974,0,0
8599,ACGTCGAATCTAGGGA,141,144,3,16,7985,0,0
8600,ACGTCGAATCTAGGGA,141,144,3,11,7988,0,0
8601,ACGTCGAATCTAGGGA,141,144,3,17,7989,0,0
8602,ACGTAGAATCTAGGGA,141,144,3,13,8136,0,0
8603,ACGTCGAATCTAGGGA,141,141,0,18,8137,0,0
8604,ACGTCTAATCTAGGGA,141,144,3,18,8138,0,0
8605,ACGTCGAATCTAGGGA,141,144,3,17,8139,0,0
8606,ACGTCGAATCTAGGGA,141,144,3,13,8140,0,0
8607,ACGTAGAATCTAGGGA,141,141,0,15,8142,0,0
8608,ACGTCGAATCTAGGGA,141,144,3,16,8259,0,0
8609,ACGTCGAATCTAGGGA,141,144,3,17,8260,0,0
8610,ACGTCGAATCTAGGGA,142,145,3,15,6571,0,0
8611,ACGTCGAATCTAGGGA,142,143,1,14,6816,0,0
8612,ACGTCGAATCTAGGGA,142,162,20,15,6855,5,0
8613,ACGTCGAATCTATGGA,142,173,31,16,6867,8,0
8614,ACGTCGAATCTAGGGA,142,142,0,16,7011,0,0
8615,ACGTCGAATCTAGGGA,142,144,2,17,7022,0,0
8616,ACGTCGCATCTAGGGA,142,146,4,15,7182,0,0
8617,ACGTCGAATCTAGGGA,142,142,0,16,7205,0,0
8618,ACGTCGAATCTAGGGA,142,145,3,12,7219,0,0
8619,ACGTCGAATCTAGGGA,142,164,22,17,7369,5,0
8620,ACGTCGAATCTAGGGA,142,151,9,17,7525,1,0
8621,ACGTCGAATCTAGGGA,142,146,4,17,7531,0,0
8622,ACGTCGAATCTAGGGA,142,144,2,18,7535,0,0
8623,ACGTCGAATCTAGGGA,142,143,1,16,7690,0,0
8624,ACGTCGAATCTAGGGA,142,142,0,17,7691,0,0
8625,ACGTCGAATCTAGGGA,142,157,15,10,7693,3,0
8626,ACGTCGAATCTAGGGA,142,152,10,16,7782,1,0
8627,ACGTCGAATCTAGGGA,142,145,3,18,7786,0,0
8628,ACGTCGAATCTAGGGA,142,146,4,17,7788,0,0
8629,ACGTCGAATCTAGGGA,142,150,8,14,7852,1,0
8630,ACGTCGAATCTAGGGA,142,143,1,17,7857,0,0
8631,ACGTCGAATCTAGGGA,142,161,19,15,7866,4,0
8632,ACGTCGAATCTAGGGA,142,175,33,12,7874,9,0
8633,ACGTAGAATCTAGGGA,142,170,28,14,7876,7,0
8634,ACGTCGAATCTAGGGA,142,155,13,15,7884,2,0
8635,ACGTCGAATCTAGGGA,142,160,18,19,7887,4,0
8636,ACGTCGAATCTAGGGA,142,151,9,12,7888,1,0
8637,ACGTCGAATCTAGGGA,142,148,6,18,7890,0,0
8638,ACGTCTAATCTAGGGA,142,186,44,19,7897,13,0
8639,ACGTCGAATCTAGGGA,142,149,7,17,7901,0,0
8640,ACGTCGAATCTAGGGA,142,160,18,10,8021,4,0
8641,ACGTCGAATCTAGGGA,142,155,13,16,8022,2,0
8642,ACGTCGAATCTAGGGA,142,158,16,17,8023,3,0
8643,ACGTCGAATCTAGGGA,142,182,40,10,8024,11,0
8644,ACGTCGAATCTAGGGA,142,159,17,12,8026,4,0
8645,ACGTCGAATCTAGGGA,142,146,4,16,8027,0,0
8646,ACGTCGAATCTAGGGA,142,151,9,18,8028,1,0
8647,ACGTCGAATCTAGGGA,142,151,9,20,8029,1,0
8648,ACGTCGAATCGAGGGA,142,145,3,17,8030,0,0
8649,ACGTCGAATGTAGGGA,142,181,39,18,8038,11,0
8650,ACGTCGAATCTAGGGA,142,149,7,10,8201,0,0
8651,GCGTCGAATCTAGGGA,142,145,3,14,8202,0,0
8652,ACGTCGAATCTAGGGA,142,151,9,10,8206,1,0
8653,ACGTCGAATCTAGGGA,142,152,10,17,8207,1,0
8654,ACGTCGAATCTAGGGA,142,152,10,16,8209,1,0
8655,ACGTCGAATCTAGGGA,142,142,0,20,8211,0,0
8656,ACGTCGAATCGAGGGA,142,145,3,17,8212,0,0
8657,ACGTCGAATCTAGGGA,142,157,15,13,8213,3,0
8658,ACGTCGAATCTAGGGA,142,150,8,18,8218,1,0
8659,ACGTAGAATCTAGGGA,142,150,8,14,8219,0,0
8660,ACGTCGAATCTAGGGA,142,144,2,18,8220,0,0
8661,ACGTCGAATCTAGGGA,142,145,3,16,8221,0,0
8662,ACGTCGAATCTAGGGA,142,145,3,17,8222,0,0
8663,ACGTCGAATCTAGGGA,142,144,2,12,8226,0,0
8664,ACGTAGAATCTAGGGA,142,145,3,16,8232,0,0
8665,ACGTCGAATCTAGGGA,142,145,3,19,8233,0,0
8666,ACGTCGAATCTAGGGA,142,145,3,14,8234,0,0
8667,ACGTCGAATCTAGGGA,142,145,3,12,8235,0,0
8668,ACGTCGTATCTAGGGA,142,145,3,14,8237,0,0
8669,ACGTCGAATCTAGAGC,142,145,3,19,8240,0,0
8670,ACGTCGAATCTAGGGA,142,142,0,19,8241,0,0
8671,ACGTCGAATCTAGGGA,142,145,3,17,8245,0,0
8672,ACGTCGAATCTAGGGA,142,143,1,18,8248,0,0
8673,ACGTCGAATCTAGGGA,142,144,2,17,8249,0,0
8674,ACGTCGACTCTAGGGA,142,145,3,17,8251,0,0
8675,ACGTCGAATCTAGGGA,142,145,3,17,8255,0,0
8676,ACGTCGAATCTAGGGA,143,168,25,12,6349,6,0
8677,ACGTCTAATCTAGGGA,143,168,25,17,7034,6,0
8678,ACGTCGAATCTAGGGA,143,161,18,12,7073,4,0
8679,ACGTCGAATCTAGGGA,143,168,25,16,7332,6,0
8680,ACGTCGAATCTAGGGA,143,144,1,17,7333,0,0
8681,ACGTCGAATCTAGGGA,143,169,26,12,7497,7,0
8682,ACGTCGAATCTAGGGA,143,144,1,12,7499,0,0
8683,ACGTCGAATCTAGGGA,143,153,10,16,7505,1,0
8684,ACGTCTAATCTAGGGA,143,143,0,17,7513,0,0
8685,ACGTCGAATCTAGGGA,143,143,0,10,7548,0,0
8686,ACGTCGAATCTAGGGA,143,154,11,17,7557,2,0
8687,ACGTCGAATCTAGGGA,143,143,0,15,7563,0,0
8688,ATGTCGAATCTAGGGA,143,162,19,15,7564,4,0
8689,ACGTCGAATCTAGGGA,143,149,6,15,7565,0,0
8690,ACGTCGAATCTAGGGA,143,190,47,17,7566,14,0
8691,ACGTCGAATCTAGGGA,143,153,10,15,7571,1,0
8692,ACGTCGAATCTAGGGA,143,145,2,16,7677,0,0
8693,ACGTCGAATCTCGGGA,143,145,2,18,7682,0,0
8694,ACGTCGAATCTAGGGA,143,153,10,17,7742,1,0
8695,ACGTCGAATCTAGGGA,143,145,2,14,7746,0,0
8696,ACGTCGAATCTAGGGA,143,145,2,13,7753,0,0
8697,ACGTCGAATCTAGGGA,143,144,1,18,7755,0,0
8698,ACGTCGAATCTAGGGA,143,153,10,12,7756,1,0
8699,ACGTCGAATCTAGGGA,143,162,19,13,7758,4,0
8700,ACGTCGAATCTAGGGA,143,143,0,17,7761,0,0
8701,ACGTCGAATCTAGGGA,143,146,3,14,7767,0,0
8702,ACGTCGAATCTAGGGA,143,159,16,18,7779,3,0
8703,ACGTCGAATCTAGGGA,143,145,2,16,7910,0,0
8704,ACGTCGATTCTAGGGA,143,148,5,14,7916,0,0
8705,ACGTCGAATCTAGGGA,143,155,12,18,7917,2,0
8706,ACGTCTAATCTAGGGA,143,149,6,18,7921,0,0
8707,ACGTCGTATCTAGGAA,143,148,5,18,7929,0,0
8708,ACGTCGAATCTAGGGA,143,144,1,21,7933,0,0
8709,ACGTCGAATCTAGGGA,143,143,0,16,7990,0,0
8710,AGGTCTAATCTAGGGA,143,159,16,18,7991,3,0
8711,ACGTCGAATCTAGGGA,143,146,3,16,8080,0,0
8712,ACGTCGATTCTAGGGA,143,146,3,13,8081,0,0
8713,ACGTCGAATCTAGGGA,143,146,3,17,8085,0,0
8714,ACGTCGAATCTATGGA,143,146,3,17,8094,0,0
8715,ACGTCGAATCTCGGGA,143,146,3,13,8099,0,0
8716,ACGTCGTATCTAGGGA,143,143,0,18,8100,0,0
8717,ACGTCGCATCTAGGGA,143,146,3,16,8102,0,0
8718,ACGTCGAATCTAGGGA,143,146,3,18,8109,0,0
8719,ACGTCGAATCTAGGGA,143,146,3,17,8112,0,0
8720,ACGTCGAATCTAGGGA,143,146,3,18,8113,0,0
8721,ACGTCGAATCTAGGGA,143,146,3,18,8114,0,0
8722,ACGTCGAATCTAGGGA,143,146,3,16,8115,0,0
8723,ACGTCGAATCTAGGGA,143,146,3,18,8116,0,0
8724,ACGTCGAATCTAGGGA,143,146,3,19,8119,0,0
8725,ACGTCGAATCTAGGGA,143,146,3,11,8122,0,0
8726,ACGTCGAATCTAGGGA,143,146,3,18,8124,0,0
8727,ACGTCGAATCTAGGGA,143,143,0,14,8263,0,0
8728,ACGTCGAATCTATGGA,143,146,3,17,8266,0,0
8729,ACGTCGAATCTAGGGA,143,146,3,18,8268,0,0
8730,ACGTCGAATCTAGGGA,143,146,3,12,8269,0,0
8731,ACGTCGCATCTAGGGA,143,146,3,16,8274,0,0
8732,ACGTCGAATCTAGGGA,143,146,3,21,8275,0,0
8733,ACGTCGAATCTAGGGA,143,146,3,17,8278,0,0
8734,ACGTCGAATCTAGGAA,143,146,3,14,8279,0,0
8735,ACGTCGAATCTAGGGA,143,146,3,18,8282,0,0
8736,ACGTCGAATCTAGAGA,143,146,3,16,8285,0,0
8737,ACGTCGAATCTAGGGA,143,146,3,18,8286,0,0
8738,ACGTCGTATCTAGTGA,143,143,0,17,8287,0,0
8739,ACGTCGAATCTAGGGA,143,146,3,19,8288,0,0
8740,ACGTCGAATCTAGGGA,143,146,3,18,8291,0,0
8741,ACGTCGAATCTAGGGA,143,146,3,11,8292,0,0
8742,ACGTCGAATCTAGGGA,143,146,3,19,8294,0,0
8743,ACGTCGAATCTAGGGA,143,144,1,18,8295,0,0
8744,ACGTCGAATCTAGGGA,143,144,1,15,8297,0,0
8745,ACGTCGAATCTAGGGA,144,148,4,9,6396,0,0
8746,ACGTCGAATCTAGGGA,144,154,10,15,6756,1,0
8747,ACGTCGAATCTAGGGA,144,173,29,11,6957,8,0
8748,ACGTCGAATCTAGGGA,144,152,8,12,7287,1,0
8749,ACGTCGAATCTAGGGA,144,145,1,11,7304,0,0
8750,ACGTCGAATCTAGGGA,144,166,22,17,7308,5,0
8751,ACGTCGAATCTAGGGA,144,150,6,16,7447,0,0
8752,ACGTCGAATCTAGGGA,144,144,0,18,7462,0,0
8753,ACGTCGAATCTAGGGA,144,159,15,11,7464,3,0
8754,ACGTCGAATCTAGGGA,144,162,18,13,7474,4,0
8755,ACGTCGAATCTAGGGA,144,148,4,18,7479,0,0
8756,ACGTCGAATCTAGGGA,144,150,6,11,7624,0,0
8757,ACGTCGTATCTAGGGA,144,148,4,13,7627,0,0
8758,ACGTCGAATCTAGGGA,144,148,4,14,7631,0,0
8759,ACGTCGAATCTAGGGA,144,149,5,17,7641,0,0
8760,ACGTCGAATCTAGGGA,144,158,14,16,7661,3,0
8761,ACGTCGAATCTAGGGA,144,165,21,16,7665,5,0
8762,ACGTCGAATCTAGGGA,144,147,3,13,7789,0,0
8763,ACGTCGAATCTAGGGA,144,152,8,16,7903,1,0
8764,ACGTCGAATCTAGGGA,144,146,2,16,7904,0,0
8765,ACGTCGATTCTAGGGA,144,192,48,13,7906,14,0
8766,ACGTCGAATCTAGGGA,144,168,24,13,7964,6,0
8767,ACGTCGAATCTAGGGA,144,152,8,20,7965,1,0
8768,ACGTAGAATCTAGGGA,144,144,0,15,7966,0,0
8769,ACGTCGAATCTAGGGA,144,145,1,16,7967,0,0
8770,ACGTCGAATCTAGGGA,144,174,30,13,7968,8,0
8771,ACGTCGAATCTAGGGA,144,144,0,17,7974,0,0
8772,ACGTCGAATCTAGGGA,144,145,1,16,7985,0,0
8773,ACGTCGAATCTAGGGA,144,172,28,17,7989,7,0
8774,ACGTAGAATCTAGGGA,144,148,4,13,8136,0,0
8775,ACGTCGAATCTAGGGA,144,148,4,18,8137,0,0
8776,ACGTCGAATCTAGGGA,144,147,3,17,8139,0,0
8777,ACGTCGAATCTAGGGA,144,144,0,13,8140,0,0
8778,ACGTAGAATCTAGGGA,144,147,3,15,8142,0,0
8779,ACGTCGAATCTAGGGA,144,179,35,16,8259,10,0
8780,ACGTCGAATCTAGGGA,144,153,9,17,8260,1,0
8781,ACGTCGAATCTAGGGA,144,148,4,16,8321,0,0
8782,ACGTCAAATCTAGGGA,144,147,3,15,8322,0,0
8783,ACGTCGAATCTAGGGA,144,152,8,13,8323,1,0
8784,ACGTCGAATCTAGGGA,144,144,0,17,8325,0,0
8785,ACGTCGAATCTAGGGA,144,158,14,17,8330,3,0
8786,ACGTCGAATCTAGGGA,144,145,1,18,8331,0,0
8787,ACGTCGAATCTAGGGA,144,150,6,17,8332,0,0
8788,ACGTCGAATCTAGGGA,144,150,6,13,8335,0,0
8789,ACGTCGAGTCTAGGGA,145,154,9,15,6571,1,0
8790,ACGTCGAATCTAGGGA,145,151,6,14,6816,0,0
8791,ACGTCGAATCTAGGGA,145,149,4,15,6855,0,0
8792,ACGTGGAATCTATGGA,145,155,10,16,6867,1,0
8793,ACGTCGAATCTAGGGA,145,148,3,17,7022,0,0
8794,ACGTCGCATCTAGGGA,145,162,17,15,7182,4,0
8795,ACGTCGAATCTAGGGA,145,158,13,16,7205,2,0
8796,ACGTCGAATCTAGGGA,145,172,27,17,7369,7,0
8797,ACGTCGAATCTAGGGA,145,150,5,18,7535,0,0
8798,ACGTCGAATCTAGGGA,145,145,0,16,7690,0,0
8799,ACGTCGAATCTAGGGA,145,170,25,17,7691,6,0
8800,ACGTCGAATCTAGGGA,145,148,3,10,7693,0,0
8801,ACGTCGAATCTAGGGA,145,154,9,18,7786,1,0
8802,ACGTCGAATCTAGGGA,145,151,6,14,7852,0,0
8803,ACGTCGAATCTAGGGA,145,145,0,15,7866,0,0
8804,ACGTAGAATCTAGGGA,145,148,3,14,7876,0,0
8805,ACGTCGAATCTAGGGA,145,148,3,12,7888,0,0
8806,ACGTCGAATCTAGGGA,145,148,3,18,7890,0,0
8807,ACGTCGAATCTAGGGA,145,148,3,17,7901,0,0
8808,ACGTCGAATCTAGGGA,145,145,0,17,8023,0,0
8809,ACGTCGAATCTAGGGA,145,148,3,10,8024,0,0
8810,ACGTCGAATCTAGGGA,145,148,3,12,8026,0,0
8811,ACGTCGAATCTAGGGA,145,148,3,18,8028,0,0
8812,ACGTCGAATCGAGGGA,145,148,3,17,8030,0,0
8813,ACGTCGAATCTAGGGA,145,148,3,18,8038,0,0
8814,ACGTCGAATCTAGGGA,145,148,3,10,8201,0,0
8815,ACGTCGAATCTAGGGA,145,148,3,14,8202,0,0
8816,ACGTCGAATCTAGGGA,145,148,3,10,8206,0,0
8817,ACGTCGAATCTAGGGA,145,148,3,17,8207,0,0
8818,ACGTCGAATCTAGGGA,145,148,3,16,8209,0,0
8819,ACGTCGAATCTAGGGA,145,148,3,20,8211,0,0
8820,ACGTCGAATCGAGGGA,145,147,2,17,8212,0,0
8821,ACGTCGAATCTAGGGA,145,148,3,13,8213,0,0
8822,ACGTCGAATCTAGGGA,145,148,3,18,8218,0,0
8823,ACGTAGAATCTAGGGA,145,148,3,14,8219,0,0
8824,ACGTCGAATCTAGGGA,145,148,3,16,8221,0,0
8825,ACGTCGAATCTAGGGA,145,146,1,17,8222,0,0
8826,ACGTCGAATCTAGGGA,145,147,2,12,8226,0,0
8827,ACGTAGAATCTAGGGA,145,146,1,16,8232,0,0
8828,ACGTCGAATCTAGGGA,145,146,1,14,8234,0,0
8829,ACGTCGAATCTAGGGA,145,148,3,12,8235,0,0
8830,ACGTCGTATCTAGGGA,145,148,3,14,8237,0,0
8831,ACGTCGAAGCTAGAGC,145,148,3,19,8240,0,0
8832,ACGTCGAATCTAGGGA,145,148,3,19,8241,0,0
8833,ACGTCGAATCTAGGGA,145,148,3,18,8248,0,0
8834,ACGTCGAATCTAGGGA,145,148,3,17,8249,0,0
8835,ACGTCGAATCCAGGGA,145,146,1,17,8255,0,0
8836,ACGTCGAATCTAGGGA,145,148,3,17,8299,0,0
8837,ACGTCGACTCTAGGGA,145,146,1,15,8303,0,0
8838,ACGTCGAATCTAGGGA,145,146,1,17,8336,0,0
8839,ACGTCGAATCTAGGGA,145,147,2,16,8379,0,0
8840,ACGTCGAATCTAGGGA,145,148,3,10,8382,0,0
8841,ACGTCGAATCTAGGGA,145,148,3,20,8387,0,0
8842,ACGTCGAATCGAGGGA,145,148,3,17,8388,0,0
8843,ACGTCGAATCTAGGGA,145,148,3,12,8396,0,0
8844,ACGTAGAATCTAGGGA,145,145,0,14,8397,0,0
8845,ACGTCGAATCTAGGGA,145,147,2,14,8398,0,0
8846,ACGTCGAATCTAGGGA,145,148,3,19,8399,0,0
8847,ACGTCTAATCTAGGGA,145,148,3,19,8400,0,0
8848,ACGTCGAATCTAGGGA,145,148,3,14,8401,0,0
8849,ACGTTGAATCTAGGGA,145,148,3,13,8408,0,0
8850,ACGTCGAATCTAGGGA,145,147,2,17,8413,0,0
8851,ACGTCTAATCTAGGGA,146,154,8,17,7034,1,0
8852,ACGTCGAATCTAGGGA,146,159,13,12,7073,2,0
8853,ACGTCGAATCTAGGGA,146,148,2,16,7332,0,0
8854,ACGTCGAATCTAGGGA,146,152,6,12,7497,0,0
8855,ACGTCGAATCTAGGGA,146,148,2,12,7499,0,0
8856,ACGTCGAATCTAGGGA,146,150,4,16,7505,0,0
8857,ACGTCGAATCTAGGGA,146,158,12,10,7548,2,0
8858,ACGTCGAATCTAGGGA,146,156,10,17,7557,1,0
8859,ACGTCGAATCTAGGGA,146,156,10,15,7565,1,0
8860,ACGTCGAATCTAGGGA,146,151,5,17,7566,0,0
8861,ACGTCGAATCTAGGGA,146,146,0,16,7677,0,0
8862,ACGTCGAATCTCGGGA,146,156,10,18,7682,1,0
8863,ACGTCGAATCTAGGGA,146,158,12,17,7742,2,0
8864,ACGTCGAATCTAGGGA,146,156,10,18,7755,1,0
8865,ACGTCGAATCTAGGGA,146,153,7,12,7756,0,0
8866,ACGTCGAATCTAGGGA,146,146,0,13,7758,0,0
8867,ACGTCGAATCTAGGGA,146,149,3,17,7761,0,0
8868,ACGTCGAATCTAGGGA,146,152,6,18,7779,0,0
8869,ACGTCGAATCTAGGGA,146,150,4,16,7910,0,0
8870,ACGTCGAATCTAGGGA,146,171,25,14,7916,6,0
8871,ACGTCGAATCTAGGGA,146,153,7,18,7917,0,0
8872,CCGTCTAATCTAGGGA,146,149,3,18,7921,0,0
8873,ACGTCGTATCTAGGGA,146,147,1,18,7929,0,0
8874,ACGTCGAATCTAGGGA,146,147,1,21,7933,0,0
8875,ACGTCGAATCTAGGGA,146,158,12,16,7990,2,0
8876,AGGTGTAATCTAGGGA,146,146,0,18,7991,0,0
8877,ACGTCGAATCTAGGGA,146,150,4,16,8080,0,0
8878,ACGTCGAATCTAGGGA,146,151,5,17,8085,0,0
8879,ACGTCGAATCTATGGA,146,146,0,17,8094,0,0
8880,ACGTCGTATCTAGGGA,146,153,7,18,8100,0,0
8881,ACGTCGAATCTAGGGA,146,156,10,17,8112,1,0
8882,ACGTCGAATCTAGGGA,146,148,2,18,8113,0,0
8883,ACGTCGAATCTAGGGA,146,152,6,18,8114,0,0
8884,ACGTCGAATCTAGGGA,146,147,1,16,8115,0,0
8885,ACGTCGAATCTAGGGA,146,161,15,18,8116,3,0
8886,ACGTCGAATCTAGGGA,146,146,0,18,8124,0,0
8887,ACGTCGAATCTAGGGA,146,148,2,14,8263,0,0
8888,ACGTCGAATCTAGGGA,146,155,9,12,8269,1,0
8889,ACGTCGCATCTAGGGA,146,159,13,16,8274,2,0
8890,ACGTCGAATCTAGGGA,146,146,0,21,8275,0,0
8891,ACGTCGAATCTAGGGA,146,153,7,17,8278,0,0
8892,ACGTCGAATCTAGGGA,146,175,29,18,8282,8,0
8893,ACGTCGAATCTAGGGA,146,163,17,16,8285,4,0
8894,ACGTCGAATCTAGGGA,146,158,12,18,8286,2,0
8895,ACGTCGAATCTAGGGA,146,153,7,18,8291,0,0
8896,ACGTCGAATCTAGGGA,146,152,6,19,8294,0,0
8897,ACGTCGAATCTAGGGA,146,150,4,18,8295,0,0
8898,ACGTCGAATCTAGGGA,146,154,8,15,8297,1,0
8899,ACGTCGATTCTAGGGA,146,155,9,13,8434,1,0
8900,ACGTCGAATCTAGGGA,146,148,2,16,8435,0,0
8901,ACGTCGAATCTAGGGA,146,160,14,15,8437,3,0
8902,ACGTCGAATCTAGGGA,147,157,10,9,6396,2,0
8903,ACGTCGAATCTAGGGA,147,160,13,15,6756,3,0
8904,ACGTCGAATCTAGGGA,147,154,7,12,7287,1,0
8905,ACGTCGAATCTAGGGA,147,182,35,11,7304,10,0
8906,ACGTCGAATCTAGGGA,147,166,19,17,7308,5,0
8907,ACGTCGAATCTAGGGA,147,156,9,18,7462,1,0
8908,ACGTCGAATCTAGGGA,147,151,4,11,7464,0,0
8909,ACGTCGAATCTAGGGA,147,162,15,11,7624,3,0
8910,ACGTCGAATCTAGGGA,147,164,17,13,7627,4,0
8911,ACGTCGAATCTAGGGA,147,150,3,14,7631,0,0
8912,ACGTCGAATCTAGGGA,147,169,22,17,7641,5,0
8913,ACGTCGAATCTAGGGA,147,162,15,16,7665,3,0
8914,ACGTCGAATCTAGGGA,147,162,15,13,7789,3,0
8915,ACGTCGAATCTAGGGA,147,194,47,16,7903,14,0
8916,ACGTAGAATCTAGGGA,147,149,2,15,7966,0,0
8917,ACGTCGAATCTAGGGA,147,189,42,13,7968,12,0
8918,ACGTCGAATCTAGCGA,147,148,1,17,7974,0,0
8919,ACGTCGAATCTAGGGA,147,157,10,16,7985,1,0
8920,ACGTCGACTCTAGGGA,147,167,20,17,7989,5,0
8921,ACGTAGAATCTAGGGA,147,149,2,13,8136,0,0
8922,ACGTCGAATCTAGGGA,147,172,25,18,8137,6,0
8923,ACGTCGAATCTAGGGA,147,149,2,17,8139,0,0
8924,ACGTCGAATCTAGGGA,147,182,35,13,8140,10,0
8925,ACGTAGAATCTAGGGA,147,147,0,15,8142,0,0
8926,ACGTCGAATCTAGGGA,147,164,17,16,8259,4,0
8927,ACGTCGAATCTAGGGA,147,154,7,17,8260,0,0
8928,ACGTCGAATCTAGGGA,147,156,9,16,8321,1,0
8929,ACGTCGAATCTAGGGA,147,151,4,13,8323,0,0
8930,ACGTCGAATCTAGGGA,147,173,26,17,8325,6,0
8931,ACGTCGAAGCTAGGGA,147,149,2,17,8330,0,0
8932,ACGTCGAATCTAGGGA,147,150,3,18,8331,0,0
8933,ACGTCGAATCTAGGGA,147,150,3,17,8332,0,0
8934,ACGTCGAATCTAGGGA,147,150,3,13,8335,0,0
8935,ACGTCGAATCTAGGGA,147,148,1,17,8417,0,0
8936,ACGTCGAATCTAGGGA,147,148,1,17,8418,0,0
8937,ACGTCGAATCTAGGGA,147,147,0,18,8428,0,0
8938,ACGTCGAATCTAGGGA,147,150,3,13,8492,0,0
8939,ACGTCGAATCTAGGGA,147,150,3,18,8497,0,0
8940,ACGTCGAATCTAGGGA,147,150,3,17,8498,0,0
8941,ACGTCGAATCTAGGGA,147,150,3,13,8500,0,0
8942,ACGTCGAATCTAGGGA,147,148,1,11,8502,0,0
8943,ACGTCGAATCTAGGGA,147,150,3,20,8506,0,0
8944,ACGTCGAATCTCGGGA,147,147,0,19,8514,0,0
8945,ACGTCGAATCAAGGGA,147,150,3,18,8515,0,0
8946,ACGTCGAATCTAGGGA,147,150,3,15,8516,0,0
8947,ACGTCGAATCTAGGGA,147,148,1,14,8518,0,0
8948,ACGTCGAATCTAGGGA,147,150,3,14,8521,0,0
8949,ACGTCGAATCTAGGGA,147,147,0,18,8522,0,0
8950,ACGTCGAATCTAGGGA,147,150,3,18,8523,0,0
8951,ACGTCGAATCTAGGGA,147,150,3,16,8525,0,0
8952,ACGTCGAATCTAGGGA,147,150,3,19,8527,0,0
8953,CCGTCGAATCTAGGGA,147,149,2,17,8528,0,0
8954,ACGTCGAATCTAGGGA,147,150,3,18,8529,0,0
8955,ACGTCGAATCTAGGGA,147,150,3,15,8530,0,0
8956,ACGTCTAATCTAGGGA,147,150,3,19,8532,0,0
8957,ACGTCGAATCTAGGGA,147,150,3,22,8535,0,0
8958,ACGTCGAATCTAGGGA,147,147,0,17,8536,0,0
8959,ACGTCGAATCTAGGGA,147,150,3,17,8538,0,0
8960,ACGTCGAATCTAGGGA,147,150,3,19,8541,0,0
8961,ACGTCGAATCTAGGGA,147,150,3,13,8546,0,0
8962,ACGTCGAATCTAGGGA,147,150,3,14,8547,0,0
8963,ACGTCGAATCTAGGGA,147,150,3,19,8552,0,0
8964,ACGTCGAATCTAGGGA,148,153,5,15,6571,0,0
8965,ACGTCGAATCTAGGGA,148,165,17,15,6855,4,0
8966,ACGTCGAATCTATGGA,148,153,5,16,6867,0,0
8967,ACGTCGAATCTAGGGA,148,176,28,17,7022,7,0
8968,ACGTCGCATCTAGGGA,148,152,4,15,7182,0,0
8969,ACGTCGAATCTAGGGA,148,150,2,16,7205,0,0
8970,ACGTCGAATCTAGGGA,148,148,0,17,7369,0,0
8971,ACGTCGAATCTAGGGA,148,154,6,16,7690,0,0
8972,ACGTCGAATCTAGGGA,148,154,6,17,7691,0,0
8973,ACGTCGAATCTAGGGA,148,154,6,10,7693,0,0
8974,ACGTCGAATCTAGGGA,148,170,22,18,7786,5,0
8975,ACGTCGAATCTAGGGA,148,151,3,14,7852,0,0
8976,ACGTCGAATCTAGGGA,148,149,1,15,7866,0,0
8977,ACGTAGAATCTAGGGA,148,148,0,14,7876,0,0
8978,ACGTCGAATCTAGGGA,148,151,3,18,7890,0,0
8979,ACGTCGAATCTAGGGA,148,164,16,17,7901,3,0
8980,ACGTCGAATCTAGGGA,148,149,1,17,8023,0,0
8981,ACGTCGAATCTAGGGA,148,155,7,12,8026,0,0
8982,ACGTCGAATCTAGGGA,148,151,3,14,8202,0,0
8983,ACGTCGAATCTAGCGA,148,148,0,10,8206,0,0
8984,ACGTCGAATCTAGGGA,148,155,7,17,8207,0,0
8985,ACGTCGAATCTAGGGA,148,155,7,16,8209,0,0
8986,ACGTCGAATCTAGGGA,148,157,9,18,8218,1,0
8987,ACGTAGAATCTAGGGA,148,153,5,14,8219,0,0
8988,ACGTCGAATCTAGGGA,148,153,5,16,8221,0,0
8989,ACGTCGAATCTAGGGA,148,148,0,17,8222,0,0
8990,ACGTCGAATCTAGGGA,148,170,22,12,8226,5,0
8991,ACGTAGAATCTAGGGA,148,151,3,16,8232,0,0
8992,ACGTCGAATCTAGGGA,148,176,28,14,8234,7,0
8993,ACGTCGAATCTAGGGA,148,159,11,12,8235,2,0
8994,ACGTCGAATCTAGAGC,148,155,7,19,8240,0,0
8995,ACGTCGAATCTAGGGA,148,155,7,18,8248,0,0
8996,ACGTCGAATCTAGGGA,148,154,6,17,8255,0,0
8997,ACGTCGAATCTAGGGA,148,160,12,17,8299,2,0
8998,ACGTCGACTCTAGGGA,148,157,9,15,8303,1,0
8999,ACGTCGAATCTAGGGA,148,150,2,17,8336,0,0
9000,ACGTCGAATCTAGGGA,148,177,29,16,8379,8,0
9001,ACGTCGAATCTAGGGA,148,148,0,10,8382,0,0
9002,CCGTCGAATCTAGGGA,148,160,12,20,8387,2,0
9003,ACGTCGAATCGAGGGA,148,161,13,17,8388,2,0
9004,ACGTCGAATCTAGGGA,148,153,5,14,8398,0,0
9005,ACGTCGAATCTAGGGA,148,151,3,19,8399,0,0
9006,ACGTCTAATCTAGGGA,148,156,8,19,8400,1,0
9007,ACGTCGAATCTAGGGA,148,150,2,14,8401,0,0
9008,ACGTCGAATCTAGGGA,148,150,2,17,8413,0,0
9009,ACGTCGAATCTAGGGA,148,156,8,10,8568,1,0
9010,ACGTCGAATCTAGGGA,148,153,5,12,8569,0,0
9011,ACGTCGAATCTAGGGA,148,152,4,12,8572,0,0
9012,ACGTCGAATCTAGGGA,148,154,6,17,8574,0,0
9013,ACGTCGAATCTAGGGA,148,148,0,12,8576,0,0
9014,ACGTCGAATCTAGGGA,148,148,0,14,8577,0,0
9015,ACGTCTAATCTAGGGA,149,152,3,17,7034,0,0
9016,ACGTCGAATCTAGGGA,149,157,8,12,7499,1,0
9017,ACGTCGAATCTAGGGA,149,158,9,16,7505,1,0
9018,ACGTCGAATCTAGGGA,149,149,0,10,7548,0,0
9019,ACGTCGAATCTAGGGA,149,152,3,17,7557,0,0
9020,ACGTCGAATCTAGGGA,149,152,3,15,7565,0,0
9021,ACGTCGAATCTAGGGA,149,152,3,17,7566,0,0
9022,ACGTCGAATCTAGGGA,149,152,3,16,7677,0,0
9023,ACGTCGAATCTAGGGA,149,152,3,17,7742,0,0
9024,ACGTCGAATCTAGGGA,149,152,3,12,7756,0,0
9025,ACGTCGAATCTAGGGA,149,152,3,13,7758,0,0
9026,ACGTCGAATCTAGGGA,149,149,0,17,7761,0,0
9027,ACGTCGAATCTAGGGA,149,152,3,18,7779,0,0
9028,ACGTCGAATCTAGGGA,149,152,3,16,7910,0,0
9029,ACGTCGAATCTAGGGA,149,152,3,18,7917,0,0
9030,ACGTCTAATCTAGGGA,149,152,3,18,7921,0,0
9031,ACGTCGTATCTAGGGA,149,149,0,18,7929,0,0
9032,ACGTCGAATCTAGGGA,149,152,3,21,7933,0,0
9033,ACGTCGAATCTAGGGA,149,152,3,16,7990,0,0
9034,AGGTCTAATCTAGGGA,149,151,2,18,7991,0,0
9035,ACGTCGAATCTAGGGA,149,152,3,16,8080,0,0
9036,ACGTCGAATCTATGGA,149,152,3,17,8094,0,0
9037,ACGTCGTATCTAGGGA,149,149,0,18,8100,0,0
9038,ACGTCGAATCTAGGGA,149,152,3,17,8112,0,0
9039,ACGTCGAATCTAGGGA,149,152,3,18,8113,0,0
9040,ACGTCGAATCTAGGGA,149,149,0,18,8114,0,0
9041,ACGTCGAATCTAGGGA,149,152,3,16,8115,0,0
9042,ACGTCGAATCTAGGGA,149,152,3,18,8116,0,0
9043,ACGTCGAATCTAGGGA,149,152,3,18,8124,0,0
9044,ACGTCGAATCTAGGGA,149,151,2,14,8263,0,0
9045,ACGTCGAATCTAGGGA,149,149,0,12,8269,0,0
9046,ACGTCGCATCTAGGGA,149,152,3,16,8274,0,0
9047,ACGTCGAATCTAGGGA,149,152,3,21,8275,0,0
9048,ACGTCGAATCTAGGGA,149,150,1,17,8278,0,0
9049,ACGTCGAATCTAGGGA,149,152,3,18,8282,0,0
9050,ACGTCGAATCTAGGGA,149,152,3,16,8285,0,0
9051,ACGTCGAATCTAGGGA,149,152,3,19,8294,0,0
9052,ACGTCGAATCTAGGGA,149,152,3,18,8295,0,0
9053,ACGTCGAATCTAGGGA,149,151,2,15,8297,0,0
9054,ACGTCGAATCTAGGGA,149,152,3,17,8556,0,0
9055,ACGTCGAATCTAGGGA,149,152,3,20,8558,0,0
9056,ACGTCGAATCTAGGGA,149,149,0,18,8561,0,0
9057,ACGTCGAATCTAGGGA,149,152,3,16,8612,0,0
9058,ACGTCGAATCTATGGA,149,152,3,17,8613,0,0
9059,ACGTCGAATCTAGGGA,149,149,0,18,8619,0,0
9060,ACGTCGAATCTAGGGA,149,152,3,18,8620,0,0
9061,ACGTCGAATCTAGGGA,149,152,3,11,8625,0,0
9062,ACGTCGAATCTAGGGA,149,152,3,17,8626,0,0
9063,ACGTCGAATCTAGGGA,149,149,0,15,8629,0,0
9064,ACGTCGAATCTAGGGA,149,152,3,16,8631,0,0
9065,ACGTCGAATCTAGGGA,149,151,2,13,8632,0,0
9066,ACGTAGAATCTAGGGA,149,152,3,15,8633,0,0
9067,ACGTCGAATCTAGGGA,149,152,3,16,8634,0,0
9068,ACGTCGAATCTAGGGA,149,152,3,20,8635,0,0
9069,ACGTCGAATCTAGGGA,149,149,0,13,8636,0,0
9070,ACGTCTAATCTAGGGA,149,152,3,20,8638,0,0
9071,ACGTCGAATCTAGGGA,149,151,2,11,8640,0,0
9072,ACGTCGAATCTAGGGA,149,152,3,17,8641,0,0
9073,ACGTCGAATCTAGGGA,149,152,3,18,8642,0,0
9074,ACGTCGAATCTAGGGA,149,152,3,11,8643,0,0
9075,ACGTCGAATCTAGGGA,149,152,3,13,8644,0,0
9076,ACGTCGAATCTAGGGA,149,152,3,19,8646,0,0
9077,ACGTCGAATCTAGGGA,149,152,3,21,8647,0,0
9078,ACGTCGAATGTAGGGA,149,152,3,19,8649,0,0
9079,ACGTCGAATCTAGGGA,149,149,0,11,8652,0,0
9080,ACGTCGAATCTAAGGA,149,152,3,18,8653,0,0
9081,ACGTCGAATCTAGGGA,149,150,1,17,8654,0,0
9082,ACGTCGAATCTAGGGA,149,152,3,14,8657,0,0
9083,ACGTCGAATCTAGGGA,149,152,3,19,8658,0,0
9084,ACGTCGAATCTAGGGA,150,150,0,9,6396,0,0
9085,ACGTCGAATCTAGGGA,150,150,0,15,6756,0,0
9086,ACGTCGAATCTAGGGA,150,151,1,12,7287,0,0
9087,ACGTCGAATCTAGGGA,150,151,1,11,7304,0,0
9088,ACGTCGAATCTAGGGA,150,150,0,17,7308,0,0
9089,ACGTCGAATCTAGGGA,150,155,5,11,7464,0,0
9090,ACGTCGAATCTAGGGA,150,151,1,16,7665,0,0
9091,ACGTCGAATCTAGGGA,150,150,0,13,7789,0,0
9092,ACGTAGAATCTAGGGA,150,155,5,15,7966,0,0
9093,ACGTCGAATCTAGGGA,150,156,6,13,7968,0,0
9094,ACGTCGAATCTAGGGA,150,156,6,16,7985,0,0
9095,ACGTCGAATCTAGGGA,150,160,10,17,7989,1,0
9096,ACGTCGAATCTAGGGA,150,170,20,17,8139,5,0
9097,ACGTCGAATCTAGGGA,150,150,0,13,8140,0,0
9098,ACGTAGAATCTAGGGA,150,151,1,15,8142,0,0
9099,ACGTCGAATCTAGGGA,150,167,17,16,8259,4,0
9100,ACGTCGAATCTAGGGA,150,150,0,17,8260,0,0
9101,ACGTCGAATCTAGGGA,150,151,1,16,8321,0,0
9102,ACGTCGAATCTAGGGA,150,155,5,17,8325,0,0
9103,TCGTCGAATCTAGGGA,150,169,19,17,8330,4,0
9104,ACGTCGAATCTAGGGA,150,161,11,18,8331,2,0
9105,ACGTCGAATCTAGGGA,150,156,6,17,8332,0,0
9106,ACGTCGAATCTAGGGA,150,152,2,13,8335,0,0
9107,ACGTCGAATCTAGGGA,150,158,8,17,8417,1,0
9108,ACGTCGAATCTAGGGA,150,151,1,18,8428,0,0
9109,ACGTCGAATCTAGGGA,150,153,3,18,8497,0,0
9110,ACGTCGAATCTAGGGA,150,167,17,17,8498,4,0
9111,ACGTCGAATCTAGGGA,150,159,9,13,8500,1,0
9112,ACGTCGAATCTAGGGA,150,156,6,11,8502,0,0
9113,ACGTCGAATCTAGGGA,150,155,5,20,8506,0,0
9114,ACGTCGAATCTCGGGA,150,159,9,19,8514,1,0
9115,ACGTCGAATCTAGGGA,150,156,6,15,8516,0,0
9116,ACGTCGAATCTAGGGA,150,161,11,14,8518,2,0
9117,ACGTCGAATCTAGGGA,150,158,8,14,8521,1,0
9118,ACGTCGAATCTAGGGA,150,157,7,18,8523,0,0
9119,ACGTCGAATCTAGGGA,150,151,1,16,8525,0,0
9120,ACGTCGAATCTAGGGA,150,171,21,19,8527,5,0
9121,ACGTCGAATCTAGGGA,150,150,0,18,8529,0,0
9122,ACGTCGAATCTAGGGA,150,150,0,22,8535,0,0
9123,ACGTCGAATCTAGGGA,150,166,16,17,8536,3,0
9124,ACGTCGAATCTAGGGA,150,151,1,17,8538,0,0
9125,ACGTCGAATCTAGGGA,150,188,38,13,8546,11,0
9126,ACGTCGAATCTAGGGA,150,165,15,14,8547,3,0
9127,ACGTCGAATCTAGGGA,150,154,4,13,8676,0,0
9128,ACGTCTAATCTAGGGA,150,152,2,18,8677,0,0
9129,ACGTCGAATCTAGGGA,150,166,16,13,8678,3,0
9130,ACGTCGAATCTAGGGA,150,152,2,17,8679,0,0
9131,ACGTCGAATCTAGGGA,150,158,8,13,8681,1,0
9132,ACGTCGAATCTAGGGA,150,162,12,17,8683,2,0
9133,ACGTCGAATCTAGGGA,150,157,7,18,8686,0,0
9134,ATGTCGAATCTAGGGA,150,150,0,16,8688,0,0
9135,ACGTCGAATCTAGGGA,150,150,0,18,8690,0,0
9136,ACGTCGAATCTAGGGA,150,154,4,16,8691,0,0
9137,ACGTCGAATCTAGGGA,150,182,32,18,8694,9,0
9138,ACGTCGAATCTAGGGA,150,170,20,13,8698,5,0
9139,ACGTCGAATCTAGGGA,150,157,7,14,8699,0,0
9140,ACGTCGAATCTAGGGA,150,152,2,19,8702,0,0
9141,ACGTCGAATCTAGTGA,150,155,5,19,8705,0,0
9142,ACGTCGAATCTAGGGA,151,153,2,15,6571,0,0
9143,ACGTCGAATCTAGGGA,151,164,13,17,7022,3,0
9144,ACGTCGCATCTAGGGA,151,158,7,15,7182,1,0
9145,ACGTCGAATCTAGGGA,151,172,21,16,7690,6,0
9146,ACGTCGAATCTAGGGA,151,163,12,17,7691,3,0
9147,ACGTCGAATCTAGGGA,151,159,8,10,7693,1,0
9148,ACGTCGAATCTAGGGA,151,156,5,18,7786,0,0
9149,ACGTCGAATCTAGGGA,151,166,15,14,7852,4,0
9150,ACGTAGAATCTAGGGA,151,153,2,14,7876,0,0
9151,ACGTCGAATCTAGGGA,151,188,37,18,7890,11,0
9152,ACGTCGAATCTAGGGA,151,151,0,17,7901,0,0
9153,ACGTCGAATCTAGGGA,151,158,7,12,8026,1,0
9154,ACGTCGAATCTAGGGA,151,154,3,14,8202,0,0
9155,ACGTCGAATCTAGGGA,151,159,8,16,8209,1,0
9156,ACGTCGAATCTAGGGA,151,157,6,18,8218,1,0
9157,ACGTAGAATCTAGGGA,151,162,11,14,8219,2,0
9158,ACGTCGAATCTAGGGA,151,166,15,16,8221,4,0
9159,ACGGCGAATCTAGGGA,151,157,6,12,8226,0,0
9160,ACGTAGAATCTAGGGA,151,153,2,16,8232,0,0
9161,ACGTCGAATCTAGGGA,151,170,19,14,8234,4,0
9162,ACGTCGAATCTAGGGA,151,157,6,12,8235,0,0
9163,ACGTCGAATCTAGAGC,151,163,12,19,8240,2,0
9164,ACGTCGAATCTAGGGA,151,152,1,18,8248,0,0
9165,ACGTCGACTCTAGGGA,151,162,11,15,8303,2,0
9166,ACGTCGAATCTAGGGA,151,156,5,17,8336,0,0
9167,ACGTCGAATCTAGGGA,151,167,16,10,8382,3,0
9168,ACGTCGAATCTAGGGA,151,165,14,20,8387,3,0
9169,ACGTCGAATCTAGGGA,151,152,1,14,8398,0,0
9170,ACGTCGAATCTAGGGA,151,172,21,19,8399,5,0
9171,ACGTCGAATCTAGGGA,151,162,11,17,8413,2,0
9172,ACGTCGAATCTAGGGA,151,154,3,12,8572,0,0
9173,ACGTCGAATCTAGGGA,151,164,13,17,8574,2,0
9174,ACGTCGAATCTAGGGA,151,167,16,12,8576,3,0
9175,ACGTCGAATCTAGGGA,151,152,1,14,8577,0,0
9176,AGGTCTAATCTAGGGA,151,155,4,19,8710,0,0
9177,ACGTCGAATCTAGGGA,151,173,22,16,8746,5,0
9178,ACGTCGAATCTAGGGA,151,152,1,12,8747,0,0
9179,ACGTCGAATCTAGGGA,151,155,4,13,8748,0,0
9180,ACGTCGAATCTAGGGA,151,164,13,18,8750,2,0
9181,ACGTCGAATCTAGGGA,151,153,2,12,8753,0,0
9182,ACGTCGAATCTAGGGA,151,151,0,14,8754,0,0
9183,ACGTCGAATCTAGGGA,151,152,1,17,8760,0,0
9184,ACGTCGAATCTAGGGA,151,156,5,17,8761,0,0
9185,ACGTCGAATCTAGGGA,151,151,0,17,8763,0,0
9186,ACGTCGATTCTAGGGA,151,159,8,14,8765,1,0
9187,ACGTCGAATCTAGGGA,151,154,3,14,8766,0,0
9188,ACGTCGAATCTAGGGA,151,185,34,21,8767,9,0
9189,ACGTCGAATCTAGGGA,151,159,8,14,8770,1,0
9190,ACGTCGAATCTAGGGA,151,152,1,18,8773,0,0
9191,ACGTCGAATCTAGGGA,151,164,13,17,8779,2,0
9192,ACGTCGAATCTAGGGA,151,151,0,18,8780,0,0
9193,ACGTCGAATCTAGGGA,151,165,14,14,8783,3,0
9194,ACGTCGAATCTAGGGA,151,179,28,18,8785,7,0
9195,ACGTCTAATCTAGGGA,152,187,35,17,7034,10,0
9196,ACGTCGAATCTAGGGA,152,177,25,16,7505,7,0
9197,ACGTCGAATCTAGGGA,152,153,1,10,7548,0,0
9198,ACGTCGAATCTAGGGA,152,162,10,17,7557,1,0
9199,ACGTCGAATCTAGGGA,152,165,13,15,7565,2,0
9200,ACGTCGAATCTAGGGA,152,156,4,16,7677,0,0
9201,ACGTCGAATCTAGGGA,152,155,3,17,7742,0,0
9202,ACGTCGAATCTAGGGA,152,155,3,12,7756,0,0
9203,ACGTCGAATCTAGGGA,152,152,0,17,7761,0,0
9204,ACGTCGAATCTAGGGA,152,155,3,18,7779,0,0
9205,ACGTCGAATCTAGGGA,152,155,3,16,7910,0,0
9206,ACGTCGAATCTAGGGA,152,155,3,18,7917,0,0
9207,ACGTCTAATCTAGGGA,152,152,0,18,7921,0,0
9208,ACGTCGTATCTAGGGA,152,155,3,18,7929,0,0
9209,ACGTCGAATCTAGGGA,152,155,3,21,7933,0,0
9210,ACGTCGAATCTAGGGA,152,155,3,16,7990,0,0
9211,AGGTCTAATCTAGGGA,152,155,3,18,7991,0,0
9212,ACGTCGAATCTATGGA,152,155,3,17,8094,0,0
9213,ACGTCGTATCTAGGGA,152,154,2,18,8100,0,0
9214,ACGTCGAATCTAGGGA,152,155,3,17,8112,0,0
9215,ACGTGGAATCTAGGGA,152,155,3,18,8116,0,0
9216,ACGTCGAATCTAGGGA,152,155,3,18,8124,0,0
9217,ACGTCGAATCTAGGGA,152,155,3,12,8269,0,0
9218,ACGTCGCATCTAGGGA,152,155,3,16,8274,0,0
9219,ACGTAGAATCTAGGGA,152,153,1,21,8275,0,0
9220,ACGTCGAATCTAGGGA,152,155,3,16,8285,0,0
9221,ACGTCGAATCTAGGGA,152,155,3,19,8294,0,0
9222,ACGTCGAATCTAGGGA,152,155,3,18,8295,0,0
9223,ACGTCGAATCTAGGGA,152,155,3,20,8558,0,0
9224,ACGTCGAATCTAGGGA,152,153,1,18,8561,0,0
9225,ACGTCGAATCTAGGGA,152,155,3,16,8612,0,0
9226,ACGTCGAATCTATGGA,152,155,3,17,8613,0,0
9227,ACGTCGAATCTAGGGA,152,153,1,18,8619,0,0
9228,ACGTCGAATCTAGGGA,152,155,3,11,8625,0,0
9229,ACGTCGAATCTAGGGA,152,155,3,16,8631,0,0
9230,ACGTCGAATCTAGGGA,152,155,3,13,8632,0,0
9231,ACGTAGAATCTAGGGA,152,155,3,15,8633,0,0
9232,ACGTCGAATCTAGGGA,152,152,0,16,8634,0,0
9233,ACGTCGAATCTAGGGA,152,155,3,20,8635,0,0
9234,ACGTCTAATCTAGGGA,152,153,1,20,8638,0,0
9235,ACGTCGAATCTAGGGA,152,155,3,11,8640,0,0
9236,ACGTCGAATCTAGGGA,152,155,3,17,8641,0,0
9237,ACGTCGAATCTAGGGA,152,154,2,18,8642,0,0
9238,ACGTCGAATCTAGGGA,152,152,0,11,8643,0,0
9239,ACGTCGAATCTAGGGA,152,155,3,13,8644,0,0
9240,ACGTCGAATGTAGGGA,152,155,3,19,8649,0,0
9241,ACGTCGAATCTAGGGA,152,155,3,14,8657,0,0
9242,ACGTCGAGTCTAGGGA,152,155,3,16,8789,0,0
9243,ACGTGGAATCTATGGA,152,155,3,17,8792,0,0
9244,ACGTCGCATCTAGGGA,152,155,3,16,8794,0,0
9245,ACGTCGAATCTAGGGA,152,155,3,17,8795,0,0
9246,ACGTCGAATCTAGGGA,152,155,3,18,8796,0,0
9247,ACGTCGAATCTAGGGA,152,152,0,18,8799,0,0
9248,ACGTCGAATCTAGGGA,152,155,3,19,8801,0,0
9249,ACGTCGAATCTAGGGA,152,155,3,10,8902,0,0
9250,ACGTCGAATCTAGGGA,152,153,1,16,8903,0,0
9251,ACGTCGAATCTAGGGA,152,155,3,13,8904,0,0
9252,ACGTCGAATCTAGGGA,152,155,3,12,8905,0,0
9253,ACGTCGAATCTAGGGA,152,155,3,18,8906,0,0
9254,ACGTCGAATCTAGGGA,153,153,0,9,6396,0,0
9255,ACGTCGAATCTAGGGA,153,155,2,12,7287,0,0
9256,ACGTCGAATCTAGGGA,153,158,5,17,7308,0,0
9257,ACGTCGAATCTAGGGA,153,158,5,16,7665,0,0
9258,ACGTCGAATCTAGGGA,153,159,6,13,7789,0,0
9259,ACGTCGAATCTAGGGA,153,153,0,13,7968,0,0
9260,ACGTCGAATCTAGGGA,153,154,1,16,7985,0,0
9261,ACGTCGAATCTAGGGA,153,200,47,17,7989,14,0
9262,ACGTCGAATCTAGGGA,153,163,10,17,8139,1,0
9263,ACGTCGAATCTAGGGA,153,179,26,13,8140,7,0
9264,ACGTCGAATCTAGGGA,153,186,33,16,8259,9,0
9265,ACGTCGAATCTAGGGA,153,154,1,17,8260,0,0
9266,ACGTCGAATCTAGGGA,153,153,0,17,8325,0,0
9267,ACGTCGAATCTAGGGA,153,156,3,17,8330,0,0
9268,ACGTCGAATCTAGGGA,153,175,22,18,8331,5,0
9269,ACGTCGAATCTAGGGA,153,165,12,13,8335,2,0
9270,ACGTCGAATCTAGGGA,153,163,10,17,8417,1,0
9271,ACGTCGAATCTAGGGA,153,158,5,18,8428,0,0
9272,ACGTCGAATCTAGGGA,153,154,1,18,8497,0,0
9273,ACGTCGAATCTAGGGA,153,159,6,17,8498,0,0
9274,ACGTCGAATCTAGGGA,153,162,9,13,8500,1,0
9275,ACGTCGAATCTAGGGA,153,158,5,20,8506,0,0
9276,ACGTCGAATCTCGGGA,153,166,13,19,8514,2,0
9277,ACGTCGAATCTAGGGA,153,158,5,15,8516,0,0
9278,ACGTCGAATCTAGGGA,153,169,16,14,8518,3,0
9279,ACGTCGAATCTAGGGA,153,159,6,14,8521,0,0
9280,ACGTCGAATCTAGGGA,153,166,13,16,8525,2,0
9281,ACGTCGAATCTAGGGA,153,154,1,18,8529,0,0
9282,ACGTCGAATCTAGGGA,153,156,3,22,8535,0,0
9283,ACGTCGAATCTAGGGA,153,170,17,17,8538,4,0
9284,ACGTCGAATCTAGGGA,153,163,10,13,8546,1,0
9285,ACGTCGAATCTAGGGA,153,154,1,14,8547,0,0
9286,ACGTCGAATCTAGGGA,153,230,77,13,8676,24,0
9287,ACGTCTAATCTAGGGA,153,156,3,18,8677,0,0
9288,ACGTCGAATCTAGGGA,153,166,13,13,8678,2,0
9289,ACGTCGAATCTAGGGA,153,158,5,17,8679,0,0
9290,ACGTCGAATCTAGGGA,153,157,4,13,8681,0,0
9291,ACGTCGAATCTAGGGA,153,159,6,18,8686,0,0
9292,ATGTCGAATCTAGGGA,153,153,0,16,8688,0,0
9293,ACGTCGAATCTAGGGA,153,160,7,18,8690,0,0
9294,ACGTCGAATCTAGGGA,153,179,26,14,8699,7,0
9295,ACGTCGAATCTAGGGA,153,154,1,19,8702,0,0
9296,ACGTCGAATCTAGGGA,153,168,15,19,8705,3,0
9297,AGGTCTAATCTAGGGA,153,160,7,18,8851,0,0
9298,ACGTCGAATCTAGGGA,153,155,2,13,8852,0,0
9299,ACGTCGAATCTAGGGA,153,157,4,11,8857,0,0
9300,ACGTCGAATCTAGGGA,153,156,3,18,8858,0,0
9301,ACGTCGAATCTAGGGA,153,163,10,16,8859,1,0
9302,ACGTCGAATCTCGGGA,153,168,15,19,8862,3,0
9303,ACGTCGAATCTAGGGA,153,172,19,18,8863,4,0
9304,ACGTCGAATCTCGGGA,153,165,12,19,8864,2,0
9305,ACGTCGAATCTAGGGA,153,162,9,15,8870,1,0
9306,ACGTCGAATCTAGGGA,153,159,6,17,8875,0,0
9307,ACGTCGAATCTAGGGA,153,165,12,18,8881,2,0
9308,ACGTCGAATCTAGGGA,153,182,29,19,8885,8,0
9309,ACGTCGAATCTAGGGA,153,155,2,13,8888,0,0
9310,ACGTCGCATCTAGGGA,153,163,10,17,8889,1,0
9311,ACGTCGAATCTAGGGA,153,167,14,19,8892,3,0
9312,ACGTCGAATCTAGGGA,153,192,39,17,8893,11,0
9313,ACGTCGAATCTAGGGA,153,158,5,19,8894,0,0
9314,ACGTCGAATCTAGGGA,153,161,8,16,8898,1,0
9315,ACGTCGATTCTAGGGA,153,164,11,14,8899,2,0
9316,ACGTCGAATCTAGGGA,153,155,2,16,8901,0,0
9317,ACGTCGAATCTAGGGA,154,163,9,15,6571,1,0
9318,ACGTCGAATCTAGGGA,154,164,10,17,7022,1,0
9319,ACGTCGAATCTAGGGA,154,162,8,16,7690,1,0
9320,ACGTCGAATCTAGGGA,154,163,9,10,7693,1,0
9321,ACGTCGAATCTAGGGA,154,167,13,18,7786,2,0
9322,ACGTCGAATCTAGGGA,154,179,25,14,7852,6,0
9323,ACGTCGAATCTAGGGA,154,166,12,17,7901,2,0
9324,ACGTCGAATCTAGGGA,154,182,28,12,8026,7,0
9325,ACGTCGAATCTAGGGA,154,175,21,14,8202,5,0
9326,ACGTCGAATCTAGGGA,154,159,5,16,8209,0,0
9327,ACGTAGAATCTAGGGA,154,185,31,14,8219,8,0
9328,ACGTCGAATCTAGGGA,154,200,46,16,8221,13,0
9329,ACGTCGAATCTAGGGA,154,168,14,12,8226,3,0
9330,ACGTCGAATCTAGGGA,154,180,26,18,8248,7,0
9331,ACGTCGAATCTAAGGA,154,158,4,17,8336,0,0
9332,ACGTCGAATCTAGGGA,154,174,20,10,8382,5,0
9333,ACGTCGAATCTAGGGA,154,158,4,20,8387,0,0
9334,ACGTCGAATCTAGGGA,154,159,5,17,8413,0,0
9335,ACGTCGAATCTAGGGA,154,166,12,12,8572,2,0
9336,ACGTCGAATCTAGGGA,154,162,8,17,8574,1,0
9337,ACGTCGAATCTAGGGA,154,162,8,12,8576,1,0
9338,AGGTCTAATCTAGGGA,154,155,1,19,8710,0,0
9339,ACGTCGAATCTAGGGA,154,163,9,12,8747,0,0
9340,ACGTCGAATCTAGGGA,154,175,21,18,8750,4,0
9341,ACGTCGAATCTAGGGA,154,158,4,12,8753,0,0
9342,ACGTCGAATCTAGGGA,154,157,3,14,8754,0,0
9343,ACGTCGAATCTAGGGA,154,157,3,17,8760,0,0
9344,ACGTCGAATCTAGGGA,154,157,3,17,8761,0,0
9345,ACGTCGATTCTAGGGA,154,157,3,14,8765,0,0
9346,ACGTCGAATCTAGGGA,154,157,3,14,8766,0,0
9347,ACGTCGAATCTAGGGA,154,157,3,14,8770,0,0
9348,ACGTCGAATCTAGGGA,154,155,1,18,8773,0,0
9349,ACGTCGAATCTAGGGA,154,154,0,17,8779,0,0
9350,ACGTCGAATCTAGGGA,154,157,3,18,8785,0,0
9351,ACGTCGAATCTAGGGA,154,156,2,19,8907,0,0
9352,ACGTCGAATCTAGGGA,154,157,3,12,8909,0,0
9353,ACGTCGAATCTAGGGA,154,157,3,14,8910,0,0
9354,ACGTCGAATCTAGGGA,154,155,1,18,8912,0,0
9355,ACGTCGAATCTAGGGA,154,156,2,17,8913,0,0
9356,ACGTCGAATCTAGGGA,154,157,3,14,8914,0,0
9357,ACGTCGAATCTAGGGA,154,156,2,17,8915,0,0
9358,ACGTCGAATCTAGGGA,154,157,3,14,8917,0,0
9359,ACGTCGAATCTAGGGA,154,157,3,17,8919,0,0
9360,ACGTCGACTCTAGGGA,154,157,3,18,8920,0,0
9361,ACGTCGAATCTAGAGA,154,154,0,19,8922,0,0
9362,ACGTCGAATCTAGGGA,154,157,3,14,8924,0,0
9363,ACGTCGAATCTAGGGA,154,157,3,17,8926,0,0
9364,ACGACGAATCTAGGGA,154,157,3,17,8928,0,0
9365,ACGTCGAATCTAGGGA,155,161,6,16,7505,0,0
9366,ACGTCGAATCTAGGGA,155,155,0,15,7565,0,0
9367,ACGTCGAATCTAGGGA,155,156,1,16,7677,0,0
9368,ACGTCGAATCTAGGGA,155,155,0,17,7742,0,0
9369,ACGTCGAATCTAGGGA,155,155,0,12,7756,0,0
9370,ACGTCGAATCTAGGGA,155,163,8,17,7761,1,0
9371,ACGTCGAATCTAGGGA,155,157,2,18,7779,0,0
9372,ACGTCGAATCTAGGGA,155,155,0,16,7910,0,0
9373,ACGTCGAATCTAGGGA,155,160,5,18,7917,0,0
9374,ACGTCTAATCTAGGGA,155,158,3,18,7921,0,0
9375,ACGTCGAATCTAGGGA,155,160,5,21,7933,0,0
9376,ACGTCGAATCTAGGGA,155,162,7,16,7990,0,0
9377,AGGTCTAATCTAGGGA,155,186,31,18,7991,8,0
9378,ACGTCGAATCTATGGA,155,208,53,17,8094,16,0
9379,ACGTCGTATCTAGGGA,155,162,7,18,8100,0,0
9380,ACGTCGAATCTAGGGA,155,157,2,18,8116,0,0
9381,ACGTCGAATCTAGGGA,155,169,14,18,8124,3,0
9382,ACGTCGAATCTAGGGA,155,163,8,21,8275,1,0
9383,ACGTCGAATCTAGGGA,155,166,11,16,8285,2,0
9384,ACGTCGAATCTAGGGA,155,156,1,19,8294,0,0
9385,ACGTCGAATCTAGGGA,155,155,0,18,8295,0,0
9386,ACGTCGAATCTAGGGA,155,156,1,20,8558,0,0
9387,ACGTCGAATCCAGGGA,155,155,0,18,8561,0,0
9388,ACGTCGAATCTAGGGA,155,161,6,16,8612,0,0
9389,ACGTCGAATCTATGGA,155,173,18,17,8613,4,0
9390,ACGTCGAATCTAGGGA,155,155,0,18,8619,0,0
9391,ACGTCGAATCTAGGGA,155,162,7,11,8625,0,0
9392,ACGTCGAATCTAGGGA,155,188,33,16,8631,9,0
9393,ACGTCGAATCTAGGGA,155,155,0,13,8632,0,0
9394,ACGTAGAATCTAGGGA,155,170,15,15,8633,3,0
9395,ACGTCGAATCTAGGGA,155,170,15,20,8635,3,0
9396,ACGTCTAATCTAGGCA,155,159,4,20,8638,0,0
9397,ACGTCGAATCTAGGGA,155,156,1,11,8640,0,0
9398,ACGTCGAATCTAGGGA,155,156,1,18,8642,0,0
9399,ACGTCGAATCTAGGGA,155,166,11,11,8643,2,0
9400,ACGTCGAATCTAGGGA,155,170,15,13,8644,3,0
9401,ACGTCGAATGTAGGGA,155,158,3,19,8649,0,0
9402,ACGTCGAATCTAGGGA,155,158,3,14,8657,0,0
9403,ACGTCGCATCTAGGGA,155,158,3,16,8794,0,0
9404,ACGTCGAATCTAGGGA,155,158,3,17,8795,0,0
9405,ACGTCGAATCTAGGGA,155,158,3,18,8796,0,0
9406,ACGTCGAATCTAGGGA,155,158,3,18,8799,0,0
9407,ACGTCGAATCTAGGGA,155,157,2,10,8902,0,0
9408,ACGTCGAATCTAGGGA,155,158,3,16,8903,0,0
9409,ACGTCGAATCTAGGGA,155,158,3,12,8905,0,0
9410,ACGTCGAATCTAGGGA,155,156,1,18,8906,0,0
9411,ACGTCGAATCTAGGGA,155,157,2,18,8930,0,0
9412,ACGTCGAATCTAGGGA,155,158,3,16,8965,0,0
9413,ACGTCGAATCTAGGGA,155,158,3,18,8967,0,0
9414,ACGTCGAATCTAGGGA,155,158,3,19,8974,0,0
9415,ACGTCGAATCTAGGGA,155,155,0,18,8979,0,0
9416,ACGTCGAATCTAGGGA,155,155,0,19,8986,0,0
9417,ACGTCGAATCTAGGGA,155,158,3,13,8990,0,0
9418,ACGTCGAATCTAGGGA,155,158,3,15,8992,0,0
9419,ACGTCGAATCTAGGGA,155,158,3,13,8993,0,0
9420,ACGTCGAATCTAGGGA,155,158,3,18,8997,0,0
9421,ACGTCGACTCTAGGGA,155,158,3,16,8998,0,0
9422,ACGTCGAATCTAGGGA,155,158,3,17,9000,0,0
9423,CCGTCGAATCTAGGGA,155,158,3,21,9002,0,0
9424,ACGTCGAATCGAGGGA,155,158,3,18,9003,0,0
9425,ACGTCTAATCTAGGGA,155,157,2,20,9006,0,0
9426,ACGTCGAATCTAGGGA,155,158,3,11,9009,0,0
9427,ACGTCGAATCTAGGGA,156,168,12,9,6396,2,0
9428,ACGTCGAATCTAGGGA,156,168,12,12,7287,2,0
9429,ACGTCGAATCTAGGGA,156,162,6,17,7308,0,0
9430,ACGTCGAATCTAGGGA,156,160,4,13,7789,0,0
9431,ACGTCGAATCTAGGGA,156,163,7,16,7985,0,0
9432,ACGTCGAATCTAGGGA,156,161,5,17,7989,0,0
9433,ACGTCGAATCTAGGGA,156,159,3,13,8140,0,0
9434,ACGTCGAATCTAGGGA,156,157,1,16,8259,0,0
9435,ACGTCGAATCTAGGGA,156,166,10,17,8260,1,0
9436,ACGTCGAATCTAGGGA,156,162,6,13,8335,0,0
9437,ACGTCGAATCTAGGGA,156,156,0,17,8417,0,0
9438,ACGTCGAATCTAGGGA,156,172,16,18,8428,3,0
9439,ACGTCGAATCTAGGGA,156,160,4,18,8497,0,0
9440,ACGTCGAATCTAGGGA,156,179,23,17,8498,6,0
9441,ACGTCGAATCTAGGGA,156,170,14,20,8506,3,0
9442,ACGTCGAATCTCGGGA,156,159,3,19,8514,0,0
9443,ACGTCGAATCTAGGGA,156,166,10,15,8516,1,0
9444,ACGTCGAATCTAGGGA,156,165,9,14,8518,1,0
9445,ACGTCGAATCTAGGGA,156,157,1,14,8521,0,0
9446,ACGTCGAATCTAGGGA,156,199,43,16,8525,12,0
9447,ACGTCGAATCTAGGGA,156,161,5,22,8535,0,0
9448,ACGTCGAATCTAGGGA,156,158,2,13,8546,0,0
9449,ACGTCGAATCTAGGGA,156,166,10,14,8547,1,0
9450,ACGTCGAATCTAGGGA,156,157,1,13,8676,0,0
9451,ACGTCTAATCTAGGGA,156,179,23,18,8677,6,0
9452,ACGTCGAATCTAGGGA,156,165,9,13,8678,1,0
9453,ACGTCGAATCTAGGGA,156,161,5,17,8679,0,0
9454,ACGTCGAATCTAGGGA,156,162,6,13,8681,0,0
9455,ATGTCGAATCTAGGGA,156,167,11,16,8688,2,0
9456,ACGTCGAATCTAGGGA,156,160,4,18,8690,0,0
9457,ACGTCGAATCTAGGGA,156,182,26,14,8699,7,0
9458,ACGTCGAATCTAGGGA,156,160,4,19,8702,0,0
9459,ACGTCGAATCTAGGGA,156,159,3,13,8852,0,0
9460,ACGTCGAATCTAGGGA,156,166,10,11,8857,1,0
9461,ACGTCGAATCTAGGGA,156,160,4,18,8863,0,0
9462,ACGTCGAATCTAGGGA,156,156,0,15,8870,0,0
9463,ACGTCGAATCTAGGGA,156,167,11,17,8875,2,0
9464,ACGTCGAATCTAGGGA,156,183,27,19,8885,7,0
9465,ACGTCGCATCTAGGGA,156,159,3,17,8889,0,0
9466,ACGTCGAATCTAGGGA,156,159,3,19,8892,0,0
9467,ACGTCGAATCTAGGGA,156,159,3,17,8893,0,0
9468,ACGTCGAATCTAGGGA,156,159,3,19,8894,0,0
9469,ACGTCGAATCTAGGGA,156,159,3,16,8901,0,0
9470,ACGTCGAATCTAGGGA,156,159,3,13,9016,0,0
9471,ACGTCGAATCTAGGGA,156,159,3,17,9017,0,0
9472,ACGTCGAATCTAGGGA,156,159,3,18,9143,0,0
9473,ACGTCGCATCTAGGGA,156,159,3,16,9144,0,0
9474,ACGTCGAATCTAGGGA,156,159,3,17,9145,0,0
9475,ACGTCGAATCTAGGGA,156,158,2,18,9146,0,0
9476,ACGTCGAATCTAGGGA,156,159,3,11,9147,0,0
9477,ACGTCGAATCTAGGGA,156,159,3,15,9149,0,0
9478,ACGTCGAATCTAGGGA,156,157,1,19,9151,0,0
9479,ACGTCGAATCTAGGGA,156,158,2,13,9153,0,0
9480,ACGTCGAATCTAGGGA,156,159,3,17,9155,0,0
9481,ACGTCGAATCTAGGGA,156,159,3,19,9156,0,0
9482,ACGTAGAATCTAGGGA,156,156,0,15,9157,0,0
9483,ACGTCGAATCTAGGGA,156,159,3,17,9158,0,0
9484,ACGTCGAATCTAGGGA,157,157,0,17,7022,0,0
9485,ACGTCGAATCTAGGGA,157,157,0,16,7690,0,0
9486,ACGTCGAATCTAGGGA,157,168,11,18,7786,2,0
9487,ACGTCGAATCTAGGGA,157,161,4,17,7901,0,0
9488,ACGTCGAATCTAGGGA,157,159,2,14,8202,0,0
9489,ACGTCGAATCTAGGGA,157,163,6,16,8209,0,0
9490,ACGTAGAATCTAGGGA,157,176,19,14,8219,4,0
9491,ACGTCGAATCTAGGGA,157,171,14,16,8221,3,0
9492,ACGTCGAATCTAGGGA,157,157,0,12,8226,0,0
9493,ACGTCGAATCTAGGGA,157,165,8,18,8248,1,0
9494,ACGTCGAATCTAGGGA,157,160,3,17,8336,0,0
9495,ACGTCGAATCTAGGGA,157,162,5,10,8382,0,0
9496,ACGTCGAATCTAGGGA,157,162,5,20,8387,0,0
9497,ACGTCGAATCTAGGGA,157,160,3,17,8413,0,0
9498,ACGTCGAATCTAGGGA,157,195,38,12,8572,11,0
9499,ACGTCGAATCTAGGGA,157,177,20,12,8576,5,0
9500,AGGTCTAATCTAGGGA,157,167,10,19,8710,1,0
9501,ACGTCGAATCTAGGGA,157,179,22,12,8747,5,0
9502,ACGTCGAATCTAGGGA,157,158,1,18,8750,0,0
9503,ACGTCGAATCTAGGGA,157,166,9,12,8753,1,0
9504,ACGTCGAATCTAGGGA,157,172,15,14,8754,3,0
9505,ACGTCGAATCTAGGGA,157,168,11,17,8760,2,0
9506,ACGTCGAATCTAGGGA,157,178,21,17,8761,5,0
9507,ACGTCGATTCTAGGGA,157,159,2,14,8765,0,0
9508,ACGTCGAATCTAGGGA,157,209,52,14,8766,15,0
9509,ACGTCGAATCTAGGGA,157,159,2,14,8770,0,0
9510,ACGTCGAATCTAGGGA,157,159,2,18,8773,0,0
9511,ACGTCGAATCTAGGGA,157,183,26,17,8779,7,0
9512,ACGTCGAATCTAGGGA,157,158,1,18,8785,0,0
9513,ACGTCGAATCTAGGGA,157,167,10,12,8909,1,0
9514,ACGTCGAATCTAGGGA,157,174,17,14,8910,4,0
9515,ACGTCGAATCTAGGGA,157,160,3,18,8912,0,0
9516,ACGTCGAATCTAGGGA,157,161,4,17,8913,0,0
9517,ACGTCGAATCTAGGGA,157,190,33,14,8914,9,0
9518,ACGTCGAATCTAGGGA,157,160,3,17,8915,0,0
9519,ACGTCGAATCTAGGGA,157,160,3,14,8917,0,0
9520,ACGTCGACTCTAGGGA,157,160,3,18,8920,0,0
9521,ACGTCGAATCTAGGGA,157,160,3,19,8922,0,0
9522,ACGTCGAATCTAGGGA,157,160,3,14,8924,0,0
9523,ACGTCGAATCTAGGGA,157,160,3,17,8926,0,0
9524,ACGTCGAATCTAGGGA,157,157,0,18,9095,0,0
9525,ACGTCGAATCTAGGGA,157,160,3,18,9096,0,0
9526,ACGTCGAATCTAGGGA,157,160,3,17,9099,0,0
9527,TCGTCGAATCTAGGGA,157,160,3,18,9103,0,0
9528,ACGTCGAATCTAGGGA,157,160,3,19,9104,0,0
9529,ACGTCGAATCTAGGGA,157,157,0,18,9107,0,0
9530,ACGTCGAATCTAGGGA,157,160,3,18,9110,0,0
9531,ACGTCGAATCTAGGGA,157,160,3,14,9111,0,0
9532,ACGTCGAATCTCGGGA,157,159,2,20,9114,0,0
9533,ACGTCGAATCTAGGGA,157,160,3,15,9116,0,0
9534,ACGTCGAATCTAGGGA,157,159,2,15,9117,0,0
9535,ACGTCGAATCTAGGGA,157,160,3,20,9120,0,0
9536,ACGTCGAATCTAGGGA,157,157,0,18,9123,0,0
9537,ACGTCGAATCTAGGGA,157,157,0,14,9125,0,0
9538,ACGTCGAATCTAGGGA,157,160,3,15,9126,0,0
9539,ACGTCGAATCTAGGGA,157,160,3,14,9129,0,0
9540,ACGTCGAATCTAGGGA,157,159,2,14,9131,0,0
9541,ACGTCGAATCTAGGGA,157,160,3,18,9132,0,0
9542,ACGTCGAATCTAGGGA,157,160,3,19,9137,0,0
9543,ACGTCGAATCTAGGGA,157,160,3,14,9138,0,0
9544,ACGTCTAATCTAGGGA,157,158,1,18,9195,0,0
9545,ACGTCGAATCTAGGGA,157,157,0,17,9196,0,0
9546,ACGTCGAATCTAGGGA,158,170,12,15,7565,2,0
9547,ACGTCGAATCTAGGGA,158,177,19,16,7677,4,0
9548,ACGTCGAATCTAGGGA,158,182,24,12,7756,6,0
9549,ACGTCGAATCTAGGGA,158,164,6,17,7761,0,0
9550,ACGTCGAATCTAGGGA,158,185,27,18,7779,7,0
9551,ACGTCGAATCTAGGGA,158,186,28,18,7917,7,0
9552,ACTTCTAATCTAGGGA,158,181,23,18,7921,6,0
9553,ACGTCGAATCTAGGGA,158,158,0,21,7933,0,0
9554,ACGTCGAATCTAGGGA,158,163,5,16,7990,0,0
9555,AGGTCTAATCTAGGGA,158,162,4,18,7991,0,0
9556,ACGTCGAATCTATGGA,158,167,9,17,8094,1,0
9557,ACGTCGTATCTAGGGA,158,178,20,18,8100,5,0
9558,ACGTCGAATCTAGGGA,158,167,9,18,8116,1,0
9559,ACGTCGAATCTAGGGA,158,180,22,18,8124,5,0
9560,ACGTCGAATCTAGGGA,158,160,2,16,8285,0,0
9561,ACGTCGAATCTAGGGA,158,170,12,19,8294,2,0
9562,ACGTCGAATCTAGGGA,158,166,8,20,8558,1,0
9563,ACGTCGAATCTAGGGA,158,160,2,18,8561,0,0
9564,ACGTCGAATCTAGGGA,158,158,0,16,8612,0,0
9565,ACGTCGAATCTATGGA,158,173,15,17,8613,3,0
9566,ACGTCGAATCTAGGGA,158,176,18,18,8619,4,0
9567,ACGTCGAATCTAGGGA,158,168,10,16,8631,1,0
9568,ACGTCGAATCTAGGGA,158,169,11,13,8632,2,0
9569,ACGTAGAATCTAGGGA,158,160,2,15,8633,0,0
9570,ACGTCGAATCTAGGGA,158,171,13,20,8635,2,0
9571,ACGTCTAATCTAGGGA,158,159,1,20,8638,0,0
9572,ACGTCGAATCTAGGGA,158,180,22,11,8640,5,0
9573,ACGTCGAATCTAGGGA,158,167,9,11,8643,1,0
9574,ACGTCGAATCTAGGGA,158,163,5,13,8644,0,0
9575,ACGTCGAATGTAGGGA,158,160,2,19,8649,0,0
9576,ACGTCGCATCTAGGGA,158,162,4,16,8794,0,0
9577,ACGTCGAATCTAGGGA,158,171,13,18,8796,2,0
9578,ACGTCGAATCTAGGGA,158,164,6,18,8799,0,0
9579,ACGTCGAATCTAGGGA,158,179,21,16,8903,4,0
9580,ACGTCGAATCTAGGGA,158,162,4,12,8905,0,0
9581,ACGTCGAATCTAGGGA,158,158,0,18,8906,0,0
9582,ACGTCGAATCTAGGGA,158,161,3,18,8930,0,0
9583,ACGTCGAATCTAGGGA,158,158,0,16,8965,0,0
9584,ACGTCGAATCTAGGGA,158,161,3,18,8967,0,0
9585,ACGTCGAATCTAGGGA,158,161,3,19,8974,0,0
9586,ACGTCGAATCTAGGGA,158,161,3,18,8979,0,0
9587,ACGTCGAATCTAGGGA,158,161,3,13,8990,0,0
9588,ACGTCGAATCTAGGGA,158,161,3,15,8992,0,0
9589,ACGTCGAATCTAGGGA,158,161,3,13,8993,0,0
9590,ACGTCGAATCTAGGGA,158,161,3,18,8997,0,0
9591,ACGTCGAATCTAGGGA,158,161,3,17,9000,0,0
9592,CCGTCGAATCTAGGGA,158,158,0,21,9002,0,0
9593,ACGCCGAATCGAGGGA,158,161,3,18,9003,0,0
9594,ACGTCGAATCTAGGGA,158,161,3,15,9161,0,0
9595,ACGTCGAATCTAGAGC,158,161,3,20,9163,0,0
9596,ACGTCGACTCTAGGGA,158,161,3,16,9165,0,0
9597,ACGTCGAATCTAGGGA,158,161,3,11,9167,0,0
9598,ACGTCGAATCTAGGGA,158,161,3,21,9168,0,0
9599,ACGTCGAATCTAGGGA,158,161,3,20,9170,0,0
9600,ACGTCGAATCTAGGGA,158,161,3,18,9171,0,0
9601,ACGTCGAATCTAGGGA,158,161,3,18,9173,0,0
9602,ACGTCGAATCTAGGGA,158,161,3,13,9174,0,0
9603,ACGTCGAATCTAGGGA,158,161,3,17,9177,0,0
9604,ACGTCGAATCTAGGGA,158,161,3,19,9180,0,0
9605,ACGTCGATTCTAGGGA,158,161,3,15,9186,0,0
9606,ACGTCGAATCTAGGGA,158,160,2,22,9188,0,0
9607,ACGTCGAATCTAGGGA,158,161,3,15,9189,0,0
9608,ACGTCGACTCTAGGGA,158,161,3,18,9191,0,0
9609,ACGTCGAATCTAGGGA,158,161,3,15,9193,0,0
9610,ACGTCGAATCTAGGGA,158,161,3,19,9194,0,0
9611,ACGTCGAATCTAGGGA,159,160,1,9,6396,0,0
9612,ACGTCGAATCTAGGGA,159,172,13,12,7287,2,0
9613,ACGTCGAATCTAGGGA,159,162,3,17,7308,0,0
9614,ACGTCGAATCTAGGGA,159,162,3,16,7985,0,0
9615,ACGTCGAATCTAGGGA,159,164,5,13,8140,0,0
9616,ACGTCGAATCTAGGGA,159,175,16,16,8259,3,0
9617,ACGTCGAATCTAGGGA,159,166,7,17,8260,0,0
9618,ACGTCGAATCTAGGGA,159,166,7,18,8428,0,0
9619,ACGTCGAATCTAGGGA,159,159,0,18,8497,0,0
9620,ACGTCGAATCTAGGGA,159,162,3,17,8498,0,0
9621,ACGTCGAATCTAGGGA,159,170,11,20,8506,2,0
9622,ACGTCGAATCTCGGGA,159,168,9,19,8514,1,0
9623,ACGTCGAATCTAGGGA,159,189,30,15,8516,8,0
9624,ACGTCGAATCTAGGGA,159,167,8,14,8518,1,0
9625,ACGTCGAATCTAGGGA,159,161,2,14,8521,0,0
9626,ACGTCGAATCTAGGGA,159,170,11,22,8535,2,0
9627,ACGTCGAATCTAGGGA,159,166,7,13,8546,0,0
9628,ACGTCGAATCTAGGGA,159,177,18,14,8547,4,0
9629,ACGTCGAATCTAGGGA,159,196,37,13,8676,10,0
9630,ACGTCTAATCTAGGGA,159,160,1,18,8677,0,0
9631,ACGTCGAATCTAGGGA,159,166,7,13,8678,0,0
9632,ACGTCGAATCTAGGGA,159,166,7,17,8679,0,0
9633,ACGTCGAATCTAGGGA,159,159,0,13,8681,0,0
9634,ATGTCGAATCTAGGGA,159,159,0,16,8688,0,0
9635,ACGTCGAATCTAGGGA,159,160,1,18,8690,0,0
9636,ACGTCGAATCTAGGGA,159,203,44,14,8699,13,0
9637,ACGTCGAATCTAGGGA,159,168,9,15,8870,1,0
9638,ACGTCGAATCTAGGGA,159,170,11,19,8885,2,0
9639,ACGTCGAATCTAGGGA,159,176,17,19,8892,4,0
9640,ACGTCGAATCTAGGGA,159,160,1,17,8893,0,0
9641,ACGTCGAATCTAGGGA,159,159,0,16,8901,0,0
9642,ACGTCGAATCTAGGGA,159,160,1,18,9143,0,0
9643,ACGTCGAATCTAGGGA,159,166,7,17,9145,0,0
9644,ACGTCGAATCTAGGGA,159,161,2,18,9146,0,0
9645,ACGTCGAATCTAGGGA,159,160,1,15,9149,0,0
9646,ACGTCGAATCTAGGGA,159,181,22,19,9151,5,0
9647,ACGTAGAATCTAGGGA,159,173,14,15,9157,3,0
9648,ACGTCGAATCTAGGGA,159,172,13,17,9158,2,0
9649,ACGTCGAATCTAGGGA,159,159,0,18,9198,0,0
9650,ACGTCGAATCTAGGGA,159,168,9,16,9199,1,0
9651,ACGTCGAATCTAGGGA,160,178,18,17,7022,5,0
9652,ACGTCGAATCTAGGGA,160,185,25,16,7690,7,0
9653,ACGTCGAATCTAGGGA,160,181,21,18,7786,5,0
9654,ACGTCGAATCTAGGGA,160,163,3,14,8202,0,0
9655,ACGTCGAATCTAGGGA,160,163,3,16,8209,0,0
9656,ACGTCGAATCTAGGGA,160,163,3,16,8221,0,0
9657,ACGTCGAATCTAGTGA,160,162,2,18,8248,0,0
9658,ACGTCGAATCTAGGGA,160,163,3,17,8336,0,0
9659,ACGTCGAATCTAGGGA,160,160,0,10,8382,0,0
9660,ACGTCGAATCTAGGGA,160,163,3,20,8387,0,0
9661,ACGTCGAATCTAGGGA,160,163,3,17,8413,0,0
9662,ACGTCGAATCTAGGGA,160,163,3,12,8572,0,0
9663,ACGTCGAATCTAGGGA,160,163,3,12,8576,0,0
9664,ACGTCGAATCTAGGGA,160,163,3,12,8747,0,0
9665,ACGTCGAATCTAGGGA,160,163,3,18,8750,0,0
9666,ACGTCGAATCTAGGGA,160,160,0,14,8754,0,0
9667,ACGTCGAATCTAGGGA,160,163,3,17,8761,0,0
9668,ACGTCGATTCTAGGGA,160,163,3,14,8765,0,0
9669,ACGTCGAATCTAGGGA,160,163,3,14,8766,0,0
9670,ACGTCGAATCTAGGGA,160,163,3,14,8770,0,0
9671,ACGTCGAATCTAGGGA,160,163,3,18,8773,0,0
9672,ACGTCGAATCTAGGGA,160,163,3,17,8779,0,0
9673,ACGTCGAATCTAGGGA,160,163,3,12,8909,0,0
9674,ACGTCGAATCTAGGGA,160,162,2,14,8910,0,0
9675,ACGTCGAATCTAGGGA,160,163,3,18,8912,0,0
9676,ACGTCGAATCTAGGGA,160,163,3,17,8913,0,0
9677,ACGTCGAATCTAGGGA,160,161,1,14,8914,0,0
9678,ACGTCGAATCTAGGGA,160,163,3,17,8915,0,0
9679,ACGTCGAATCTAGGGA,160,163,3,14,8917,0,0
9680,ACGTCGACTCTAGGGA,160,163,3,18,8920,0,0
9681,ACGTCGAATCTAGGGA,160,160,0,19,8922,0,0
9682,ACGTCGAATCTAGGGA,160,163,3,14,8924,0,0
9683,ACGTCGAATCTAGGGA,160,160,0,17,8926,0,0
9684,ACGTCGAATCTAGGGA,160,162,2,18,9096,0,0
9685,ACGTCGAATCTAGGGA,160,163,3,17,9099,0,0
9686,TCGTCGAATCTAGGGA,160,163,3,18,9103,0,0
9687,ACGTCGAATCTAGGGA,160,163,3,19,9104,0,0
9688,ACGTCGAATCTAGGGA,160,163,3,18,9110,0,0
9689,ACGTCGAATCTAGGGA,160,163,3,15,9116,0,0
9690,ACGTCGAATCTAGGGA,160,163,3,20,9120,0,0
9691,ACGTCGAATCTAGGGA,160,163,3,18,9123,0,0
9692,ACGTCGAATCTAGGGA,160,163,3,14,9125,0,0
9693,ACGTCGAATCTAGGGA,160,163,3,15,9126,0,0
9694,ACGTCGAATCTAGGGA,160,163,3,14,9129,0,0
9695,ACGTCGAATCTAGGGA,160,163,3,18,9132,0,0
9696,ACGTCGAATCTAGGGA,160,163,3,19,9137,0,0
9697,ACGTCGAATCTAGGGA,160,163,3,14,9138,0,0
9698,ACGTCTAATCTAGGGA,160,163,3,18,9195,0,0
9699,ACGTCGAATCTAGGGA,160,160,0,17,9196,0,0
9700,ACGTCGAATCTAGGGA,160,163,3,18,9261,0,0
9701,ACGTCGAATCTAGGGA,160,161,1,18,9262,0,0
9702,ACGTCGAATCTAGGGA,160,163,3,14,9263,0,0
9703,ACGTCGAATCTAGGGA,160,163,3,17,9264,0,0
9704,ACGTCGAATCTAGGGA,160,163,3,19,9268,0,0
9705,ACGTCGAATCTAGGGA,160,163,3,14,9269,0,0
9706,ACGTCGAATCTAGGGA,160,162,2,18,9270,0,0
9707,ACGTCGAATCTAGGGA,160,163,3,14,9274,0,0
9708,ACGTCGAATCTCGGGA,160,163,3,20,9276,0,0
9709,ACGTCGAATCTAGGGA,160,163,3,15,9278,0,0
9710,ACGTCGAATCTAGGGA,160,163,3,17,9280,0,0
9711,ACGTCGAATCTAGGGA,160,160,0,18,9283,0,0
9712,ACGTCGAATCTAGGGA,160,160,0,14,9284,0,0
9713,ACGTCGAGTCTAGGGA,160,163,3,14,9286,0,0
9714,ACGTCGAATCTAGGGA,160,163,3,14,9288,0,0
9715,ACGTCGAATCTAGGGA,160,163,3,15,9294,0,0
9716,ACGTCGAATCTAGGGA,160,160,0,20,9296,0,0
9717,ACGTCGAATCTAGGGA,160,161,1,17,9301,0,0
9718,ACGTCGAATCTCGGGA,160,160,0,20,9302,0,0
9719,ACGTCGAATCTAGGGA,160,163,3,19,9303,0,0
9720,ACGTCGAATCTCGGGA,160,163,3,20,9304,0,0
9721,ACGTCGAATCTAGGGA,160,163,3,16,9305,0,0
9722,ACGTCGAATCTAGGGA,160,163,3,19,9307,0,0
9723,ACGTCGAATCTAGGGA,160,163,3,20,9308,0,0
9724,ACGTCGCATCTAGGGA,160,160,0,18,9310,0,0
9725,ACGTCGAATCTAGGGA,160,163,3,20,9311,0,0
9726,ACGTCGAATCTAGGGA,160,161,1,18,9312,0,0
9727,ACGTCGAATCTAGGGA,160,163,3,17,9314,0,0
9728,ACGTCGATTCTAGGGA,160,163,3,15,9315,0,0
9729,ACGTCGAATCTAGGGA,161,192,31,16,7677,8,0
9730,ACGTCGAATCTAGGGA,161,163,2,18,7779,0,0
9731,ACGTCGAATCTAGGGA,161,161,0,18,7917,0,0
9732,ACGTCTAATCTAGGGA,161,165,4,18,7921,0,0
9733,ACGTCGAATCTAGGGA,161,173,12,21,7933,2,0
9734,AGGTCTAATCTAGGGA,161,169,8,18,7991,1,0
9735,ACGTCGTATCTAGGGA,161,172,11,18,8100,2,0
9736,ACGTCGAATCTAGGGA,161,166,5,18,8116,0,0
9737,ACGTCGAATCTAGGGA,161,166,5,18,8124,0,0
9738,ACGTCGAATCTAGGGA,161,170,9,16,8285,1,0
9739,ACGTCGAATCTAGGGA,161,184,23,19,8294,6,0
9740,ACGTCGAATCTAGGGA,161,167,6,20,8558,0,0
9741,ACGTCGAATCTAGGGA,161,171,10,18,8561,1,0
9742,ACGTCGAATCTAGGGA,161,164,3,16,8612,0,0
9743,ACGTCGAATCTATGGA,161,168,7,17,8613,0,0
9744,ACGTCGAATCTAGGGA,161,169,8,18,8619,1,0
9745,ACGTCGAATCTAGGGA,161,161,0,13,8632,0,0
9746,ACGTAGAATATAGGGA,161,161,0,15,8633,0,0
9747,ACGTCTAATCTAGGGA,161,180,19,20,8638,4,0
9748,ACGTCGAATCTAGGGA,161,175,14,11,8643,3,0
9749,ACGTCGAATGTAGGGA,161,161,0,19,8649,0,0
9750,ACGTCGCATCTAGGGA,161,173,12,16,8794,2,0
9751,ACGTCGAATCTAGGGA,161,178,17,18,8796,4,0
9752,ACGTCGAATCTAGGGA,161,161,0,18,8799,0,0
9753,ACGTCGAATCTAGGGA,161,171,10,12,8905,1,0
9754,ACGTCGAATCTAGGGA,161,164,3,18,8906,0,0
9755,ACGTCGAATCTAGGGA,161,163,2,18,8930,0,0
9756,ACGTCGAATCTAGGGA,161,163,2,16,8965,0,0
9757,ACGTCGAATCTAGGGA,161,164,3,18,8967,0,0
9758,ACGTCGAATCTAGGGA,161,161,0,19,8974,0,0
9759,ACGTCGAATCTAGGGA,161,182,21,18,8979,5,0
9760,ACGTCGAATCTAGGGA,161,173,12,13,8990,2,0
9761,ACGTCGAATCTAGGGA,161,169,8,15,8992,1,0
9762,ACGTCGAATCTAGGGA,161,164,3,17,9000,0,0
9763,ACGTCGAATCTAGGGA,161,162,1,15,9161,0,0
9764,ACGTCGAATCTAGAGC,161,174,13,20,9163,2,0
9765,ACGTCGACTCTAGGGA,161,162,1,16,9165,0,0
9766,ACGTCGAATCTAGGGA,161,173,12,11,9167,2,0
9767,ACGTCGAATCTAGGGA,161,168,7,21,9168,0,0
9768,ACGTCGAATCTAGGGA,161,168,7,20,9170,0,0
9769,ACGTCGAATCTAGGGA,161,182,21,18,9171,5,0
9770,ACGTCGAATCTAGGGA,161,161,0,18,9173,0,0
9771,ACGTCGACTCTAGGGA,161,165,4,13,9174,0,0
9772,ACGTCGAATCTAGGGA,161,163,2,17,9177,0,0
9773,ACGTCGAATCTAGGGA,161,166,5,19,9180,0,0
9774,ACGTCGAATCTAGGGA,161,164,3,22,9188,0,0
9775,ACGTCGAATCTAGGGA,161,165,4,18,9191,0,0
9776,ACGTCGAATCTAGGGA,161,164,3,15,9193,0,0
9777,ACGTCGAATCTAGGGA,161,185,24,19,9194,6,0
9778,ACGTCGAATCTAGGGA,161,171,10,16,9317,1,0
9779,ACGTCGAATCTAGGGA,161,168,7,18,9318,0,0
9780,ACGTCGAATCTAGGGA,161,175,14,17,9319,3,0
9781,ACGTCGAATCTAGGGA,161,161,0,11,9320,0,0
9782,ACGTCGAATCTAGGGA,161,161,0,19,9321,0,0
9783,ACGTCGAATCTAGGGA,161,179,18,15,9322,4,0
9784,ACGTCGAATCTAGGGA,161,166,5,18,9323,0,0
9785,ACGACGAATCTAGGGA,161,164,3,13,9324,0,0
9786,ACGTCGAATCTAGGGA,161,161,0,15,9325,0,0
9787,ACGTAGAATCTAGGGA,161,168,7,15,9327,0,0
9788,ACGTCGAATCTAGGGA,161,169,8,17,9328,0,0
9789,ACGTCGAATCTAGGGA,161,163,2,13,9329,0,0
9790,ACGTCGAATCTAGGGA,161,191,30,19,9330,7,0
9791,ACGTCGAATCTAGGGA,161,161,0,11,9332,0,0
9792,ACGTCGAATCTAGGGA,161,165,4,13,9335,0,0
9793,ACGTCGAATCTAGGGA,161,161,0,18,9336,0,0
9794,ACGTCGAATCTAGGGA,161,191,30,13,9337,7,0
9795,ACGTCGAATCTAGGGA,162,163,1,9,6396,0,0
9796,ACGTCGAATCTAGGGA,162,174,12,12,7287,2,0
9797,ACGTCGAATCTAGGGA,162,189,27,17,7308,7,0
9798,ACGTCGAATCTAGGGA,162,199,37,16,7985,10,0
9799,GCGTCGAATCTAGGGA,162,162,0,16,8259,0,0
9800,ACGTCGAATCTAGGGA,162,162,0,17,8260,0,0
9801,ACGTCGAATCTCGGGA,162,171,9,19,8514,1,0
9802,ACGTCGAATCTAGGGA,162,171,9,15,8516,1,0
9803,ACGTCGAATCTAGGGA,162,175,13,14,8518,2,0
9804,ACGTCGAATCTAGGGA,162,185,23,14,8521,6,0
9805,ACGTCGAATCTAGGGA,162,165,3,14,8547,0,0
9806,ACGTCGAATCTAGGGA,162,167,5,13,8676,0,0
9807,ACGTCTAATCTAGGGA,162,175,13,18,8677,2,0
9808,ACGTCGAATCTAGGGA,162,162,0,17,8679,0,0
9809,ACGTCGAATCTAGGGA,162,175,13,13,8681,2,0
9810,ACGTCGAATCTAGGGA,162,163,1,18,8690,0,0
9811,ACGTCGAATCTAGGGA,162,165,3,15,8870,0,0
9812,ACGTCGAATCTAGGGA,162,174,12,19,8892,2,0
9813,ACGTCGAATCTAGGGA,162,171,9,17,8893,1,0
9814,ACGTCGAATCTAGGGA,162,191,29,18,9143,8,0
9815,ACGTCGAATCTAGGGA,162,168,6,17,9145,0,0
9816,ACGTCGAATCTAGGGA,162,190,28,18,9146,7,0
9817,ACGTCGAATCTAGGGA,162,163,1,15,9149,0,0
9818,ACGTCGAATCTAGGGA,162,163,1,19,9151,0,0
9819,ACGTCGAATCTAGGGA,162,163,1,17,9158,0,0
9820,ACGTCGAATCTAGGGA,162,172,10,16,9199,1,0
9821,ACGTCGAATCTAGGGA,162,193,31,18,9370,8,0
9822,AGGTCTAATCTAGGGA,162,165,3,19,9377,0,0
9823,ACGTCGAATCTATGGA,162,177,15,18,9378,2,0
9824,ACGTCGAATCTAGGGA,162,165,3,19,9381,0,0
9825,ACGTCGAATCTAGGGA,162,175,13,22,9382,2,0
9826,ACGTCGAATCTAGGGA,162,170,8,17,9383,0,0
9827,ACGTCGAATCTATGGA,162,173,11,18,9389,1,0
9828,ACGTCGAATCTAGGGA,162,168,6,17,9392,0,0
9829,ACGTAGAATCTAGGGA,162,166,4,16,9394,0,0
9830,ACGTCGAATCTAGGGA,162,162,0,21,9395,0,0
9831,ACGTCGAATCTAGGGA,162,168,6,12,9399,0,0
9832,ACGTCGAATCTAGGGA,162,164,2,14,9400,0,0
9833,ACGTCGAATCTAGGGA,163,167,4,17,7022,0,0
9834,ACGTCGAATCTAGGGA,163,173,10,18,7786,1,0
9835,ACGTCGAATCTAGGGA,163,173,10,16,8209,1,0
9836,ACGTCGAATCTAGGGA,163,165,2,16,8221,0,0
9837,ACGTCGAATCTAGGGA,163,171,8,18,8248,1,0
9838,ACGTCGAATCTAGGGA,163,165,2,17,8336,0,0
9839,ACGTCGAATCTAGGGA,163,183,20,20,8387,5,0
9840,ACGTCGAATCTAGGGA,163,166,3,17,8413,0,0
9841,ACGTCGAATCTAGGGA,163,164,1,12,8572,0,0
9842,ACGTCGAATCTAGGGA,163,163,0,12,8747,0,0
9843,ACGTCGAATCTAGGGA,163,169,6,18,8750,0,0
9844,ACGTCGAATCTAGGGA,163,197,34,17,8761,9,0
9845,ACGTCGATTCTAGGGA,163,195,32,14,8765,9,0
9846,ACGTCGAATCTAGGGA,163,165,2,14,8766,0,0
9847,ACGTCGAATCTAGGGA,163,181,18,14,8770,4,0
9848,ACGTCGAATCTAGGGA,163,180,17,18,8773,4,0
9849,ACGTCGAATCTAGGGA,163,199,36,17,8779,10,0
9850,ACGTCGAATCTAGGGA,163,185,22,14,8910,5,0
9851,ACGTCGAATCTAGGGA,163,179,16,18,8912,3,0
9852,ACGTCGAATCTAGGGA,163,164,1,17,8915,0,0
9853,ACGTCGAATCTAGGGA,163,174,11,14,8917,2,0
9854,ACGTCGACTCTAGGGA,163,163,0,18,8920,0,0
9855,ACGTCGAATCTAGGGA,163,170,7,19,8922,0,0
9856,ACGTCGAGTCTAGGGA,163,164,1,14,8924,0,0
9857,ACGTCGAATCTAGGGA,163,182,19,17,8926,4,0
9858,ACGTCGAATCTAGGGA,163,168,5,18,9096,0,0
9859,ACGTCGAATCTAGGGA,163,171,8,17,9099,1,0
9860,TCGTCGAATCTAGGGA,163,217,54,18,9103,16,0
9861,ACGTCGAATCTAGGGA,163,166,3,18,9110,0,0
9862,ACGTCGAATCTAGGGA,163,165,2,20,9120,0,0
9863,ACGTCGAATCTAGGGA,163,166,3,18,9123,0,0
9864,ACGTCGAATCTAGGGT,163,166,3,14,9125,0,0
9865,ACGTCGAATCTAGGGA,163,166,3,15,9126,0,0
9866,ACGTCGAATCTAGGGA,163,163,0,14,9129,0,0
9867,ACGTCGAATCTAGGGA,163,166,3,19,9137,0,0
9868,ACGTCGAATCTAGGGA,163,166,3,14,9138,0,0
9869,ACGTCTAATCTAGGGA,163,165,2,18,9195,0,0
9870,ACGTCGAATCTAGGGA,163,166,3,17,9196,0,0
9871,ACGTCGAATCTAGGGA,163,166,3,18,9261,0,0
9872,ACGTCGAATCTAGGGA,163,166,3,14,9263,0,0
9873,ACGTCGAATCTAGGGA,163,166,3,17,9264,0,0
9874,ACGTCGAATCTAGGGA,163,166,3,19,9268,0,0
9875,ACGTCGAATCTAGGGA,163,166,3,14,9269,0,0
9876,ACGTCGAATCTCGGGA,163,166,3,20,9276,0,0
9877,ACGTCGAATCTAGGGA,163,166,3,15,9278,0,0
9878,ACGTCGAATCTAGGGA,163,166,3,17,9280,0,0
9879,ACGTCGAATCTAGGGA,163,164,1,18,9283,0,0
9880,ACGTCGAATCTAGGGA,163,164,1,14,9286,0,0
9881,ACGTCGAATCTAAGGA,163,166,3,14,9288,0,0
9882,ACGTCGAATCTAGGGA,163,166,3,15,9294,0,0
9883,ACGTCGAATCTAGGGA,163,164,1,20,9296,0,0
9884,ACGTCGAATCTCGGGA,163,165,2,20,9302,0,0
9885,ACGTCGAATCTAGGGA,163,166,3,19,9303,0,0
9886,ACGTCGAATCTCGGGA,163,163,0,20,9304,0,0
9887,ACGTCGAATCTAGGGA,163,166,3,19,9307,0,0
9888,ACGTCGAATCTAGGGA,163,166,3,20,9308,0,0
9889,ACGTCGAATCTAGGGA,163,166,3,20,9311,0,0
9890,ACGTCGAATCTAGGGA,163,166,3,18,9312,0,0
9891,ACGTCGATTCTAGGGA,163,166,3,15,9315,0,0
9892,ACGTCGAATTTAGGGA,163,166,3,19,9340,0,0
9893,ACGTCGAATCTAGGGA,163,166,3,10,9427,0,0
9894,ACGTCGAATCTAGGGA,163,164,1,13,9428,0,0
9895,ACGTCGAATCTAGGGA,163,166,3,18,9435,0,0
9896,ACGTCGAATCTAGGGA,163,163,0,19,9438,0,0
9897,ACGTCGAATCTAGGGA,163,166,3,18,9440,0,0
9898,ACGTCGAATCTAGGGA,163,166,3,21,9441,0,0
9899,ACGTCGAATCTAGGGA,163,166,3,16,9443,0,0
9900,ACGTCGAATCTAGGGA,163,165,2,15,9444,0,0
9901,ACGTCGAATCTAGGGA,163,166,3,17,9446,0,0
9902,ACGTCGAATCTAGGGA,163,166,3,15,9449,0,0
9903,ACGTCTAATCTAGGGA,163,165,2,19,9451,0,0
9904,ACGTCGAATCTAGGGA,163,166,3,14,9452,0,0
9905,ATGTCGAATCTAGGGA,163,166,3,17,9455,0,0
9906,ACGTCGAATCTAGGGA,163,165,2,15,9457,0,0
9907,ACGTCGAATCTAGGGA,163,166,3,12,9460,0,0
9908,ACGTCGAATCTAGGGA,163,163,0,18,9463,0,0
9909,ACGTCGAATCTAGGGA,164,165,1,16,7677,0,0
9910,ACGTCGAATCTAGGGA,164,188,24,18,7779,6,0
9911,ACGTCGAATCTAGGGA,164,172,8,21,7933,1,0
9912,ACGTCGTATCTAGGGA,164,178,14,18,8100,3,0
9913,ACGTCGAATCTAGGGA,164,177,13,18,8116,2,0
9914,ACGTCGAATCTAGGGA,164,165,1,18,8124,0,0
9915,ACGTCGAATCTAGGGA,164,170,6,16,8285,0,0
9916,ACGTCGAATCTAGGGA,164,164,0,19,8294,0,0
9917,ACGTCGAATCTAGGGA,164,164,0,20,8558,0,0
9918,ACGTCGAATCTAGGGA,164,173,9,18,8561,1,0
9919,ACGTCGAATCTATGGA,164,176,12,17,8613,2,0
9920,ACGTCGAATCTAGGGA,164,168,4,13,8632,0,0
9921,ACGTAGAATCTAGGGA,164,166,2,15,8633,0,0
9922,ACGTCTAATCTAGGGA,164,183,19,20,8638,4,0
9923,ACGTCGAATCTAGGGA,164,181,17,11,8643,4,0
9924,ACGTCGAATGTAGGGA,164,165,1,19,8649,0,0
9925,ACGTCGAATCTAGGGA,164,191,27,18,8796,7,0
9926,ACGTCGAATCTAGGGA,164,168,4,18,8799,0,0
9927,ACGTCGAATCTAGGGA,164,172,8,12,8905,1,0
9928,ACGTCGAATCTAGGGA,164,165,1,18,8906,0,0
9929,ACGTCGAATCTAGGGA,164,180,16,18,8930,3,0
9930,ACGTCGAATCTAGGGA,164,175,11,16,8965,2,0
9931,ACGTCGAATCTAGGGA,164,179,15,18,8967,3,0
9932,ACGTCGAATCTAGGGA,164,174,10,19,8974,1,0
9933,ACGTCGAATCTAGGGA,164,176,12,13,8990,2,0
9934,ACGTCGAATCTAGGGA,164,168,4,15,8992,0,0
9935,ACGTCGAATCTAGGGA,164,172,8,17,9000,1,0
9936,ACGTCGAATCTAGGGA,164,176,12,15,9161,2,0
9937,ACGTCGAATCTAGGGA,164,182,18,11,9167,4,0
9938,ACGTCGAATCTAGGGA,164,168,4,21,9168,0,0
9939,ACGTCGAATCTAGGGA,164,165,1,20,9170,0,0
9940,ACGTCGAATCTAGGGA,164,207,43,13,9174,12,0
9941,ACGTCGAATCTAGGGA,164,171,7,17,9177,0,0
9942,ACGTCGAATCTAGGGA,164,195,31,22,9188,8,0
9943,ACGTCGAATCTAGGGA,164,175,11,15,9193,1,0
9944,ACGTCGAATCTAGGGA,164,166,2,19,9194,0,0
9945,ACGTCGAATCTAGGGA,164,180,16,19,9321,3,0
9946,ACGTCGAATCTAGGGA,164,168,4,15,9322,0,0
9947,ACGTCGAATCTAGGGA,164,181,17,18,9323,3,0
9948,ACGTCGAATCTAGGGA,164,169,5,13,9324,0,0
9949,ACGTCGAATCTAGGGA,164,168,4,15,9325,0,0
9950,ACGTAGAATCTAGGGA,164,171,7,15,9327,0,0
9951,ACGTCGAATCTAGGGA,164,167,3,17,9328,0,0
9952,ACGTCGAATCTAGGGA,164,164,0,13,9329,0,0
9953,ACGTCGAATCTAGGGA,164,169,5,19,9330,0,0
9954,ACGTCGAATCTAGGGA,164,165,1,11,9332,0,0
9955,ACGTCGAATCTAGGGA,164,174,10,13,9335,1,0
9956,ACGTCGAATCTAGGGA,164,181,17,20,9464,3,0
9957,ACGTCGAATCTAGGGA,164,171,7,19,9486,0,0
9958,ACGTAGAATCTAGGGA,164,168,4,15,9490,0,0
9959,ACGTCGAATCTAGGGA,164,184,20,17,9491,4,0
9960,ACGTCGAATCTAGGGA,164,179,15,19,9493,2,0
9961,ACGTCGAATCTAGGGA,164,169,5,13,9498,0,0
9962,ACGTCGAATCCAGGGA,164,182,18,13,9499,3,0
9963,AGGTCTAATCTAGGGA,164,169,5,20,9500,0,0
9964,ACGTCGAATCTAGGGA,164,169,5,13,9501,0,0
9965,ACGTCGAATCTAGGGA,164,168,4,13,9503,0,0
9966,ACGTCGAATCTAGGGA,164,165,1,15,9504,0,0
9967,ACGTCGAATCTAGGGA,164,172,8,18,9505,0,0
9968,ACGACGAATCTAGGGA,164,165,1,18,9506,0,0
9969,ACGTCGAATCTAGGGA,164,164,0,15,9508,0,0
9970,ACGTCGAATCTAGGGA,164,167,3,18,9511,0,0
9971,ACGTCGAATCTAGGGA,164,167,3,13,9513,0,0
9972,ACGTCGAATCTAGGGA,164,167,3,15,9514,0,0
9973,ACGTCGAATCTAGGGA,165,183,18,12,7287,4,0
9974,ACGTCGAATCTAGGGA,165,197,32,17,7308,9,0
9975,ACGTCGAATCTAGGGA,165,182,17,16,8259,4,0
9976,ACGTCGAATCTCGGGA,165,168,3,19,8514,0,0
9977,ACGTCGAATCTAGGGA,165,165,0,14,8518,0,0
9978,ACGTCGAATCTAGGGA,165,168,3,14,8521,0,0
9979,ACGTCGAATCTAGGGA,165,168,3,14,8547,0,0
9980,ACGTCGAATCTAGGGA,165,168,3,13,8676,0,0
9981,ACGTCTAATCTAGGGA,165,168,3,18,8677,0,0
9982,ACGTCGAATCTAGGGA,165,168,3,17,8679,0,0
9983,ACGTCTAATCTAGGGA,165,168,3,13,8681,0,0
9984,ACGTCGAATCTAGGGA,165,168,3,18,8690,0,0
9985,ACGTCGAATCTAGGGA,165,168,3,15,8870,0,0
9986,ACGTCGAATCTAGGGA,165,168,3,19,8892,0,0
9987,ACGTCGAATCTAGGGA,165,166,1,17,9145,0,0
9988,ACGTGGAATCTAGGGA,165,167,2,15,9149,0,0
9989,ACGTCGAATCTAGGGA,165,168,3,19,9151,0,0
9990,ACGTCGAATCTAGGGA,165,168,3,17,9158,0,0
9991,AGGTCTAATCTAGGGA,165,168,3,19,9377,0,0
9992,ACGTCGAATCTATGGA,165,165,0,18,9378,0,0
9993,ACGTCGAATCTAGGGA,165,165,0,19,9381,0,0
9994,ACGTCGAATCTAGGGA,165,168,3,17,9383,0,0
9995,ACGTCGAATCTATGGA,165,168,3,18,9389,0,0
9996,ACGTCGAATCTAGGGA,165,168,3,17,9392,0,0
9997,ACGTAGAATCTAGGGA,165,165,0,16,9394,0,0
9998,ACGTCGAATCTAGGGA,165,168,3,21,9395,0,0
9999,ACGTCGAATCTAGGGA,165,168,3,12,9399,0,0
10000,ACGTCGAATCTAGGGA,165,168,3,14,9400,0,0
10001,ACGTCGAATCTAGGGA,165,168,3,15,9517,0,0
10002,ACGTCGAATCTAGGGA,165,168,3,16,9546,0,0
10003,ACGTCGAATCTAGGGA,165,168,3,17,9547,0,0
10004,ACGTCGAATCTAGGGA,165,168,3,13,9548,0,0
10005,ACGTCGAATCTAGGGA,165,166,1,19,9550,0,0
10006,ACGTCGAATCTAGGGA,165,168,3,19,9551,0,0
10007,ACTTCTAATCTAGGGA,165,166,1,19,9552,0,0
10008,ACGTCGAATCTATGGA,165,168,3,18,9556,0,0
10009,ACGTCGTATCTAGGGA,165,168,3,19,9557,0,0
10010,ACGTCGAATCTAGGGA,165,168,3,19,9558,0,0
10011,ACGTCGAATCTAGGGA,165,168,3,19,9559,0,0
10012,ACGTCGAATCTAGGGA,165,168,3,20,9561,0,0
10013,ACGTCGAATCTAGGGA,165,168,3,21,9562,0,0
10014,ACGTCGAATCTATGGA,165,166,1,18,9565,0,0
10015,ACGTCGAATCTAGGGA,165,168,3,19,9566,0,0
10016,ACGTCGAATCTAGGGA,165,166,1,17,9567,0,0
10017,ACGTCGAATCTAGGGA,165,168,3,14,9568,0,0
10018,ACGTCGAATCTAGGGA,165,168,3,21,9570,0,0
10019,ACGTCGAATCTAGGGA,165,167,2,12,9572,0,0
10020,ACGTCGAATCTAGGGA,165,168,3,12,9573,0,0
10021,ACGTCGAATCTAGGGA,165,168,3,18,9651,0,0
10022,ACGTCGAATCTAGGGA,165,168,3,17,9652,0,0
10023,ACGTCGAATCTAGGGA,166,180,14,17,7022,3,0
10024,ACGTCGAATCTAGGGA,166,179,13,18,7786,2,0
10025,ACGTCGAATCTAGGGA,166,173,7,16,8221,0,0
10026,ACGTCGAATCTAGGGA,166,171,5,18,8248,0,0
10027,ACGTCGAATCTAGGGA,166,181,15,17,8336,3,0
10028,ACGTCGAATCTAGGGA,166,167,1,17,8413,0,0
10029,ACGTCGAATCTAGGGA,166,169,3,12,8572,0,0
10030,ACGTCGAATCTAGGGA,166,176,10,12,8747,1,0
10031,ACGTCGATTCTAGGGA,166,181,15,14,8765,3,0
10032,ACGTCGAATCTAGGGA,166,183,17,14,8766,4,0
10033,ACGTCGAATCTAGGGA,166,168,2,14,8770,0,0
10034,ACGTCGAATCTAGGGA,166,191,25,18,8773,6,0
10035,ACGTCGAATCTAGGGA,166,177,11,17,8779,2,0
10036,ACGTCGAATCTAGGGA,166,169,3,18,8912,0,0
10037,ACGTCGAATCTAGGGA,166,167,1,17,8915,0,0
10038,ACGTCGAATCTAGGGA,166,172,6,14,8917,0,0
10039,ACGTCGACTCTAGGCA,166,166,0,18,8920,0,0
10040,ACGTCGAATCTAGGGA,166,182,16,19,8922,3,0
10041,ACGTCGAATCTAGGGA,166,185,19,14,8924,4,0
10042,ACGTCGAATCTAGGGA,166,168,2,18,9096,0,0
10043,ACGTCGAATCTAGGGA,166,182,16,17,9099,3,0
10044,TCGCCGAATCTAGGGA,166,168,2,18,9103,0,0
10045,ACGTCGAATCTAGGGA,166,167,1,18,9110,0,0
10046,ACGTCGAATCTAGGGA,166,173,7,20,9120,0,0
10047,ACGTCGAATCTAGGGA,166,172,6,14,9125,0,0
10048,ACGTCGAATCTAGGGA,166,167,1,19,9137,0,0
10049,ACGTCGAATCTAGGGA,166,169,3,14,9138,0,0
10050,ACGTCTAATCTAGGGA,166,169,3,18,9195,0,0
10051,ACGTCGAATCTAGGGA,166,210,44,17,9196,13,0
10052,ACGTCGAATCTAGGGA,166,168,2,18,9261,0,0
10053,ACGTCGAATCTAGGGA,166,166,0,14,9263,0,0
10054,ACGTCGAATCTAGGGA,166,167,1,17,9264,0,0
10055,ACGTCGAATCTAGGGA,166,202,36,19,9268,10,0
10056,ACGTCGAATCTAGGGA,166,166,0,15,9278,0,0
10057,ACGTCGAATCTAGGGA,166,167,1,18,9283,0,0
10058,ACGTCGAATCTAGGGA,166,166,0,14,9286,0,0
10059,ACGTCGAATCTAGGGA,166,171,5,15,9294,0,0
10060,ACGTCGAATCTAGGGA,166,173,7,20,9296,0,0
10061,ACGTCGAATCTCGGGA,166,170,4,20,9302,0,0
10062,ACGTCGAATCTAGGGA,166,173,7,19,9303,0,0
10063,ACGTCGAATCTAGGGA,166,170,4,20,9308,0,0
10064,ACGTCGAATCTAGGGA,166,171,5,20,9311,0,0
10065,ACGTCGAATCTAGGGA,166,199,33,18,9312,9,0
10066,ACGTCGAATCTAGGGA,166,171,5,19,9340,0,0
10067,ACGTCGAATCTAGGGA,166,170,4,10,9427,0,0
10068,ACGTCGAATCTAGGGA,166,204,38,13,9428,10,0
10069,ACGTCGAATCTAGGGA,166,180,14,19,9438,2,0
10070,ACGTCGAATCTAGGGA,166,200,34,18,9440,9,0
10071,ACGTCGAATCTAGGGA,166,172,6,21,9441,0,0
10072,ACGTCGAATCTAGGGA,166,172,6,17,9446,0,0
10073,ACGTCTAATCTAGGGA,166,192,26,19,9451,6,0
10074,ATGTCGAATCTAGGGA,166,174,8,17,9455,0,0
10075,ACGTCGAATCTAGGGA,166,172,6,15,9457,0,0
10076,ACGTCGAATCTAGGGA,166,177,11,18,9463,1,0
10077,ACGTCGAATCTAGGGA,166,177,11,13,9612,1,0
10078,ACGTCGAATCTAGGGA,166,192,26,17,9616,6,0
10079,ACGTCGAATCTAGGGA,166,179,13,21,9621,2,0
10080,ACGTCGAATCTCGGGA,166,191,25,20,9622,6,0
10081,ACGTCGAATCTAGGGA,166,173,7,16,9623,0,0
10082,ACGTCGAATCTAGGGA,166,175,9,15,9624,0,0
10083,ACGTCGAATCTAGGGA,166,175,9,23,9626,0,0
10084,ACGTCGAATCTAGGGA,166,176,10,15,9628,1,0
10085,ACGTCGAATCTAGGGA,166,174,8,14,9629,0,0
10086,ACGTCGAATCTAGGGA,166,167,1,15,9636,0,0
10087,ACGTCGAATCTAGGGA,166,178,12,16,9637,1,0
10088,ACGTCGAATCTAGGGA,166,170,4,20,9638,0,0
10089,ACGTCGAATCTAGGGA,166,173,7,20,9639,0,0
10090,ACGTCGAATCTAGGGA,166,166,0,20,9646,0,0
10091,ACGTAGAATCTAGGGA,166,169,3,16,9647,0,0
10092,ACGTCGAATCTAGGGA,166,173,7,18,9648,0,0
10093,ACGTCGAATCTAGGGA,166,170,4,17,9650,0,0
10094,ACGTCGAATCTAGGGA,166,167,1,19,9653,0,0
10095,ACGTCGAATCTAGGGA,167,168,1,21,7933,0,0
10096,ACGTCGTATCTAGGGA,167,174,7,18,8100,0,0
10097,ACGTCGAATCTAGGGA,167,169,2,18,8116,0,0
10098,ACGTCGAATCTAGGGA,167,168,1,18,8124,0,0
10099,ACGTCGAATCTAGGGA,167,169,2,16,8285,0,0
10100,ACGTCGAATCTAGGGA,167,169,2,19,8294,0,0
10101,ACGTCGAATCTAGGGA,167,172,5,20,8558,0,0
10102,ACGTCGAATCTAGGGA,167,170,3,18,8561,0,0
10103,ACGTCGAATCTATGGA,167,170,3,17,8613,0,0
10104,ACGTCGAATCTAGGGA,167,170,3,13,8632,0,0
10105,ACGTAGAATCTAGGGA,167,170,3,15,8633,0,0
10106,ACGTCTAATCTAGGGA,167,170,3,20,8638,0,0
10107,ACGTCGAATCTAGGGA,167,170,3,11,8643,0,0
10108,ACGTCGAATGTAGGGA,167,170,3,19,8649,0,0
10109,ACGTCGAATCTAGGGA,167,170,3,18,8796,0,0
10110,ACGTCGAATCTAGGGA,167,170,3,18,8799,0,0
10111,ACGTCGAATCTAGGGA,167,170,3,12,8905,0,0
10112,ACGTCGAATCTAGGGA,167,169,2,18,8930,0,0
10113,ACGTCGAATCTAGGGA,167,170,3,18,8967,0,0
10114,ACGTCGAATCTAGGGA,167,168,1,19,8974,0,0
10115,ACGTCGAATCTAGGGA,167,168,1,13,8990,0,0
10116,ACGTCGAATCTAGGGA,167,170,3,15,8992,0,0
10117,ACGTCGAATCTAGGGA,167,170,3,17,9000,0,0
10118,ACGTCGAATCTAGGGA,167,170,3,15,9161,0,0
10119,ACGTCGAATCTAGGGA,167,170,3,20,9170,0,0
10120,ACGTCGAATCTAGGGA,167,170,3,17,9177,0,0
10121,ACGTCGAATCTAGGGA,167,170,3,22,9188,0,0
10122,ACGTCGAATCTAGGGA,167,170,3,19,9194,0,0
10123,ACGTCGAATCTAGGGA,167,170,3,15,9322,0,0
10124,ACGTCGAATCTAGGGA,167,170,3,13,9324,0,0
10125,ACGTCGAATCTAGGGA,167,168,1,15,9325,0,0
10126,ACGTAGAATCTAGGGA,167,168,1,15,9327,0,0
10127,ACGTCGAATCTAGGGA,167,170,3,17,9328,0,0
10128,ACGTCGAATCTAGGGA,167,170,3,13,9329,0,0
10129,ACGTCGAATCTAGGGA,167,170,3,19,9330,0,0
10130,ACGTCGAATCTAGGGA,167,170,3,11,9332,0,0
10131,ACGTCGAATCTAGGGA,167,167,0,20,9464,0,0
10132,ACGTCGAATCTAGGGA,167,169,2,19,9486,0,0
10133,ACGTAGAATCTAGGGA,167,168,1,15,9490,0,0
10134,ACGTCGAATCTAGGGA,167,167,0,17,9491,0,0
10135,ACGTTGAATCTAGGGA,167,169,2,13,9498,0,0
10136,ACGTCGAATCTAGGGA,167,170,3,13,9499,0,0
10137,ACGTCGAATCTAGGGA,167,170,3,13,9501,0,0
10138,ACGTCGAATCTAGGGA,167,170,3,15,9504,0,0
10139,ACGTCGAATCTAGGGA,167,167,0,18,9505,0,0
10140,ACGTCGAATCTAGGGA,167,170,3,18,9506,0,0
10141,ACGTCGAATCTAGGGA,167,170,3,15,9508,0,0
10142,ACGTCGAATCTAGGGA,167,169,2,18,9511,0,0
10143,ACGTCGAATCTAGGGA,167,170,3,15,9514,0,0
10144,ACGTCGAATCTAGGGA,167,168,1,19,9577,0,0
10145,ACGTCGAATCTAGGGA,167,168,1,17,9579,0,0
10146,ACGTCGAATCTAGGGA,168,172,4,17,7308,0,0
10147,ACGTCGAATCTAGGGA,168,196,28,16,8259,7,0
10148,ACGTCGAATCTAGGGA,168,189,21,14,8547,5,0
10149,ACGTCGAATCTAGGGA,168,189,21,13,8681,5,0
10150,ACGTCGAATCTAGGGA,168,175,7,18,8690,0,0
10151,ACGTCGAATCTAGGGA,168,171,3,15,8870,0,0
10152,ACGTCGAATCTAGGGA,168,174,6,19,8892,0,0
10153,ACGTCGAATCTAGGGA,168,178,10,17,9145,1,0
10154,ACGTCGAATCTAGGGA,168,208,40,19,9151,11,0
10155,AGGTCTAATCTAGGGA,168,172,4,19,9377,0,0
10156,ACGTCGAATCTATGGA,168,171,3,18,9378,0,0
10157,ACGTCGAATCTAGGGA,168,173,5,19,9381,0,0
10158,ACGTCGAATCTATGGA,168,168,0,18,9389,0,0
10159,ACGTCGAATCTAGGGA,168,171,3,17,9392,0,0
10160,ACGTAGAATCTAGGGA,168,173,5,16,9394,0,0
10161,ACGTCGAATCTAGGGA,168,182,14,21,9395,3,0
10162,ACGTCGAATCTAGGGA,168,168,0,14,9400,0,0
10163,ACGTCGAATCTAGGGA,168,185,17,15,9517,4,0
10164,ACGTCGAATCTAGGGA,168,171,3,16,9546,0,0
10165,ACGTCGAATCTAGGGA,168,173,5,17,9547,0,0
10166,ACGTCGAATCTAGGGA,168,170,2,13,9548,0,0
10167,ACGTCGAATCTAGGGA,168,180,12,19,9550,2,0
10168,ACGTCGAATCTAGGGA,168,172,4,19,9551,0,0
10169,ACTTCTAATCTAGGGA,168,177,9,19,9552,1,0
10170,ACGTCGTATCTAGGGA,168,171,3,19,9557,0,0
10171,ACGTCGAATCTAGGGA,168,176,8,19,9559,1,0
10172,ACGTCGAATCTAGGGA,168,173,5,20,9561,0,0
10173,ACGTCGAATCTATGGA,168,168,0,18,9565,0,0
10174,ACGTCGAATCTAGGGA,168,170,2,19,9566,0,0
10175,ACGTCGAATCTAGGGA,168,172,4,14,9568,0,0
10176,ACGTCGAATCTAGGGA,168,178,10,21,9570,1,0
10177,TCGTCGAATCTAGGGA,168,171,3,12,9572,0,0
10178,ACGTCGAATCTAGGGA,168,169,1,18,9651,0,0
10179,ACGTCGAATCTAGGGA,168,170,2,17,9652,0,0
10180,ACGTCGAATCTAAGGA,168,202,34,17,9729,9,0
10181,ACGTCGAATCTAGGGA,168,179,11,22,9733,2,0
10182,AGGTCTAATCTAGGGA,168,168,0,19,9734,0,0
10183,ACGTCGTATCTAGGGA,168,174,6,19,9735,0,0
10184,ACGTCGAATCTAGGGA,168,186,18,17,9738,3,0
10185,ACGTCGAATCTAGGGA,168,178,10,20,9739,1,0
10186,ACGTCGAATCTAGGGA,168,181,13,19,9741,2,0
10187,ACGTCGAATCTAGGGA,168,173,5,19,9744,0,0
10188,ACGTCTAATCTAGGGA,168,169,1,21,9747,0,0
10189,ACGTCGAATCTAGGGA,168,169,1,12,9748,0,0
10190,ACGTCGCATCTAGGGA,168,182,14,17,9750,2,0
10191,ACGTCGAATCTAGGGA,168,183,15,19,9751,2,0
10192,ACGTCGAATCTAGGGA,168,179,11,13,9753,1,0
10193,ACGTCGAATCTAGGGA,168,178,10,19,9759,1,0
10194,ACGTCGAATCTAGGGA,168,183,15,14,9760,2,0
10195,ACGTCGAATCTAGGGA,168,174,6,16,9761,0,0
10196,ACGTCGAATCTAGAGC,168,181,13,21,9764,2,0
10197,ACGTCGAATCTAGGGA,168,168,0,12,9766,0,0
10198,ACGTCGAATCTAGGGA,168,182,14,19,9769,2,0
10199,ACGTCGAATCTAGGGA,168,200,32,20,9777,8,0
10200,ACGTCGAATCTAGGGA,168,168,0,17,9778,0,0
10201,ACGTCGAATCTAGGGA,168,175,7,18,9780,0,0
10202,ACGTCGAATCTAGGGA,168,168,0,16,9783,0,0
10203,ACGTCGAATCTAGGGA,169,209,40,18,7786,11,0
10204,ACGTCGAATCTAGGGA,169,169,0,16,8221,0,0
10205,ACGTCGAATCTAGGGA,169,172,3,18,8248,0,0
10206,ACGTCGAATCTAGGGA,169,172,3,17,8336,0,0
10207,ACGTCGAATCTAGGGA,169,171,2,17,8413,0,0
10208,ACGTCGAATCTAGGGA,169,171,2,12,8572,0,0
10209,ACGTCGAATCTAGGGA,169,172,3,12,8747,0,0
10210,ACGTCGATTCTAGGGA,169,170,1,14,8765,0,0
10211,ACGTCGAATCTAGGGA,169,172,3,14,8770,0,0
10212,ACGTCGAATCTAGGGA,169,172,3,18,8773,0,0
10213,ACGTCGAATCTAGGGA,169,170,1,17,8779,0,0
10214,ACGTCGAATCTAGGGA,169,172,3,17,8915,0,0
10215,ACGTCGAATCTAGGGA,169,172,3,14,8917,0,0
10216,ACGTCGAATCTAGGGA,169,172,3,19,8922,0,0
10217,ACGTCGAATCTAGGGA,169,172,3,14,8924,0,0
10218,ACGTCGAATCTAGGGA,169,169,0,18,9096,0,0
10219,ACGTCGAATCTAGGGA,169,172,3,20,9120,0,0
10220,ACGTCGAATCTAGGGA,169,172,3,14,9125,0,0
10221,ACGTCGAATCTAGGGA,169,172,3,19,9137,0,0
10222,ACGTCGAATCTAGGGA,169,172,3,14,9138,0,0
10223,ACGTCTAATCTAGGGA,169,172,3,18,9195,0,0
10224,ACGTCGAATCTAGGGA,169,172,3,17,9196,0,0
10225,ACGTCGAATCTAGGGA,169,172,3,18,9261,0,0
10226,ACGTCGAATCTAGGGA,169,170,1,14,9263,0,0
10227,ACGTCGAATCTAGGGA,169,172,3,17,9264,0,0
10228,ACGTCGAATCTAGGGA,169,172,3,19,9268,0,0
10229,ACGTCGAATCTAGGGA,169,169,0,18,9283,0,0
10230,ACGTCGAATCTAGGGA,169,172,3,14,9286,0,0
10231,ACGTCGAATCTAGGGA,169,172,3,15,9294,0,0
10232,ACGTCGAATCTAGGGA,169,172,3,19,9303,0,0
10233,ACGTCGAATCTAGGGA,169,172,3,20,9308,0,0
10234,ACGTCGAATCTAGGGA,169,169,0,18,9312,0,0
10235,ACGTCGAATCTAGGGA,169,170,1,19,9340,0,0
10236,ACGTCGAATCTAGGGA,169,172,3,19,9438,0,0
10237,ACGTCGAATCTAGGGA,169,172,3,18,9440,0,0
10238,ACGTCGAATCTAGGGA,169,172,3,21,9441,0,0
10239,ACGTCGAATCTAGGGA,169,169,0,17,9446,0,0
10240,ACGTCTAATCTAGGGA,169,172,3,19,9451,0,0
10241,ACGTCGAATCTAGGGA,169,172,3,15,9457,0,0
10242,ACGTCGAATCTAGGGA,169,170,1,13,9612,0,0
10243,ACGTCGAATCTAGGGA,169,172,3,17,9616,0,0
10244,ACGTCGAATCTAGGGA,169,172,3,21,9621,0,0
10245,ACGTCGAATCTAGGGA,169,169,0,16,9623,0,0
10246,ACGTCGAATCTAGAGA,169,172,3,23,9626,0,0
10247,ACGTCGAATCTAGGGA,169,170,1,15,9628,0,0
10248,ACGTCGAATCTAGGGA,169,172,3,14,9629,0,0
10249,ACGTCGAATCTAGGGA,169,170,1,15,9636,0,0
10250,ACGTCGAATCTAGGGA,169,172,3,20,9638,0,0
10251,ACGTCGAATCTAGGGA,169,171,2,20,9639,0,0
10252,ACGTCGAATCTAGGGA,169,169,0,20,9646,0,0
10253,ACGTAGAATCTAGGGA,169,171,2,16,9647,0,0
10254,ACGTCGAATCTAGGGA,169,172,3,18,9648,0,0
10255,ACGTCGAATCTAGGGA,169,172,3,19,9653,0,0
10256,ACGTCGAATCTAGGGA,169,172,3,13,9796,0,0
10257,ACGACGAATCTAGGGA,169,172,3,18,9797,0,0
10258,ACGTCGAATCTAGGGA,169,172,3,17,9798,0,0
10259,ACGTCGAATCTCGGGA,169,169,0,20,9801,0,0
10260,ACGTCGAATCTAGGGA,169,172,3,16,9802,0,0
10261,ACGTCGAATCTAGGGA,169,172,3,15,9803,0,0
10262,ACGTCGAATCTAGGGA,169,172,3,15,9804,0,0
10263,ACGTCTAATCTAGGGA,169,170,1,19,9807,0,0
10264,ACGTCGAATCTAGGGA,169,171,2,14,9809,0,0
10265,ACGTCGAATCTAGGGA,169,171,2,20,9812,0,0
10266,ACGTCGAATCTAGGGA,169,172,3,18,9813,0,0
10267,ACGTCGAATCTAGGGA,169,170,1,19,9814,0,0
10268,ACGTCGAATCTAGGGA,170,178,8,21,7933,1,0
10269,ACGTCGTATCTAGGGA,170,172,2,18,8100,0,0
10270,ACGTCGAATCTAGGGA,170,182,12,18,8124,2,0
10271,ACGTCGAATCTAGGGA,170,183,13,16,8285,2,0
10272,ACGTCGAATCTAGGGA,170,171,1,19,8294,0,0
10273,ACGTCGAATCTAGGGA,170,179,9,18,8561,1,0
10274,ACGTCGAATCTATGGA,170,183,13,17,8613,2,0
10275,ACGTCGAATCTAGGGA,170,190,20,13,8632,5,0
10276,ACGTCTAATCTAGGGA,170,173,3,20,8638,0,0
10277,ACGTCGAATCTAGGGA,170,178,8,11,8643,1,0
10278,ACGTCGAATGTAGGGA,170,175,5,19,8649,0,0
10279,ACGTCGAATCTAGGGA,170,176,6,18,8796,0,0
10280,ACGTCGAATCTAGGGA,170,182,12,12,8905,2,0
10281,ACGTCGCATCTAGGGA,170,183,13,18,8930,2,0
10282,ACGTCGAATCTAGGGA,170,170,0,18,8967,0,0
10283,ACGTCGAATCTAGGGA,170,171,1,15,8992,0,0
10284,ACGTCGAATCTAGGGA,170,205,35,17,9000,10,0
10285,ACGTCGAATCTAGGGA,170,177,7,20,9170,0,0
10286,ACGCCGAATCTAGGGA,170,171,1,17,9177,0,0
10287,ACGTCGAATCTAGGGA,170,183,13,22,9188,2,0
10288,ACGTCGAATCTAGGGA,170,185,15,19,9194,3,0
10289,ACGTCGAATCTAGGGA,170,179,9,15,9322,1,0
10290,ACGTCGAATCTAGGGA,170,176,6,13,9324,0,0
10291,ACTTCGAATCTAGGGA,170,171,1,15,9325,0,0
10292,ACGTAGAATCTAGGGA,170,197,27,15,9327,7,0
10293,ACGTCGAATCTAGGGA,170,170,0,17,9328,0,0
10294,ACGTCGAATCTAGGGA,170,171,1,19,9330,0,0
10295,ACGTCGAATCTAGGGA,170,170,0,11,9332,0,0
10296,ACGTCGAATCTAGGGA,170,183,13,20,9464,2,0
10297,ACGTAGAATCTAGGGA,170,178,8,15,9490,1,0
10298,ACGTCGAATCTAGGGA,170,182,12,17,9491,2,0
10299,ACGTCGAATCTAGGGA,170,172,2,13,9498,0,0
10300,ACGTCGAATCTAGGGA,170,182,12,13,9499,2,0
10301,ACGTCGAATCTAGGGA,170,179,9,13,9501,1,0
10302,ACGTCGAATCTAGGGA,170,171,1,15,9504,0,0
10303,ACGTCGAATCTAGGGA,170,177,7,18,9506,0,0
10304,ACGTCGAATCTAGGGA,170,184,14,15,9508,3,0
10305,ACGTCGAATCTAGGGA,170,171,1,18,9511,0,0
10306,ACGTCGAATCTAGGGA,170,183,13,15,9514,2,0
10307,ACGTCGAATCTAGGGA,170,176,6,19,9577,0,0
10308,ACGTCGAATCTAGGGA,170,172,2,17,9579,0,0
10309,ACGTCGAATCTAGGGA,170,172,2,20,9790,0,0
10310,ACGTCGAATCTAGGGA,170,177,7,14,9794,0,0
10311,ACGTCGAATCTAGGGA,170,176,6,19,9834,0,0
10312,ACGTCGAATCTAGGGA,170,183,13,17,9835,2,0
10313,ACGTCGAATCGAGGGA,170,173,3,19,9837,0,0
10314,ACGTCGAATCTAGGGA,170,172,2,21,9839,0,0
10315,ACGTCGAATCTAGGGA,170,189,19,18,9844,4,0
10316,ACGTCGATTCTAGGGA,170,171,1,15,9845,0,0
10317,ACGTCGAATCTAGGGA,170,171,1,15,9847,0,0
10318,ACGTCGAATCTAGGGA,170,190,20,19,9848,5,0
10319,ACGTCGAATCTAGGGA,170,173,3,18,9849,0,0
10320,ACGTCGAATCTAGGGA,170,171,1,15,9850,0,0
10321,ACGTCGAATCTAGGGA,170,186,16,19,9851,3,0
10322,ACGTCGAATCTAGGGA,170,175,5,15,9853,0,0
10323,ACGTCGAATCTAGGGA,170,171,1,18,9857,0,0
10324,ACGTCGAATCTAGGGA,170,178,8,18,9859,1,0
10325,TCGTCGAATCTAGGGA,170,176,6,19,9860,0,0
10326,ACGTCGAATCTAGGGA,171,178,7,17,7308,1,0
10327,ACGTCGAATCTAGGGA,171,194,23,16,8259,6,0
10328,ACGTCGAATCTAGGGA,171,195,24,18,8690,7,0
10329,ACGTCGAATCTAGGGA,171,174,3,19,8892,0,0
10330,ACGTCGAATCTAGGGA,171,185,14,17,9145,3,0
10331,ACGTCGAATCTAGGGA,171,176,5,19,9151,0,0
10332,AGGTCTAATCTAGGGA,171,176,5,19,9377,0,0
10333,ACGTCGAATCTATGGA,171,176,5,18,9378,0,0
10334,ACCTCGAATCTATGGA,171,175,4,18,9389,0,0
10335,ACGTCGAATCTAGGGA,171,177,6,17,9392,0,0
10336,ACGTCGAATCTAGGGA,171,175,4,15,9517,0,0
10337,ACGTCGAATCTAGGGA,171,189,18,17,9547,4,0
10338,ACGTCGAATCTAGGGA,171,172,1,13,9548,0,0
10339,ACGTCGAATCTAGGGA,171,172,1,19,9550,0,0
10340,ACGTCGAATCTAGGGA,171,175,4,19,9551,0,0
10341,ACTTCTAATCTAGGGA,171,174,3,19,9552,0,0
10342,ACGTCGTATCTAGGGA,171,171,0,19,9557,0,0
10343,ACGTCGAATCTAGGGA,171,185,14,19,9559,3,0
10344,ACGTCGAATCTATGGA,171,171,0,18,9565,0,0
10345,ACGTCGAATCTAGGGA,171,171,0,19,9566,0,0
10346,ACGTCGAATCTAGGGA,171,171,0,12,9572,0,0
10347,ACGTCGAATCTAGGGA,171,182,11,18,9651,2,0
10348,ACGTCGAATCTAGGGA,171,175,4,17,9652,0,0
10349,ACGTCGAATCTAGGGA,171,188,17,17,9729,4,0
10350,ACGTCGAATCTAGGGA,171,175,4,22,9733,0,0
10351,ACGTCGTATCTAGGGA,171,179,8,19,9735,1,0
10352,ACGTCGAATCTAGGGA,171,175,4,20,9739,0,0
10353,ACGTCTAATCTAGGGA,171,171,0,21,9747,0,0
10354,ACGTCGAATCTAGGGA,171,176,5,12,9748,0,0
10355,ACGTCGCATCTAGGGA,171,175,4,17,9750,0,0
10356,ACGTCGAATCTAGGGA,171,176,5,19,9751,0,0
10357,ACGTCGAATCTAGGGA,171,175,4,19,9759,0,0
10358,ACGTCGAATCTAGGGA,171,174,3,14,9760,0,0
10359,ACGTCGAATCTAGAGC,171,174,3,21,9764,0,0
10360,ACGTCGAATCTAGGGA,171,174,3,12,9766,0,0
10361,ACGTCGAATCTAGGGA,171,174,3,19,9769,0,0
10362,ACGTCGAATCTAGGGA,171,174,3,20,9777,0,0
10363,ACGTCGAATCTAGGGA,171,174,3,18,9780,0,0
10364,ACGTCGAATCTAGGGA,171,174,3,16,9783,0,0
10365,ACGTCGAATCTAGGGA,171,174,3,19,9816,0,0
10366,ACGTCGAATCTAGGGA,171,174,3,17,9820,0,0
10367,ACGTCGAATCTAGGGA,171,174,3,19,9821,0,0
10368,ACGTCGAATCTATGGA,171,174,3,19,9823,0,0
10369,ACGTCGAATCTAGGGA,171,172,1,23,9825,0,0
10370,ACGTCGAATCTATGGA,171,174,3,19,9827,0,0
10371,ACGTCGAATCTAGGGA,171,174,3,19,9910,0,0
10372,ACGTCGAATCTAGGGA,171,174,3,22,9911,0,0
10373,ACGTCGTATCTAGGGA,171,174,3,19,9912,0,0
10374,ACGTCGAATCTAGGGA,171,173,2,19,9913,0,0
10375,ACGTCGAATCTAGGGA,171,174,3,19,9918,0,0
10376,ACGTCGAATCTATGGA,171,174,3,18,9919,0,0
10377,ACGTCTAATCTAGGGA,171,174,3,21,9922,0,0
10378,ACGTCGAATCTAGGGA,171,174,3,12,9923,0,0
10379,ACGTCGAATCTAGGGA,171,174,3,19,9925,0,0
10380,ACGTCGAATCTAGGGA,171,174,3,13,9927,0,0
10381,ACGTCGAATCTAGGGA,171,174,3,19,9929,0,0
10382,ACGTCGAATCTAGGGA,171,174,3,17,9930,0,0
10383,ACGTCGAATCTAGGGA,171,174,3,19,9931,0,0
10384,ACGTCGAATCTAGGGA,171,174,3,20,9932,0,0
10385,ACGTCGAATCTAGGGA,171,174,3,14,9933,0,0
10386,ACGTCGAATCTAGGGA,171,171,0,18,9935,0,0
10387,ACGTCGAATCTAGGGA,171,174,3,16,9936,0,0
10388,ACGTCGAATCTAGGGA,171,174,3,12,9937,0,0
10389,ACGTCGAATCTAGGGA,171,174,3,14,9940,0,0
10390,ACGTCGAATCTAGGGA,172,175,3,18,7786,0,0
10391,ACGTCGAATCTAGGGA,172,177,5,18,8248,0,0
10392,ACGTCGAATCTAGGGA,172,180,8,17,8336,1,0
10393,ACGTCGAATCTAGGGA,172,172,0,17,8413,0,0
10394,ACGTCGAATCTAGGGA,172,175,3,12,8572,0,0
10395,ACGTCGAATCTAGGGA,172,179,7,12,8747,0,0
10396,ACGTCGATTCTAGGGA,172,184,12,14,8765,2,0
10397,ACGTCGAATCTAGGGA,172,173,1,14,8770,0,0
10398,ACGTCGAATCTAGGGA,172,172,0,17,8779,0,0
10399,ACGTCGAATCTAGGGA,172,175,3,17,8915,0,0
10400,ACGTCGAATCTAGGGA,172,172,0,14,8917,0,0
10401,ACGTCGAATCTAGGGA,172,180,8,14,8924,1,0
10402,ACGTCGAATCTAGGGA,172,181,9,14,9125,1,0
10403,ACGTCGAATCTAGGGA,172,174,2,19,9137,0,0
10404,ACGTCTAATCTAGGGA,172,177,5,18,9195,0,0
10405,ACGTCGAATCTAGGGA,172,186,14,17,9196,3,0
10406,ACGTCGAATCTAGGGA,172,179,7,18,9261,0,0
10407,ACGTCGAATCTAGGGA,172,182,10,14,9263,1,0
10408,ACGTCGAATCTAGGGA,172,172,0,17,9264,0,0
10409,ACGTCGAATCTAGGGA,172,174,2,19,9268,0,0
10410,ACGTCGAATCTAGGGA,172,190,18,14,9286,4,0
10411,ACGTCGAATCTAGGGA,172,206,34,15,9294,9,0
10412,ACGTCGAATCTAGGGA,172,172,0,20,9308,0,0
10413,ACGTCGAATCTAGGGA,172,204,32,18,9312,9,0
10414,ACGTCGAATCTAGGGA,172,176,4,19,9340,0,0
10415,ACGTCGAATCTAGGGA,172,199,27,18,9440,7,0
10416,ACGTCGAATCTAGGGA,172,172,0,17,9446,0,0
10417,ACGTCTAATCTAGGGA,172,177,5,19,9451,0,0
10418,ACGTCGAATCTAGGGA,172,184,12,15,9457,2,0
10419,ACGTCGAATCTAGGGA,172,181,9,17,9616,1,0
10420,ACGTCGAATCTAGGGA,172,183,11,16,9623,2,0
10421,ACGTCGAATCTAGGGA,172,175,3,15,9628,0,0
10422,ACGTCGAATCTAGGGA,172,184,12,14,9629,2,0
10423,ACGTCGAATCTAGGGA,172,172,0,15,9636,0,0
10424,ACGTCGAATCTAGGGA,172,181,9,20,9639,1,0
10425,ACGTCGAATCTAGGGA,172,199,27,20,9646,7,0
10426,ACGTAGAATCTAGGGA,172,173,1,16,9647,0,0
10427,ACGTCGAATCTAGGGA,172,187,15,19,9653,3,0
10428,ACGTCGAATCTAGGGA,172,186,14,13,9796,3,0
10429,ACGTCGAATCTAGGGA,172,173,1,18,9797,0,0
10430,ACGTCGAATCTAGGGA,172,172,0,17,9798,0,0
10431,ACGTCGAATCTAGGGA,172,202,30,15,9803,8,0
10432,ACGTCGAATCTAGGGA,172,181,9,15,9804,1,0
10433,ACGTCTAATCTAGGGA,172,173,1,19,9807,0,0
10434,ACGTCGAATCTAGGGA,172,179,7,14,9809,0,0
10435,ACGTCGAATCTAGGGA,172,183,11,20,9812,1,0
10436,ACGTCGAATCTAGGGA,172,186,14,19,9814,2,0
10437,ACGTCGAATCGAGGGA,172,217,45,13,9973,12,0
10438,ACGTCGAATCTAGGGA,172,189,17,18,9974,3,0
10439,ACGTCGAATCTAGGGA,172,191,19,17,9975,4,0
10440,ACGTCGTATCTAGGGA,173,176,3,18,8100,0,0
10441,ACGTCGAATCTAGGGA,173,176,3,18,8124,0,0
10442,ACGTCGAATCTAGGGA,173,173,0,19,8294,0,0
10443,ACGTCGAATCTAGGGA,173,176,3,18,8561,0,0
10444,ACGTCGAATCTAGGGA,173,173,0,13,8632,0,0
10445,ACGTCTAATCTAGGGA,173,176,3,20,8638,0,0
10446,ACGCCGAATCTAGGGA,173,175,2,11,8643,0,0
10447,ACGTCGAATGTAGGGA,173,176,3,19,8649,0,0
10448,ACGTCGAATCTAGGGA,173,173,0,12,8905,0,0
10449,ACGTCGAATCTAGGGA,173,176,3,18,8967,0,0
10450,ACGTCGAATCTAGGGA,173,174,1,15,8992,0,0
10451,ACGTCGAATCTAGGGA,173,176,3,17,9000,0,0
10452,ACGTCGAATCTAGGGA,173,176,3,22,9188,0,0
10453,ACGTCGAATCTAGGGA,173,176,3,19,9194,0,0
10454,ACGTCGAATCTAGGGA,173,173,0,15,9322,0,0
10455,ACGTCGAATCTAGGGA,173,176,3,13,9324,0,0
10456,ACGTCGAATCTAGGGA,173,176,3,15,9325,0,0
10457,ACGTAGAATCTAGGGA,173,174,1,15,9327,0,0
10458,ACGTCGAATCTAGGGA,173,176,3,17,9328,0,0
10459,ACGTCGAATCTAGGGA,173,174,1,19,9330,0,0
10460,ACGTCGAATCTAGGGA,173,176,3,11,9332,0,0
10461,ACGTCGAATCTAGGGA,173,176,3,20,9464,0,0
10462,ACGTAGAATCTAGGGA,173,175,2,15,9490,0,0
10463,ACGTCGAATCTAGGGA,173,176,3,13,9498,0,0
10464,ACGTCGAATCTAGGGA,173,176,3,13,9499,0,0
10465,ACGTCGAATCTAGGGA,173,174,1,13,9501,0,0
10466,ACGTCGAATCTAGGAA,173,176,3,18,9506,0,0
10467,ACGTCGAATCTAGGGA,173,176,3,15,9508,0,0
10468,ACGTCGAATCTAGGGA,173,175,2,18,9511,0,0
10469,ACGTCGAATCTAGGGA,173,176,3,15,9514,0,0
10470,ACGTCGAATCTAGGGA,173,176,3,17,9579,0,0
10471,ACGTCGAATCTAGGGA,173,176,3,20,9790,0,0
10472,ACGTCGAATCTAGGGA,173,176,3,14,9794,0,0
10473,ACGTCGAATCTAGGGA,173,176,3,21,9839,0,0
10474,ACGTTGAATCTAGGGA,173,176,3,18,9844,0,0
10475,ACGTCGATTCTAGGGA,173,173,0,15,9845,0,0
10476,ACGTCGAATCTAGGGA,173,176,3,15,9847,0,0
10477,ACGTCGAATCTAGGGA,173,176,3,19,9848,0,0
10478,ACGTCGAATCTAGGGA,173,175,2,18,9849,0,0
10479,ACGTCGAATCTAGGGA,173,176,3,15,9850,0,0
10480,ACGTCGAATCTAGGGA,173,176,3,19,9851,0,0
10481,ACGTCGAATCTAGGGA,173,174,1,15,9853,0,0
10482,ACGTCGAATCTAGGGA,173,176,3,18,9857,0,0
10483,TCGTCGAATCTAGGGA,173,176,3,19,9860,0,0
10484,ACGTCGAATCTAGGGA,173,176,3,23,9942,0,0
10485,ACGTCGAATCTAGGGA,173,176,3,16,9943,0,0
10486,ACGTCGAATCTAGGGA,173,174,1,20,9945,0,0
10487,ACGTCGAATTTAGGGA,173,176,3,19,9947,0,0
10488,ACGTCGAATCTAGGGA,173,176,3,14,9955,0,0
10489,ACGTCGAATCTAGGGA,173,173,0,21,9956,0,0
10490,ACGTCGAATCTAGGGA,173,176,3,18,9959,0,0
10491,ACGTCGAATCTAGGGA,173,176,3,20,9960,0,0
10492,ACGTCGAATCCAGGGA,173,176,3,14,9962,0,0
10493,ACGTCGAATCTAGGGA,173,174,1,18,10023,0,0
10494,ACGTCGAATCTAGGGA,173,176,3,19,10024,0,0
10495,ACGTCGAATCTAGGGA,173,173,0,18,10027,0,0
10496,ACGTCGAATCTAGGGA,173,176,3,13,10030,0,0
10497,ACGTCGATTCTAGGGA,173,176,3,15,10031,0,0
10498,ACGTCGAATCTAGGGA,173,176,3,15,10032,0,0
10499,ACGTCGAATCTAGGGA,173,173,0,19,10034,0,0
10500,ACGTCGAATCTAGGGA,173,174,1,18,10035,0,0
10501,ACGTCGAATCTAGGGA,173,176,3,20,10040,0,0
10502,ACGTCGAATCTAGGGA,173,174,1,15,10041,0,0
10503,ACGTCGAATCTAGGGA,173,174,1,18,10043,0,0
10504,ACGTCGAATCTAGGGA,173,176,3,18,10051,0,0
10505,ACGTCGAATCTAGGGA,173,176,3,20,10055,0,0
10506,ACGTCGAATCTAGGGA,173,176,3,19,10065,0,0
10507,ACGTCGAATCTAGGGA,174,178,4,17,7308,0,0
10508,ACGTCGAATCTAGGGA,174,197,23,16,8259,6,0
10509,ACGTCGAATCTAGGGA,174,178,4,18,8690,0,0
10510,ACCTCGAATCTAGGGA,174,186,12,19,8892,2,0
10511,ACGTCGAATCTAGGGA,174,197,23,19,9151,6,0
10512,TGGTCTAATCTAGGGA,174,179,5,19,9377,0,0
10513,ACGTCGAATCTATGGA,174,185,11,18,9378,2,0
10514,ACGTCGAATCTAGGGA,174,183,9,17,9392,1,0
10515,ACGTCGAATCTAGGGA,174,190,16,15,9517,3,0
10516,ACGTCGAATCTAGGGA,174,174,0,17,9547,0,0
10517,ACGTCGAATCTAGGGA,174,186,12,13,9548,2,0
10518,ACGTCGAATCTAGGGA,174,196,22,19,9550,5,0
10519,ACGTCGAATCTAGGGA,174,189,15,19,9551,3,0
10520,ACTTCTAATCTAGGGA,174,180,6,19,9552,0,0
10521,ACGTCGTATCTAGGGA,174,176,2,19,9557,0,0
10522,ACGTCGAATCTAGGGA,174,197,23,19,9559,6,0
10523,ACGTCGAATCTAGGGA,174,194,20,19,9566,5,0
10524,ACGTCGAATCTAGGGA,174,194,20,12,9572,5,0
10525,ACGTCGAATCTAGGGA,174,179,5,18,9651,0,0
10526,ACGTCGAATCTAGGGA,174,192,18,17,9652,4,0
10527,ACGTCGAATCTAGGGA,174,191,17,17,9729,4,0
10528,ACGTCGAATCTAGGGA,174,185,11,20,9739,2,0
10529,ACGTCTAATCTAGGGA,174,182,8,21,9747,1,0
10530,ACGTCGAATCTAGGGA,174,205,31,12,9748,8,0
10531,ACGTCGAATCTAGGGA,174,174,0,19,9751,0,0
10532,ACGTCGAATCTAGGGA,174,203,29,19,9759,8,0
10533,ACGTCGAATCTAGGGA,174,181,7,19,9769,0,0
10534,ACGTCGAATCTAGGGA,174,174,0,20,9777,0,0
10535,ACGTCGAATCTAGGGA,174,179,5,18,9780,0,0
10536,ACGTCGAATCTAGGGA,174,197,23,16,9783,6,0
10537,ACGTCGAATCTAGGGA,174,182,8,19,9816,1,0
10538,ACGTCGAATCTAGGGA,174,190,16,19,9821,3,0
10539,ACGTCGAATCTATGGA,174,184,10,19,9823,1,0
10540,ACGTCGAATCTAGGGA,174,191,17,23,9825,4,0
10541,ACGTCGAATCTAGGGA,174,175,1,19,9910,0,0
10542,ACGTCGTATCTAGGGA,174,175,1,19,9912,0,0
10543,ACGTCGAATCTAGGGA,174,186,12,19,9913,2,0
10544,ACGTCGAATCTATGGA,174,180,6,18,9919,0,0
10545,ACGTCTAATCTAGGGA,174,181,7,21,9922,0,0
10546,ACGTCGAATCTAGGGA,174,181,7,12,9923,0,0
10547,ACGTCGAATCTAGGGA,174,185,11,19,9925,2,0
10548,ACGTCGAATCTAGGGA,174,174,0,19,9929,0,0
10549,ACGTCGAATCTAGGGA,174,183,9,17,9930,0,0
10550,ACGTCGAATCTAGGGA,174,182,8,19,9931,0,0
10551,ACGTCGAATCTAGGGA,174,187,13,14,9933,2,0
10552,ACGTCGAATCTAGGGA,174,182,8,16,9936,0,0
10553,ACGTCGAATCTAGGGA,174,189,15,12,9937,2,0
10554,ACGTCGAATCTAGGGA,174,190,16,14,9940,3,0
10555,ACGTCGAATCTAGGGA,175,177,2,18,7786,0,0
10556,ACGTCGAATCTAGGGA,175,178,3,17,8336,0,0
10557,ACGTCGAATCTAGGGA,175,181,6,17,8413,0,0
10558,ACGTCGATTCTAGGGA,175,192,17,14,8765,4,0
10559,ACGTCGAATCTAGGGA,175,180,5,17,8779,0,0
10560,ACGTCGAATCTAGGGA,175,205,30,17,8915,8,0
10561,ACGTCGAATCTAGGGA,175,176,1,14,8917,0,0
10562,ACGTCGAATCTAGGGA,175,219,44,14,8924,13,0
10563,ACGTCGAATCTAGGGA,175,176,1,14,9125,0,0
10564,ACGTCGAATCTAGGGA,175,184,9,19,9137,1,0
10565,ACGTCTAATCTAGGGA,175,191,16,18,9195,3,0
10566,ACGTCGAATCTAGGGA,175,175,0,17,9196,0,0
10567,ACGTCGAATCTAGGGA,175,177,2,18,9261,0,0
10568,ACGTCGAATCTAGGGA,175,183,8,14,9263,1,0
10569,ACGTCGAATCTAGGGA,175,181,6,17,9264,0,0
10570,ACGTCGAATCTAGGGA,175,241,66,14,9286,20,0
10571,ACGTCGAATCTAGGGA,175,175,0,15,9294,0,0
10572,ACGTCGAATCTAGGGA,175,190,15,20,9308,3,0
10573,ACGTCGAATCTAGGGA,175,175,0,18,9312,0,0
10574,ACGTCGAATCTAGGGA,175,181,6,18,9440,0,0
10575,ACGTCGAATCTAGGGA,175,179,4,17,9446,0,0
10576,ACGTCTAATCTAGGGA,175,216,41,19,9451,11,0
10577,ACGTCGAATCTAGGGA,175,178,3,15,9457,0,0
10578,ACGTCGAATCTAGGGA,175,191,16,16,9623,3,0
10579,ACGTCGAATCTAGGGA,175,176,1,15,9628,0,0
10580,ACGTCGAATCTAGGGA,175,192,17,14,9629,3,0
10581,ACGTCGAATCTAGGGA,175,187,12,15,9636,1,0
10582,ACGTCGAATCTAGGGA,175,180,5,20,9639,0,0
10583,ACGTCGAATCTAGGGA,175,177,2,20,9646,0,0
10584,ACGTCGAATCTAGGGA,175,181,6,19,9653,0,0
10585,ACGTCGAATCTAGGGA,175,175,0,18,9797,0,0
10586,ACGTCGAATCCAGGGA,175,184,9,17,9798,0,0
10587,ACGTCGAATCTAGGGA,175,190,15,15,9804,2,0
10588,ACGTCGAATCTAGGGA,175,193,18,19,9814,3,0
10589,ACGTCGAATCTAGGGA,175,187,12,13,9973,1,0
10590,ACGTCGAATCTAGGGA,175,175,0,18,9974,0,0
10591,ACGTCGAATCTAGGGA,175,195,20,17,9975,4,0
10592,ACGTCGAATCTAGGGA,175,182,7,14,10068,0,0
10593,ACGTCGAATCTAGGGA,175,180,5,20,10069,0,0
10594,ACGTCGAATCTAGGGA,175,221,46,19,10070,13,0
10595,ACGTCTAATCTAGGGA,175,184,9,20,10073,0,0
10596,ACGTCGAATCTAGGGA,175,198,23,19,10076,5,0
10597,ACGTCGAATCTAGGGA,175,175,0,14,10077,0,0
10598,ACGTCGAATCTAGGGA,175,183,8,18,10078,0,0
10599,ACGTCGAATCTAGGGA,175,178,3,22,10079,0,0
10600,ACGTCGAATCTCGGGA,175,178,3,21,10080,0,0
10601,ACGTCGAATCTAGGGA,175,175,0,16,10084,0,0
10602,ACGTCGAATCTAGGGA,175,178,3,17,10087,0,0
10603,ACGTCGAATCTAGGGA,175,178,3,17,10147,0,0
10604,ACGTCGAATCTAGGGA,175,178,3,15,10148,0,0
10605,ACGTCGAATCTAGGGA,175,178,3,14,10149,0,0
10606,ACGTCGAATCTAGGGA,175,178,3,18,10153,0,0
10607,ACGTCGAATCTAGGGA,175,177,2,20,10154,0,0
10608,ACGTCGAATCTAGGGA,175,178,3,22,10161,0,0
10609,ACGTCGAATCTAGGGA,175,177,2,16,10163,0,0
10610,ACGTCGAATCTAGGGA,175,175,0,20,10167,0,0
10611,ACTTCTAATCTAGGGA,175,178,3,20,10169,0,0
10612,ACGTCGAATCTAGGGA,175,178,3,20,10171,0,0
10613,ACGTCGAATCTAGGGA,175,178,3,22,10176,0,0
10614,ACGTCGAATCTAAGGA,175,178,3,18,10180,0,0
10615,ACGTCGAATCTAGGGA,175,175,0,23,10181,0,0
10616,ACGTCGTATCTAGGGA,176,180,4,18,8100,0,0
10617,ACGTCGAATCTAGGGA,176,192,16,19,8294,3,0
10618,ACGTCGAATCTAGGGA,176,187,11,18,8561,2,0
10619,ACGTCTAATCTAGGGA,176,176,0,20,8638,0,0
10620,ACGTCGAATCTAGGGA,176,177,1,11,8643,0,0
10621,ACGTCGAATGTAGGGA,176,176,0,19,8649,0,0
10622,ACGTCGAATCTAGGGA,176,183,7,12,8905,0,0
10623,ACGTCGAATCTAGGGA,176,195,19,17,9000,4,0
10624,ACGTCGAATCTAGGGA,176,190,14,22,9188,3,0
10625,ACGTCGAATCTAGGGA,176,178,2,19,9194,0,0
10626,ACGTCGAATCTAGGGA,176,187,11,15,9322,2,0
10627,ACGTCGAATCTAGGGA,176,178,2,13,9324,0,0
10628,ACGTAGAATCTAGGGA,176,200,24,15,9327,6,0
10629,ACGTCGAATCTAGGGA,176,177,1,17,9328,0,0
10630,ACGTCGAATCTAGGGA,176,188,12,19,9330,2,0
10631,ACGTCGAATCTAGGGA,176,177,1,20,9464,0,0
10632,ACGTCGAATCTAGGGA,176,178,2,13,9498,0,0
10633,ACGTCGAATCTAGGGA,176,179,3,13,9499,0,0
10634,ACGTCGAATCTAGGGA,176,180,4,13,9501,0,0
10635,ACGTCGAATCTAGGGA,176,187,11,18,9506,1,0
10636,ACGTCGAATCTAGGGA,176,183,7,15,9508,0,0
10637,ACGTCGAATCTAGGGA,176,180,4,18,9511,0,0
10638,ACGTCGAATCTAGGGA,176,179,3,17,9579,0,0
10639,ACGTCGAATCTAGGGA,176,179,3,20,9790,0,0
10640,ACGTCGAATCTAGGGA,176,180,4,14,9794,0,0
10641,ACGTCGAATCTAGGGA,176,179,3,21,9839,0,0
10642,ACGTCGAATCTAGGGA,176,179,3,18,9844,0,0
10643,ACGTCGATTCTAGGGA,176,179,3,15,9845,0,0
10644,ACGTCGAATCTAGGGA,176,179,3,15,9847,0,0
10645,ACGTCGAATCTAGGGA,176,179,3,19,9848,0,0
10646,ACGTCGAATCTAGGGA,176,179,3,18,9849,0,0
10647,ACGTCGAATCTAGGGA,176,179,3,15,9850,0,0
10648,ACGTCGAATCTAGGGA,176,179,3,19,9851,0,0
10649,ACGTCGAATCTAGGTA,176,179,3,18,9857,0,0
10650,TCGTCGAATCTAGGGA,176,179,3,19,9860,0,0
10651,ACGTCGAATCTAGGGA,176,176,0,23,9942,0,0
10652,ACGTCGAATCTAGGGA,176,179,3,20,9945,0,0
10653,ACGTCGAATCTAGGGA,176,179,3,19,9947,0,0
10654,ACGTCGAATCTAGGGA,176,179,3,21,9956,0,0
10655,ACGTCGAATCTAGGGA,176,179,3,18,9959,0,0
10656,ACGTCGAATCTAGGGA,176,179,3,20,9960,0,0
10657,ACGTCGAATCCAGGGA,176,179,3,14,9962,0,0
10658,ACGTCGAATCTAGGGA,176,178,2,18,10023,0,0
10659,ACGTCGAATCTAGGGA,176,179,3,19,10024,0,0
10660,ACGTCGAATCTAGGGA,176,179,3,18,10027,0,0
10661,ACGTCGATTCTAGGGA,176,179,3,15,10031,0,0
10662,ACGTCGAATCTAGGGA,176,179,3,15,10032,0,0
10663,ACGTCGAATCTAGGGA,176,179,3,19,10034,0,0
10664,ACGTCGAATCTAGGGA,176,176,0,18,10035,0,0
10665,ACGTCGAATCTAGGGA,176,179,3,20,10040,0,0
10666,ACGTCGAATCTAGGGA,176,179,3,15,10041,0,0
10667,ACGTCGAATCTAGGGA,176,179,3,18,10043,0,0
10668,ACGTCGAATCTAGGGA,176,179,3,18,10051,0,0
10669,ACGTCGAATCTAGGGA,176,179,3,20,10055,0,0
10670,ACGTCGAATCTAGGGA,176,179,3,19,10065,0,0
10671,ACGTCGAATCTAGGGA,176,179,3,19,10203,0,0
10672,ACGTCGAATCTAGGGA,176,179,3,18,10326,0,0
10673,TCGTCGAATCTAGGGA,176,179,3,17,10327,0,0
10674,ACGTCGAATCTAGGGA,176,179,3,19,10328,0,0
10675,ACGTCGAATCTAGGGA,177,177,0,17,7308,0,0
10676,ACGTCGAATCTAGGGA,177,180,3,16,8259,0,0
10677,ACGTCGAATCTAGGGA,177,178,1,18,8690,0,0
10678,ACGTCGAATCTAGGGA,177,200,23,19,9151,6,0
10679,AGGTCTAATCTAGGGA,177,184,7,19,9377,0,0
10680,ACGTCGAATCTATGGA,177,188,11,18,9378,2,0
10681,ACGTCGAATCTAGGGA,177,197,20,17,9392,5,0
10682,ACGTCGAATCTAGGGA,177,177,0,15,9517,0,0
10683,ACGTCGAATCTAGGGA,177,188,11,13,9548,2,0
10684,ACGTCGAATCTAGGGA,177,178,1,19,9550,0,0
10685,ACGTCGAATCTAGGGA,177,178,1,19,9551,0,0
10686,ACTTCTAATCTAGGGA,177,182,5,19,9552,0,0
10687,ACGTCGTATCTAGGGA,177,184,7,19,9557,0,0
10688,ACGTCGAATCTAGGGA,177,181,4,19,9559,0,0
10689,ACGTCGAATCTAGGGA,177,180,3,12,9572,0,0
10690,ACGTCGAATCTAGGGA,177,188,11,18,9651,2,0
10691,ACGTCGAATCTAGGGA,177,186,9,17,9652,1,0
10692,ACGTCGAATCTAGGGA,177,180,3,17,9729,0,0
10693,ACGTCGAATCTAGGGA,177,180,3,20,9739,0,0
10694,ACGTCTAATCTAGGGA,177,191,14,21,9747,3,0
10695,ACGTCGAATCTAGGGA,177,178,1,19,9751,0,0
10696,ACGTCGAATCTAGGGA,177,190,13,19,9759,2,0
10697,ACGTCGAATCTAGGGA,177,180,3,19,9769,0,0
10698,ACGTCGAATCTAGGGA,177,180,3,20,9777,0,0
10699,ACGTCGAATCTAGGGA,177,181,4,16,9783,0,0
10700,ACGTCGAATCTAGGGA,177,181,4,19,9816,0,0
10701,ACGTCGAATCTAGGGA,177,185,8,19,9821,1,0
10702,ACGTCGAATCTAGGGA,177,177,0,19,9910,0,0
10703,ACGTCGTATCTAGGGA,177,182,5,19,9912,0,0
10704,ACGTCTAATCTAGGGA,177,191,14,21,9922,3,0
10705,ACGTCGAATCTAGGGA,177,222,45,12,9923,12,0
10706,ACGTCGAATCTAGGGA,177,187,10,19,9925,1,0
10707,ACGTCGAATCTAGGGA,177,181,4,19,9929,0,0
10708,ACGTCGAATCTAGGGA,177,191,14,19,9931,2,0
10709,ACGTCGAATCTAGGGA,177,177,0,12,9937,0,0
10710,ACGTCGAATCTAGGGA,177,191,14,14,9940,2,0
10711,ACGTCGAATCTAGGGA,177,191,14,18,10184,2,0
10712,ACGTCGAATCTAGGGA,177,177,0,21,10185,0,0
10713,ACGTCGAATCTAGGGA,177,178,1,20,10186,0,0
10714,ACGTAGCATCTAGGGA,177,208,31,18,10190,8,0
10715,ACGTCGAATCTAGGGA,177,177,0,20,10191,0,0
10716,ACGTCGAATCTAGGGA,177,177,0,14,10192,0,0
10717,ACGTCGAATCTAGGGA,177,198,21,20,10193,4,0
10718,ACGTCGAATCTAGGGA,177,195,18,15,10194,3,0
10719,ACGTCGAATCTAGAGC,177,177,0,22,10196,0,0
10720,ACGTCGAACCTAGGGA,177,187,10,20,10198,1,0
10721,ACGTCGAATCTAGGGA,177,183,6,21,10199,0,0
10722,ACGTCGAATCTAGGGA,177,182,5,22,10268,0,0
10723,ACGTCGAATCTAGGGA,177,185,8,19,10270,0,0
10724,ACGTCGAATCTAGGGA,177,184,7,17,10271,0,0
10725,ACGTCGAATCTAGGGA,177,202,25,19,10273,6,0
10726,ACGTCGAATCTATGGA,177,185,8,18,10274,0,0
10727,ACGTCGAATCTAGGGA,177,180,3,14,10275,0,0
10728,ACGTCGAATCTAGGGA,177,179,2,12,10277,0,0
10729,ACGTCGAATCTAGGGA,177,181,4,13,10280,0,0
10730,ACGTCGCATCTAGGGA,177,180,3,19,10281,0,0
10731,ACGTCGAATCTAGGGA,177,180,3,18,10284,0,0
10732,ACGTCGAATCTAGGGA,177,180,3,23,10287,0,0
10733,ACGTCGAATCTAGGGA,177,180,3,20,10288,0,0
10734,ACGTCGAATCTAGGGA,177,180,3,16,10289,0,0
10735,ACGTAGAATCTAGGGA,177,177,0,16,10292,0,0
10736,ACGTCGAATCTAGGGA,177,180,3,21,10296,0,0
10737,ACGTAGAATCTAGGGA,177,180,3,16,10297,0,0
10738,ACGTCGAATCTAGGGA,177,178,1,18,10298,0,0
10739,ACGTCGAATCTAGGGA,177,179,2,14,10300,0,0
10740,ACGTCGAATCTAGGGA,177,180,3,14,10301,0,0
10741,ACGTCGAATCTAGGGA,177,180,3,16,10304,0,0
10742,ACGTCGAATCTAGGGA,177,179,2,16,10306,0,0
10743,ACGTCGAATCTAGGGA,177,180,3,18,10312,0,0
10744,ACGTCGAATCTAGGGA,177,180,3,19,10315,0,0
10745,ACGTCGAATCTAGGGA,177,180,3,20,10318,0,0
10746,ACGTCGAATGTAGGGA,177,178,1,20,10321,0,0
10747,ACGTCGAATCTAGGGA,177,180,3,19,10324,0,0
10748,ACGTCGAATCTAGGGA,178,182,4,17,8336,0,0
10749,ACGTCGATTCTAGGGA,178,184,6,14,8765,0,0
10750,ACGTCGAATCTAGGGA,178,191,13,17,8779,2,0
10751,ACGTCGAATCTAGGGA,178,185,7,17,8915,0,0
10752,ACGTCGAATCTAGGGA,178,186,8,14,8917,1,0
10753,ACGTCGAATCTAGGGA,178,194,16,14,8924,3,0
10754,ACGTCGAATCTAGAGA,178,184,6,14,9125,0,0
10755,ACGTCGAATCTAGGGA,178,197,19,19,9137,4,0
10756,ACGTCTAATCTAGGGA,178,182,4,18,9195,0,0
10757,ACGTCGAATCTAGGGA,178,186,8,18,9261,1,0
10758,ACGTCGAATCTAGGGA,178,196,18,14,9263,4,0
10759,ACGTCGAATCTAGGGA,178,180,2,17,9264,0,0
10760,ACGTCGAATCTAGGGA,178,186,8,14,9286,1,0
10761,ACGTCGAATGTAGGGA,178,196,18,15,9294,4,0
10762,ACGTCGAATCTAGGGA,178,191,13,20,9308,2,0
10763,ACGTCGAATCTAGGGA,178,179,1,18,9312,0,0
10764,ACGTCGAATCTAGGGA,178,180,2,18,9440,0,0
10765,ACGTCGAATCTAGGGA,178,205,27,17,9446,6,0
10766,ACGTCTAATCTAGGGA,178,182,4,19,9451,0,0
10767,ACGTCGAATCTAGGGA,178,182,4,15,9457,0,0
10768,ACGTCGAATCTAGGGA,178,181,3,16,9623,0,0
10769,ACGTCGAATCTAGGGA,178,178,0,14,9629,0,0
10770,ACGTCGAATCTAGGGA,178,180,2,15,9636,0,0
10771,ACGTCGAATCTAGGGA,178,181,3,20,9646,0,0
10772,ACGTCGAATCTAGGGA,178,181,3,19,9653,0,0
10773,ACGTCGAATCTAGGGA,178,181,3,18,9797,0,0
10774,ACGTCGAATCTAGGGA,178,181,3,17,9798,0,0
10775,ACGTCGAATCTAGCGA,178,179,1,15,9804,0,0
10776,ACGTCGAATCTAGGGA,178,181,3,19,9814,0,0
10777,ACGTCGAATCTAGGGA,178,179,1,13,9973,0,0
10778,ACGTCGAATCTAGGGA,178,181,3,18,9974,0,0
10779,ACGTCGAATCTAGGGA,178,181,3,17,9975,0,0
10780,ACGTCGAATCTAGGGA,178,181,3,14,10068,0,0
10781,ACGTCGAATCTAGGGA,178,181,3,20,10069,0,0
10782,ACGTCGAATCTAGGGA,178,178,0,19,10070,0,0
10783,ACGTCTAATCTAGGGA,178,181,3,20,10073,0,0
10784,ACGTCGAATCTAGGGA,178,181,3,18,10078,0,0
10785,ACGTCGAATCTAGGGA,178,178,0,22,10079,0,0
10786,ACGTCGAATCTCGGGA,178,181,3,21,10080,0,0
10787,ACGTCGAATCTAGGGA,178,179,1,17,10147,0,0
10788,ACGTCGAATCTAGGGA,178,181,3,15,10148,0,0
10789,ACGTCGAATCTAGGGA,178,179,1,14,10149,0,0
10790,ACGTCGAATCTAGGGA,178,181,3,20,10154,0,0
10791,ACGTCGAATCTAGGGA,178,178,0,22,10161,0,0
10792,ACGTCGAATCTAGGGA,178,181,3,16,10163,0,0
10793,ACGTCGAATCTAGGGA,178,181,3,20,10167,0,0
10794,ACGTCGAATCTAAGGA,178,181,3,18,10180,0,0
10795,ACGTCGAATCTAGGGA,178,181,3,23,10181,0,0
10796,ACGTCGAATCTAGGGA,178,181,3,18,10330,0,0
10797,ACGTCGAATCTAGGGA,178,181,3,18,10337,0,0
10798,ACGTCGAATCTAGGGA,178,180,2,20,10343,0,0
10799,ACGTCGAATCTAGGGA,178,181,3,19,10347,0,0
10800,ACGTCGAATCTAGGGA,178,179,1,18,10349,0,0
10801,ACGTCGTATCTAGGGA,178,181,3,20,10351,0,0
10802,ACGTCGTATCTAGGGA,179,189,10,18,8100,1,0
10803,ACGTCGAATCTAGGGA,179,180,1,19,8294,0,0
10804,ACGTCGAATCTAGGGA,179,197,18,18,8561,4,0
10805,ACGTCTAATCTAGGGA,179,193,14,20,8638,3,0
10806,ACGTCGAATCTAGGGA,179,184,5,11,8643,0,0
10807,ACGTCGAATGTAGGGA,179,185,6,19,8649,0,0
10808,ACGTCGAATCTAGGGA,179,186,7,12,8905,0,0
10809,ACGTCGAATCTAGGGA,179,181,2,22,9188,0,0
10810,ACGTCGAATCTAGGGA,179,193,14,13,9324,3,0
10811,ACGTAGAATCTAGGGA,179,185,6,15,9327,0,0
10812,ACGTCGAATCTAGGGA,179,180,1,17,9328,0,0
10813,ACGTCGAATCTAGGGA,179,189,10,19,9330,1,0
10814,ACGTCGAATCTAGGGA,179,181,2,20,9464,0,0
10815,ACGTCGAATCTAGGGA,179,204,25,13,9498,6,0
10816,ACGTCGAATCTAGGGA,179,205,26,15,9508,7,0
10817,ACGTCGAATCTAGGGA,179,192,13,18,9511,2,0
10818,ACGTCGAATCTAGGGA,179,187,8,20,9790,1,0
10819,ACGTCGAATCTAGGGA,179,179,0,14,9794,0,0
10820,ACGTCGAATCTAGGGA,179,202,23,21,9839,6,0
10821,ACGTCGAATCTAGGGA,179,184,5,18,9844,0,0
10822,ACGACGATTCTAGGGA,179,181,2,15,9845,0,0
10823,ACGTCGAATCTAGGGA,179,179,0,15,9847,0,0
10824,ACGTCGAATCTAGGGA,179,180,1,19,9848,0,0
10825,ACGTCGAATCTAGGGA,179,179,0,18,9849,0,0
10826,ACGTCGAATCTAGGGA,179,182,3,15,9850,0,0
10827,ACGTTGAATCTAGGGA,179,187,8,18,9857,1,0
10828,TCGTCGAATCTAGGGA,179,198,19,19,9860,4,0
10829,ACGTCGAATCTAGGGA,179,183,4,23,9942,0,0
10830,ACGTCGAATCTAGGGA,179,203,24,20,9945,6,0
10831,ACGTCGAATCTAGGGA,179,180,1,19,9947,0,0
10832,ACGTCGAATCTAGGGA,179,182,3,21,9956,0,0
10833,ACGTCGAATCTAGGGA,179,195,16,18,9959,3,0
10834,ACGTCGAATCCAGGGA,179,218,39,14,9962,11,0
10835,ACGTCGAATCTAGGGA,179,181,2,18,10023,0,0
10836,ACGTCGAATCTAGGGA,179,180,1,18,10027,0,0
10837,ACGTCGATTCTAGGGA,179,180,1,15,10031,0,0
10838,ACGTCGAATCTAGGGA,179,191,12,15,10032,2,0
10839,ACGTCGAATCTAGGGA,179,206,27,19,10034,7,0
10840,ACGTCGAATCTAGGGA,179,179,0,20,10040,0,0
10841,ACGTCGAATCTAGGGA,179,181,2,15,10041,0,0
10842,ACGTCGAATCTAGGGA,179,185,6,18,10043,0,0
10843,ACGTCGAATGTAGGGA,179,202,23,18,10051,6,0
10844,ACGTCGAATCTAGGGA,179,195,16,20,10055,3,0
10845,ACGTCGAATCTAGGGA,179,186,7,19,10065,0,0
10846,ACGTCGAATCTAGGGA,179,183,4,19,10203,0,0
10847,ACGTCGAATCTAGGGA,179,182,3,17,10327,0,0
10848,ACGTCGAATCTAGGGA,179,182,3,19,10328,0,0
10849,ACGTCGAATCTAGGGA,179,182,3,18,10392,0,0
10850,ACGTCGATTCTAGGGA,179,182,3,15,10396,0,0
10851,ACGTCGAATCTAGGGA,179,179,0,15,10401,0,0
10852,ACGTCGAATCTAGGGA,179,182,3,15,10402,0,0
10853,ACGTCGAATCTAGGGA,179,182,3,18,10405,0,0
10854,ACGTCGAATCTAGGGA,179,182,3,15,10407,0,0
10855,ACGTCGAATCTAGGGA,179,179,0,15,10410,0,0
10856,ACGTCGAATCTAGGGA,179,182,3,16,10411,0,0
10857,ACGTCGAATCTAGGGA,179,182,3,19,10413,0,0
10858,ACGTCGAATCTAGGGA,179,182,3,19,10415,0,0
10859,ACGTCGAATCTAGGGA,179,181,2,16,10418,0,0
10860,ACGTCGAATCTAGGGA,179,182,3,18,10419,0,0
10861,ACGTCGATTCTAGGGA,179,182,3,17,10420,0,0
10862,ACGTCGAATCTAGGGA,179,180,1,15,10422,0,0
10863,ACGTCGAATCTAGGGA,179,182,3,21,10424,0,0
10864,ACGTCGAATCTAGGGA,179,182,3,21,10425,0,0
10865,ACGTCGAATCTAGGGA,179,182,3,20,10427,0,0
10866,ACGTCGAATCTAGGGA,179,181,2,14,10428,0,0
10867,ACGTCGAATCTAGGGA,179,182,3,16,10431,0,0
10868,ACGTCGAATCTAGGGA,179,182,3,16,10432,0,0
10869,ACGTCGAATCTAGGGA,180,187,7,17,7308,0,0
10870,ACGTCGAATCTAGGGA,180,186,6,16,8259,0,0
10871,ACGTCGAATCTAGGGA,180,193,13,18,8690,2,0
10872,ACGTCGAATCTAGGGA,180,184,4,19,9151,0,0
10873,AGGTCTAATCTAGGGA,180,182,2,19,9377,0,0
10874,ACGTCGAATCTATGGA,180,183,3,18,9378,0,0
10875,ACGTCGAATCTAGGGA,180,196,16,17,9392,3,0
10876,ACGTCGAATCTAGGGA,180,180,0,15,9517,0,0
10877,ACGTCGAATCTAGGGA,180,180,0,13,9548,0,0
10878,AAGTCGAATCTAGGGA,180,190,10,19,9550,1,0
10879,ACGTCGAATCTAGGGA,180,182,2,19,9551,0,0
10880,ACTTCTAATCTAGGGA,180,183,3,19,9552,0,0
10881,ACGTCGAATCTAGGGA,180,185,5,17,9652,0,0
10882,ACGTCGAATCTAGGGA,180,187,7,17,9729,0,0
10883,ACGTCGAATCTAGGGA,180,190,10,20,9739,1,0
10884,ACGTCGAATCTAGGGA,180,183,3,19,9759,0,0
10885,ACGTCGAATCTAGGGA,180,180,0,19,9769,0,0
10886,ACGTCGAATCTAGGGA,180,181,1,20,9777,0,0
10887,ACGTCGAATCTAGGGA,180,181,1,19,9816,0,0
10888,ACGTCGAATCTAGCGA,180,184,4,19,9821,0,0
10889,ACGTCGAATCTAGGGA,180,193,13,19,9910,2,0
10890,ACGTCTAATCTAGGGA,180,189,9,21,9922,1,0
10891,ACGTCGAATCTAGGGA,180,184,4,12,9923,0,0
10892,ACGTCGAATCTAGGGA,180,180,0,19,9925,0,0
10893,ACGTCGAATCTAGGGA,180,186,6,12,9937,0,0
10894,ACGTCGAATCTAGGGA,180,194,14,14,9940,3,0
10895,ACGTCGAATCTAGGGA,180,184,4,18,10184,0,0
10896,ACGTCGAATCTAGGGA,180,191,11,20,10186,2,0
10897,ACGTCGCATCTAGGGA,180,183,3,18,10190,0,0
10898,ACGTCGAATCTAGGGA,180,183,3,20,10191,0,0
10899,ACGTCGAATCTAGGGA,180,182,2,15,10194,0,0
10900,ACGTCGAATCTAGAGC,180,197,17,22,10196,4,0
10901,ACGTCGAATCTAGGGA,180,184,4,20,10198,0,0
10902,ACGTCGAATCTAGGGA,180,184,4,21,10199,0,0
10903,ACGGCGAATCTAGGGA,180,189,9,19,10270,1,0
10904,ACGTCGAATCTAGGGA,180,205,25,17,10271,6,0
10905,ACGTCGAATCTATGGA,180,181,1,18,10274,0,0
10906,ACGTCGAATCTAGGGA,180,187,7,14,10275,0,0
10907,ACGTCGAATCTAGGGA,180,184,4,13,10280,0,0
10908,ACGTCGCATCTAGGGA,180,188,8,19,10281,0,0
10909,ACGTCGAATCTAGGGA,180,183,3,18,10284,0,0
10910,ACGTCGAATCTAGGGA,180,183,3,23,10287,0,0
10911,ACGTCGAATCTAGGGA,180,183,3,20,10288,0,0
10912,ACGTAGAATCTAGGGA,180,183,3,16,10292,0,0
10913,ACGTCGAATCTAGGGA,180,183,3,21,10296,0,0
10914,ACGTCGAATCTAGGGA,180,181,1,18,10298,0,0
10915,ACGTCGAATCTAGGGA,180,183,3,14,10300,0,0
10916,ACGTCGAATCTAGGGA,180,183,3,16,10304,0,0
10917,ACGTCGAATCTAGGGA,180,183,3,16,10306,0,0
10918,ACGTCGAATCTAGGGA,180,183,3,18,10312,0,0
10919,ACGTCGAATCTAGGGA,180,183,3,19,10315,0,0
10920,ACGTCGAATCTAGGGA,180,183,3,20,10318,0,0
10921,ACGTCGAATCTAGGGA,180,183,3,20,10321,0,0
10922,ACGTCGAATCTAGGGA,181,189,8,17,8336,1,0
10923,ACGTCGATTCTAGGGA,181,200,19,14,8765,4,0
10924,ACGTCGAATCTAGGGA,181,183,2,17,8915,0,0
10925,ACGTCGAATCTAGGGA,181,187,6,14,8917,0,0
10926,ACGTCGAATCTAGGGA,181,188,7,14,8924,0,0
10927,ACGTCGAATCTAGGGA,181,182,1,14,9125,0,0
10928,ACGTCGAATCTAGGGA,181,191,10,19,9137,1,0
10929,ACGTCTAATCTAGGGA,181,188,7,18,9195,0,0
10930,ACGTCGAATCTAGGGA,181,197,16,18,9261,3,0
10931,ACGTCGAATCTAGGGA,181,188,7,17,9264,0,0
10932,ACGTCGAATCTAGGGA,181,183,2,14,9286,0,0
10933,ACGTCGAATCTAGGGA,181,184,3,20,9308,0,0
10934,ACGTCGAATCTAGGGA,181,188,7,18,9312,0,0
10935,ACGTCGAATCTAGGGA,181,199,18,17,9446,4,0
10936,ACGTCGAATCTAGGGA,181,197,16,15,9457,3,0
10937,ACGTCGAATCTAGGGA,181,189,8,16,9623,1,0
10938,ACGTCGAATCTAGGGA,181,188,7,14,9629,0,0
10939,ACGTCGAATCTAGGGA,181,184,3,15,9636,0,0
10940,ACGTCGAATCTAGGGA,181,182,1,18,9797,0,0
10941,ACGTCGAATCTAGGGA,181,196,15,17,9798,3,0
10942,ACGTCGAATCTAGGGA,181,183,2,15,9804,0,0
10943,ACGTCGAATCTAGGGA,181,206,25,19,9814,6,0
10944,ACGTCGAATCTAGGGA,181,188,7,13,9973,0,0
10945,ACGTCGAATCTAGGGA,181,185,4,18,9974,0,0
10946,ACGTCGAATCTAGGGA,181,189,8,17,9975,1,0
10947,ACGTCGAATCTAGGGA,181,185,4,14,10068,0,0
10948,ACGTCGAATCTAGGGA,181,184,3,19,10070,0,0
10949,ACGTCTAATCTAGGGA,181,183,2,20,10073,0,0
10950,ACGTCGAATCTAGGGA,181,182,1,18,10078,0,0
10951,ACGTCGAATCTCGGGA,181,181,0,21,10080,0,0
10952,ACGTCGAATCTAGGGA,181,183,2,17,10147,0,0
10953,ACGTCGAATCTAGGGA,181,184,3,15,10148,0,0
10954,ACGTCGAATCTAGGGA,181,184,3,14,10149,0,0
10955,ACGTCGAATCTAGGGA,181,184,3,20,10154,0,0
10956,ACGTCGAATCTAGGGA,181,184,3,22,10161,0,0
10957,ACGTCGAATCTAGGGA,181,183,2,16,10163,0,0
10958,ACGTCGAATCTAAGGA,181,182,1,18,10180,0,0
10959,ACGTCGAATCTAGGGA,181,184,3,18,10330,0,0
10960,ACGTCGAATCTAGGGA,181,184,3,18,10337,0,0
10961,ACGTCGAATCTAGGGA,181,184,3,20,10343,0,0
10962,ACGTCGAATCTAGGGA,181,184,3,19,10347,0,0
10963,ACGTCGAATCTAGGGC,181,184,3,18,10349,0,0
10964,ACGTCGAATCTAGGGA,181,184,3,21,10435,0,0
10965,ACGTCGAATCTAGGGA,181,184,3,20,10436,0,0
10966,ACGTCGAATCGAGGGA,181,184,3,14,10437,0,0
10967,ACGTCGAATCTAGGGA,181,181,0,19,10438,0,0
10968,ACGTCGAATCTAGGGA,181,184,3,18,10439,0,0
10969,ACGTCGAATCTAGGGA,181,184,3,17,10508,0,0
10970,ACCTCGAATCTAGGGA,181,181,0,20,10510,0,0
10971,ACGTCGAATCTAGGGA,181,183,2,20,10511,0,0
10972,ACGTCGAATCTATGGA,181,184,3,19,10513,0,0
10973,ACGTCGAATCTAGGGA,181,184,3,18,10514,0,0
10974,ACGTCGAATCTAGGGA,181,184,3,16,10515,0,0
10975,ACGTCGAATCTAGGGA,181,184,3,14,10517,0,0
10976,ACGTCGAATCTAGGGA,181,184,3,20,10518,0,0
10977,ACGTCGAATCTAGGGA,181,184,3,20,10519,0,0
10978,ACGTCGAATCTAGGGA,181,184,3,20,10522,0,0
10979,ACGTCGAATCTAGGGA,181,184,3,20,10523,0,0
10980,ACGTCGAATCTAGGGA,181,181,0,13,10524,0,0
10981,ACGTCGAATCTAGGGA,181,184,3,18,10526,0,0
10982,ACGTCGAATCTAGGGA,181,184,3,18,10527,0,0
10983,ACGTCGAATCTAGGGA,181,184,3,21,10528,0,0
10984,ACGTCTAATCTAGGGA,181,183,2,22,10529,0,0
10985,ACGTCGAATCTAGGGA,181,184,3,13,10530,0,0
10986,ACGTCGAATCTAGGGA,181,182,1,20,10532,0,0
10987,ACGTCGAATCTAGGGA,181,184,3,17,10536,0,0
10988,ACGTCGAATCTAGGGA,181,184,3,20,10537,0,0
10989,ACGTCGAATCTAGGGA,181,184,3,20,10538,0,0
10990,ACGTCGAATCTATGGA,181,184,3,20,10539,0,0
10991,ACGTCGAATCTAGGGA,181,183,2,24,10540,0,0
10992,ACGTCGAATCTAGGGA,181,184,3,20,10543,0,0
10993,ACGTCGAATCTACGGA,181,184,3,20,10547,0,0
10994,ACGTCGTATCTAGGGA,182,189,7,18,8100,0,0
10995,ACGTCGAATCTAGGGA,182,198,16,19,8294,3,0
10996,ACGTCGAATCTAGGGA,182,199,17,18,8561,4,0
10997,ACGTCTAATCTAGGGA,182,186,4,20,8638,0,0
10998,ACGTCGAATCTAGGGA,182,186,4,22,9188,0,0
10999,ACGTAGAATCTAGGGA,182,191,9,15,9327,1,0
11000,ACGTCGAATCTAGGGA,182,191,9,17,9328,1,0
11001,ACGTCGAATCTAGGGA,182,184,2,20,9464,0,0
11002,ACGTCGAATCTAGGGA,182,191,9,13,9498,1,0
11003,ACGTCGAATCTAGGGA,182,187,5,15,9508,0,0
11004,ACGTCGAATCTAGGGA,182,185,3,18,9511,0,0
11005,ACGTCGAATCTAGGGA,182,184,2,20,9790,0,0
11006,ACGTCGAATCTAGGGA,182,195,13,14,9794,2,0
11007,ACGTCGAATCTAGGGA,182,189,7,21,9839,0,0
11008,ACGTCGAATCTAGGGA,182,200,18,18,9844,4,0
11009,ACGTCGATTCTAGGGA,182,182,0,15,9845,0,0
11010,ACGTCGAACCTAGGGA,182,196,14,18,9849,3,0
11011,ACGTCGAATCTAGGGA,182,191,9,15,9850,1,0
11012,TCGTCGAATCTAGGGA,182,216,34,19,9860,9,0
11013,ACGTCGAATCTAGGGA,182,194,12,23,9942,2,0
11014,ACGTCGAATCTAGGGA,182,183,1,18,9959,0,0
11015,ACGTCGAATCTAGGGA,182,198,16,15,10032,3,0
11016,ACGTCGAATCTAGGGA,182,196,14,19,10034,3,0
11017,ACGTCGAATCTAGGGA,182,187,5,15,10041,0,0
11018,ACGTCGAATCTAGGGA,182,184,2,18,10051,0,0
11019,ACGTCGAATCTAGGGA,182,201,19,20,10055,4,0
11020,ACGTCGAATCTAGGGA,182,184,2,19,10065,0,0
11021,ACGTCGAATCTAGGGA,182,182,0,19,10203,0,0
11022,ACGTCGAATCTAGGGA,182,184,2,17,10327,0,0
11023,ACGTCGAATCTAGGGA,182,193,11,19,10328,2,0
11024,ACGTCGATTCTAGGGA,182,196,14,15,10396,3,0
11025,ACGTCGAATCTAGGGA,182,182,0,18,10405,0,0
11026,ACGTCGAATCTAGGGA,182,195,13,15,10410,2,0
11027,ACGTCGAATCTAGGGA,182,205,23,16,10411,6,0
11028,ACGTCGAATCTAGGGA,182,232,50,19,10413,15,0
11029,ACGTCGAATCTAGGGA,182,184,2,19,10415,0,0
11030,ACGTCGAATCTAGGGA,182,182,0,16,10418,0,0
11031,ACGTCGAATCTAGGGA,182,183,1,17,10420,0,0
11032,ACGTCGAATCTAGGGA,182,199,17,15,10422,4,0
11033,ACGTCGAATCTAGGGA,182,189,7,21,10425,0,0
11034,ACGTCGAATCTAGGGA,182,190,8,20,10427,1,0
11035,ACGTCGAATCTAGGGA,182,183,1,14,10428,0,0
11036,ACGTCGAATCTAGGGA,182,190,8,16,10431,1,0
11037,ACGTCGATTCTAGGGA,182,182,0,15,10558,0,0
11038,ACGTCGAATCTAGGGA,182,203,21,18,10560,5,0
11039,ACGTCGAATCTAGGGA,182,184,2,15,10562,0,0
11040,ACGTCGAATCTAGGGA,182,203,21,20,10564,5,0
11041,ACGTCTAATCTAGGGA,182,199,17,19,10565,4,0
11042,ACGTCGAATCTAGGGA,182,182,0,15,10568,0,0
11043,ACGTCGAATCTAGGGA,182,214,32,15,10570,9,0
11044,ACGTCGAATCTAGGGA,182,191,9,21,10572,1,0
11045,ACGTCGAATCTAGGGA,183,196,13,17,7308,3,0
11046,ACGTCGAATCTAGGGA,183,186,3,18,8690,0,0
11047,ACGTCGAATCTAGGGA,183,187,4,19,9151,0,0
11048,AGGTCTAATCTAGGGA,183,190,7,19,9377,0,0
11049,ACGTCGAATCTATGGA,183,197,14,18,9378,3,0
11050,ACGTCGAATCTAGGGA,183,194,11,17,9392,2,0
11051,ACGTCGAATCTAGGGA,183,193,10,15,9517,1,0
11052,ACGTCGAATCTAGGGA,183,186,3,19,9550,0,0
11053,ACGTCGAATCTAGGGA,183,187,4,19,9551,0,0
11054,ACGTCGAATCTAGCGA,183,184,1,17,9652,0,0
11055,ACGTCGAATCTAGGGA,183,183,0,17,9729,0,0
11056,ACGTCGAATCTAGGGA,183,187,4,20,9739,0,0
11057,ACGTCGAATCTAGGGA,183,187,4,20,9777,0,0
11058,ACGTCGAATCTAGGGA,183,196,13,19,9816,2,0
11059,ACGTCGAATCTAGGGA,183,183,0,19,9821,0,0
11060,ACGTCGAATCTAGGGA,183,199,16,19,9910,3,0
11061,ACGTCGAATCTAGGGA,183,190,7,19,9925,0,0
11062,ACGTCGAATCTAGGGA,183,195,12,14,9940,2,0
11063,ACGTCGAATCTAGGGA,183,187,4,18,10184,0,0
11064,ACGTCGAATCTAGGGA,183,183,0,21,10199,0,0
11065,ACGTCGAATCTAGGGA,183,193,10,14,10275,1,0
11066,ACGTCGAATCTAGGGA,183,184,1,18,10284,0,0
11067,ACGTCGAATCTAGGGA,183,185,2,20,10288,0,0
11068,ACGTAGAATCTAGGGA,183,184,1,16,10292,0,0
11069,ACGTCGAATCTAGGGA,183,201,18,16,10304,4,0
11070,ACGCCGAATCTAGGGA,183,190,7,19,10315,0,0
11071,ACGTCGAATCTAGGGA,183,218,35,20,10318,10,0
11072,ACGTCGAATCTAGGGA,183,183,0,20,10321,0,0
11073,ACGTCGAATCTAGGGA,183,185,2,15,10551,0,0
11074,ACGTCGAATCTAGGGA,183,186,3,13,10553,0,0
11075,ACGTCGAATCTAGGGA,183,186,3,15,10554,0,0
11076,ACGTCGAATCTAGGGA,183,185,2,20,10617,0,0
11077,ACGTCGAATCTAGGGA,183,186,3,19,10618,0,0
11078,ACGTCGAATCTAGGGA,183,186,3,18,10623,0,0
11079,ACGTCGAATCTAGGGA,183,186,3,23,10624,0,0
11080,ACGTCGAATCTAGGGA,183,184,1,16,10626,0,0
11081,ACGTAGAATCTAGGGA,183,184,1,16,10628,0,0
11082,ACGTCGAATCTAGGGA,183,186,3,20,10630,0,0
11083,ACGTCGAATCTAGGGA,184,216,32,17,8336,9,0
11084,ACGTCGATTCTAGGGA,184,186,2,14,8765,0,0
11085,ACGTCGAATCTAGGGA,184,184,0,17,8915,0,0
11086,ACGTCGAATCTAGGGA,184,189,5,14,8917,0,0
11087,ACGTCGAATCTAGGGA,184,184,0,14,9125,0,0
11088,ACGTCTAATCTAGGGA,184,195,11,18,9195,2,0
11089,ACGTCGAATCTAGGGA,184,202,18,18,9261,4,0
11090,ACGTCGAATCTAGGGA,184,184,0,17,9264,0,0
11091,ACGTCGAATCTAGGGA,184,188,4,14,9286,0,0
11092,ACGTCGAATCTAGGGA,184,187,3,18,9312,0,0
11093,ACGTCGAATCTAGGGA,184,212,28,17,9446,7,0
11094,ACGTCGAATCTAGGGA,184,186,2,16,9623,0,0
11095,ACGTCGAATCTAGGGA,184,187,3,14,9629,0,0
11096,ACGTCGAATCTAGGGA,184,198,14,15,9636,3,0
11097,ACGTCGAATCTAGGGA,184,201,17,18,9797,4,0
11098,ACGTCGAATCTAGGGA,184,192,8,17,9798,1,0
11099,ACGTCGAATCTAGGGA,184,184,0,15,9804,0,0
11100,ACGTCGAATCTAGGGA,184,188,4,19,9814,0,0
11101,ACGTCGAATCTAGGGA,184,189,5,18,9974,0,0
11102,ACGTCGAATCTAGGGA,184,184,0,14,10068,0,0
11103,ACGTCGAATCTAGGGA,184,196,12,19,10070,2,0
11104,ACGTCTAATCTAGGGA,184,187,3,20,10073,0,0
11105,ACGTCGAATCTAGGGA,184,187,3,18,10078,0,0
11106,ACGTCGAATCTCGGGA,184,187,3,21,10080,0,0
11107,ACGTCGAATCTAGGGA,184,187,3,17,10147,0,0
11108,ACGTCGAATCTAGGGA,184,185,1,15,10148,0,0
11109,ACGTCGAATCTAGGGA,184,185,1,14,10149,0,0
11110,ACGTCGAATCTAGGGA,184,187,3,20,10154,0,0
11111,ACGTCGAATCTAGGGA,184,187,3,16,10163,0,0
11112,ACGTCGAATCTAAGGA,184,187,3,18,10180,0,0
11113,ACGTCGAATCTAGGGA,184,187,3,18,10330,0,0
11114,ACGTCGAATCTAGGGA,184,187,3,18,10337,0,0
11115,ACGTCGAATCTAGGTA,184,185,1,20,10343,0,0
11116,ACGTCGAATCTAGGGA,184,187,3,18,10349,0,0
11117,ACGTCGAATCTAGGGA,184,187,3,20,10436,0,0
11118,ACGTCGAATCGAGGGA,184,187,3,14,10437,0,0
11119,ACGTCGAATCTAGGGA,184,187,3,19,10438,0,0
11120,ACGTCGAATCTAGGGA,184,187,3,18,10439,0,0
11121,ACGTCGAATCTAGGGA,184,187,3,17,10508,0,0
11122,ACCTCGAATCTAGGGA,184,187,3,20,10510,0,0
11123,ACGTCGAATCTAGGGA,184,185,1,20,10511,0,0
11124,ACGTCGAATCTATGGA,184,187,3,19,10513,0,0
11125,ACGTCGAATCTAGGGA,184,187,3,16,10515,0,0
11126,ACGTCGAATCTAGGGA,184,187,3,14,10517,0,0
11127,ACGTCGAATCTAGGGA,184,187,3,20,10518,0,0
11128,ACGTCGAATCTAGGGA,184,187,3,20,10519,0,0
11129,ACGTCGAATCTAGGGA,184,187,3,20,10522,0,0
11130,ACGTCGAATCTAGGGA,184,187,3,20,10523,0,0
11131,ACGTCGAATCTAGGGA,184,187,3,13,10524,0,0
11132,ACGTCGAATCTAGGGA,184,187,3,18,10526,0,0
11133,ACGTCGAATCTAGGGA,184,187,3,18,10527,0,0
11134,ACGTCGAATCTAGGGA,184,187,3,21,10528,0,0
11135,ACGTCGAATCTAGGGA,184,187,3,13,10530,0,0
11136,ACGTCGAATCTAGGGA,184,187,3,20,10532,0,0
11137,ACGTCGAATCTAGGGA,184,187,3,17,10536,0,0
11138,ACGTCGAATCTAGGGA,184,187,3,20,10538,0,0
11139,ACGTCGAATCTAGGGA,184,186,2,24,10540,0,0
11140,ACGTCGAATCTAGGGA,184,187,3,20,10543,0,0
11141,ACGTCGAATCTAGGGA,184,187,3,20,10547,0,0
11142,ACGTCTAATCTAGGGA,184,184,0,20,10576,0,0
11143,ACGTCGAATCTAGGGA,184,187,3,17,10578,0,0
11144,ACGTCGAATCTAGGGA,184,187,3,15,10580,0,0
11145,ACGTCGAATCTAGGGA,184,187,3,16,10581,0,0
11146,ACGTCGAATCTAGGGA,184,187,3,16,10587,0,0
11147,ACGTCGAATCTAGGGA,184,186,2,20,10588,0,0
11148,ACGTCGAATCTAGGGA,184,187,3,14,10589,0,0
11149,ACGACGAATCTAGGGA,184,187,3,18,10591,0,0
11150,ACGTCGAATCTAGGGA,184,187,3,20,10594,0,0
11151,ACGTCGAATCTAGGGA,184,187,3,20,10596,0,0
11152,ACGTCGAATCTAGGGA,184,187,3,20,10678,0,0
11153,ACGTCGAATCTATGGA,184,184,0,19,10680,0,0
11154,ACGTCGAATCTAGGGA,184,187,3,18,10681,0,0
11155,ACGTCGAATCTAGGGA,184,187,3,14,10683,0,0
11156,ACGTCGAATCTAGGGA,184,187,3,19,10690,0,0
11157,ACGTCGAATCTAGGGA,184,187,3,18,10691,0,0
11158,ACGTCTAATCTAGGGA,184,187,3,22,10694,0,0
11159,ACGTCGAATCTAGGGA,184,187,3,20,10696,0,0
11160,ACGTCGAATCTAGGGA,184,187,3,20,10701,0,0
11161,ACGTCTAATCTAGGGA,184,186,2,22,10704,0,0
11162,ACGTCGTATCTAGGGA,185,189,4,18,8100,0,0
11163,ACGTCGAATCTAGGGA,185,190,5,19,8294,0,0
11164,ACGTCTAATCTAGGGA,185,213,28,20,8638,7,0
11165,ACGTCGAATCTAGGGA,185,185,0,17,9328,0,0
11166,ACGTCGAATCTAGGGA,185,198,13,13,9498,2,0
11167,ACGTCGAATCTAGGGA,185,202,17,15,9508,4,0
11168,ACGTCGAATCTAGGGA,185,200,15,20,9790,3,0
11169,ACGTCGAATCTAGGGA,185,211,26,14,9794,7,0
11170,ACGTCGAATCTAGGGA,185,196,11,18,9844,2,0
11171,ACGTCGATTCTAGGGA,185,192,7,15,9845,0,0
11172,ACGTCGAATCTAGGGA,185,188,3,18,9849,0,0
11173,TCGTCGAATCTAGGGA,185,188,3,19,9860,0,0
11174,ACGTCGAATCTAGGAA,185,186,1,23,9942,0,0
11175,ACGTCGAATCTAGGGA,185,188,3,19,10034,0,0
11176,ACGTCGAATCTAGGGA,185,190,5,18,10051,0,0
11177,ACGTGGAATCTAGGGA,185,199,14,20,10055,3,0
11178,ACGTCGAATCTAGGGA,185,195,10,19,10065,1,0
11179,ACGTCGAATCTAGGGA,185,186,1,19,10203,0,0
11180,ACGTCGAATCTAGGGA,185,196,11,17,10327,2,0
11181,ACGTCGAATCTAGGGA,185,186,1,19,10328,0,0
11182,ACGTCGAATCTAGGGA,185,200,15,18,10405,3,0
11183,ACGTCGAATCTAGGGA,185,186,1,15,10410,0,0
11184,ACGTCGAATCTAGGGA,185,189,4,16,10411,0,0
11185,ACGTCGAATCTAGGGA,185,207,22,19,10413,5,0
11186,ACGTCGAATCTAGGGA,185,202,17,19,10415,4,0
11187,ACGTCGAATCTAGGGA,185,233,48,21,10425,14,0
11188,ACGTCGAATCTAGGGA,185,187,2,20,10427,0,0
11189,ACGTCGAATCTAGGGA,185,185,0,14,10428,0,0
11190,ACTTCGAATCTAGGGA,185,185,0,16,10431,0,0
11191,ACGTCGATTCTAGGGA,185,188,3,15,10558,0,0
11192,ACGTCGAATCTAGGGA,185,194,9,18,10560,1,0
11193,ACGTCGAATCTAGGGA,185,186,1,15,10562,0,0
11194,ACGTCTAATCTAGGGA,185,200,15,19,10565,3,0
11195,ACGTCGAATCTAGGGA,185,208,23,15,10570,6,0
11196,ACGTCGAATCTAGGGA,185,194,9,21,10572,1,0
11197,ACGTCGAATCTAGGGA,185,190,5,19,10635,0,0
11198,ACGTCGAATCTAGGGA,185,189,4,18,10750,0,0
11199,ACGTCGAATCTAGGGA,185,185,0,15,10752,0,0
11200,ACGTCGAATCTAGGGA,185,187,2,15,10753,0,0
11201,ACGTCGAATCTAGGGA,185,186,1,20,10755,0,0
11202,ACGTCGAATCTAGGGA,185,194,9,19,10757,1,0
11203,ACGTCGAATCTAGGGA,185,185,0,15,10758,0,0
11204,ACGTCGAATCTAGGGA,185,200,15,15,10760,3,0
11205,ACGTCGAATGTAGGGA,185,185,0,16,10761,0,0
11206,ACGTCGAATCTAGGGA,186,196,10,17,7308,2,0
11207,ACGTCGAATCTAGGGA,186,187,1,18,8690,0,0
11208,ACGTCGAATCTAGGGA,186,202,16,19,9151,4,0
11209,ACGTCGAATCTATGGA,186,186,0,18,9378,0,0
11210,ACGTCGAATCTAGGGA,186,192,6,17,9392,1,0
11211,ACGTCGAATCTAGGGA,186,206,20,15,9517,5,0
11212,ACGTCGAATCTAGGGA,186,190,4,17,9729,0,0
11213,ACGTCGAATCTAGGGA,186,186,0,19,9816,0,0
11214,ACGTCGAATCTAGGGA,186,203,17,19,9821,4,0
11215,ACGTCGAATCTAGGGA,186,189,3,19,9910,0,0
11216,ACGTCGAATCTAGGGA,186,195,9,19,9925,2,0
11217,ACGTCGAATCTAGGGA,186,192,6,14,9940,1,0
11218,ACGTCGAATCTAGGGA,186,192,6,21,10199,0,0
11219,ACGTCGAATCTAGGGA,186,186,0,14,10275,0,0
11220,ACGTCGAATCTAGGGA,186,192,6,18,10284,0,0
11221,ACGTAGAATCTAGGGA,186,190,4,16,10292,0,0
11222,ACGTCGAATCTAGGGA,186,199,13,19,10315,2,0
11223,ACGTCGAATCTAGGGA,186,209,23,20,10318,6,0
11224,ACGTCGAATCTAGGGA,186,199,13,15,10551,2,0
11225,ACGTCGAATCTAGGGA,186,188,2,13,10553,0,0
11226,ACGTCGAATCTAGGGA,186,199,13,15,10554,2,0
11227,ACGTCGAATCTAGGGA,186,191,5,20,10617,0,0
11228,ACGTCGAATCTAGGGA,186,196,10,19,10618,1,0
11229,ACGTCGAATCTAGGGA,186,187,1,18,10623,0,0
11230,ACGTCGAATCTAGGGA,186,216,30,23,10624,8,0
11231,ACGTCGAATCTAGGGA,186,199,13,16,10626,2,0
11232,ACGTAGAATCTAGGGA,186,189,3,16,10628,0,0
11233,ACGTCGAATCTAGGGA,186,191,5,20,10630,0,0
11234,ACGTCGAATCTAGGGA,186,191,5,13,10705,0,0
11235,ACGTCGAATCTAGGGA,186,193,7,20,10706,0,0
11236,ACGTCGAATCTAGGGA,186,191,5,20,10708,0,0
11237,ACGGCGAATCTAGGGA,186,186,0,15,10710,0,0
11238,ACGTCGAATCTAGGGA,186,186,0,19,10711,0,0
11239,ACGTAGCCTCTAGGGA,186,197,11,19,10714,2,0
11240,ACGTCGAATCTAGGGA,186,188,2,21,10717,0,0
11241,ACGTCGAATCTAGGGA,186,199,13,16,10718,2,0
11242,ACGTCGAACCTAGGGA,186,188,2,21,10720,0,0
11243,ACGTCGAATCTAGGGA,186,198,12,20,10725,2,0
11244,ACGTCGAATCTAGGGA,186,193,7,21,10762,0,0
11245,ACGTCGTATCTAGGGA,186,194,8,19,10802,1,0
11246,ACGTCTAATCTAGGGA,186,203,17,19,10804,4,0
11247,ACGTCTAATCTAGGGA,186,194,8,21,10805,1,0
11248,ACGTCGAATCTAGGGA,186,190,4,14,10810,0,0
11249,ACGTCGAATCTAGGGA,186,189,3,20,10813,0,0
11250,ACGTCGAATCTAGGGA,186,204,18,14,10815,4,0
11251,ACGTCGAATCTAGGGA,186,188,2,16,10816,0,0
11252,ACGTCGAATCTAGGGA,186,196,10,19,10817,1,0
11253,ACGTCGAATCTAGGGA,186,189,3,21,10818,0,0
11254,ACGTCGAATCTAGGGA,186,193,7,22,10820,0,0
11255,ACGTTGAATCTAGGGA,186,196,10,19,10827,1,0
11256,TCGTCGAATCTAGGGA,186,194,8,20,10828,0,0
11257,ACGTCGAATCTAGGGA,186,189,3,21,10830,0,0
11258,ACGTCGAATCTAGGGA,186,190,4,19,10833,0,0
11259,ACGTCGAATCCAGGGA,186,189,3,15,10834,0,0
11260,ACGTCGAATCTAGGGA,186,189,3,16,10838,0,0
11261,ACGTCGAATCTAGGGA,186,189,3,20,10839,0,0
11262,ACGTCGAATGTAGGGA,186,189,3,19,10843,0,0
11263,ACGTCGAATCTAGGGA,186,189,3,21,10844,0,0
11264,ACGTCGAATCTAGGGA,187,192,5,17,8336,0,0
11265,ACGTCGATTCTAGGGA,187,197,10,14,8765,1,0
11266,ACGTCGAATCTAGGGA,187,210,23,17,8915,6,0
11267,ACGTCGAATCTAGGGA,187,208,21,14,8917,5,0
11268,ACGTCGAATCTAGGGA,187,188,1,14,9125,0,0
11269,ACGTCGAATCTAGGGA,187,188,1,18,9261,0,0
11270,ACGTCGAATCTAGGGA,187,187,0,14,9286,0,0
11271,ACGTCGAATCTAGGGA,187,189,2,18,9312,0,0
11272,ACGTCGAATCTAGGGA,187,210,23,17,9446,6,0
11273,ACGTCGAATCTAGGGA,187,240,53,16,9623,16,0
11274,ACGTCGAATCTAGGGA,187,190,3,14,9629,0,0
11275,ACGTCGAATCTAGGGA,187,190,3,15,9636,0,0
11276,ACGTCGAATCTAGGGA,187,190,3,18,9797,0,0
11277,ACGTCGAATCTAGGGA,187,188,1,17,9798,0,0
11278,ACGTCGAATCTAGGGA,187,190,3,19,9814,0,0
11279,ACGTCGAATCTAGGGA,187,190,3,18,9974,0,0
11280,ACGTCGAATCTAGGGA,187,190,3,14,10068,0,0
11281,ACGTCGAATCTAGGGA,187,190,3,19,10070,0,0
11282,ACGTCTAATCTAGGGA,187,190,3,20,10073,0,0
11283,ACGTCGAATCTAGGGA,187,190,3,18,10078,0,0
11284,ACGTCGAATCTCGGGA,187,190,3,21,10080,0,0
11285,ACGTCGAATCTAGGGA,187,190,3,17,10147,0,0
11286,ACGTCGAATCTAGGGA,187,190,3,15,10148,0,0
11287,ACGTCGAATCTAGGGA,187,190,3,14,10149,0,0
11288,ACGTCGAATCTAGGGA,187,190,3,20,10154,0,0
11289,ACGTCGAATCAAAGGA,187,190,3,18,10180,0,0
11290,ACGTCGAATCTAGGGA,187,190,3,18,10337,0,0
11291,ACGTCGAATCTAGGGA,187,190,3,18,10349,0,0
11292,ACGTCGAATCGAGGGA,187,187,0,14,10437,0,0
11293,ACGTCGAATCTAGGGA,187,190,3,19,10438,0,0
11294,ACGTCGAATCTAGGGA,187,189,2,18,10439,0,0
11295,ACGTCGAATCTAGGGA,187,188,1,17,10508,0,0
11296,ACGTCGAATCTAGGGA,187,189,2,20,10511,0,0
11297,ACGTCGAATCTAGGGA,187,188,1,16,10515,0,0
11298,ACGTCGAATCTAGGGA,187,190,3,20,10518,0,0
11299,ACGTCGAATCTAGGGA,187,190,3,20,10519,0,0
11300,ACGTCGAATCTAGGGA,187,190,3,20,10522,0,0
11301,ACGTCGAATCTAGGGA,187,190,3,20,10523,0,0
11302,AAGTCGAATCTAGGGA,187,190,3,13,10524,0,0
11303,ACGTCGAATCTAGGGA,187,190,3,18,10526,0,0
11304,ACGTCGAATCTAGGGA,187,190,3,18,10527,0,0
11305,ACGTCGAATATAGGGA,187,187,0,13,10530,0,0
11306,ACGTCGAATCTAGGGA,187,190,3,20,10532,0,0
11307,ACGTCGAATCTAGGGA,187,189,2,17,10536,0,0
11308,ACGTCGAATCTAGGGA,187,190,3,20,10538,0,0
11309,ACGTCGAATCTAGGGA,187,190,3,24,10540,0,0
11310,ACGTCTAATCTAGGGA,187,190,3,20,10576,0,0
11311,ACGTCGAATCTAGGGA,187,190,3,17,10578,0,0
11312,ACGTCGAATCTAGGGA,187,188,1,15,10580,0,0
11313,ACGTCGAATCTAGGGA,187,188,1,16,10587,0,0
11314,ACGTCGAATCTAGGGA,187,187,0,20,10588,0,0
11315,ACGTCGAATCTAGGGA,187,190,3,18,10591,0,0
11316,ACGTCGAATCTAGGGA,187,190,3,20,10594,0,0
11317,ACGTCGAATCTAGGGA,187,188,1,20,10596,0,0
11318,ACGTCGAATCTAGGGA,187,187,0,20,10678,0,0
11319,ACGTCGAATCTATGGA,187,187,0,19,10680,0,0
11320,ACGTCGAATCTAGGGA,187,190,3,18,10681,0,0
11321,ACGTCGAATCTAGGGA,187,190,3,14,10683,0,0
11322,ACGTCGAATCTAGGGA,187,190,3,19,10690,0,0
11323,ACGTCTAATCTAGGGA,187,190,3,22,10694,0,0
11324,ACGTCGAATCTAGGGA,187,190,3,20,10696,0,0
11325,ACGTCTAATCTAGGGA,187,190,3,22,10704,0,0
11326,ACGTCGAATCTAGGGA,187,190,3,18,10765,0,0
11327,ACGTCGAATCTAGGGA,187,188,1,19,10871,0,0
11328,ACGTCGAATCTAGGGA,187,190,3,18,10875,0,0
11329,AAGTCGAATCTAGGGA,187,190,3,20,10878,0,0
11330,ACGTCGAATCTATGGA,187,188,1,21,10883,0,0
11331,ACGTCGAATCTAGGGA,187,188,1,20,10889,0,0
11332,ACGTCTAATCTAGGGA,187,190,3,22,10890,0,0
11333,ACGTCGAATCTAGGGA,187,190,3,15,10894,0,0
11334,ACGTCGAATCTAGGGA,187,190,3,21,10896,0,0
11335,ACGTCGAATCTAGAGC,187,190,3,23,10900,0,0
11336,ACGGCGAATCTAGGGA,187,190,3,20,10903,0,0
11337,ACGTCGAATCTAGGGA,187,189,2,18,10904,0,0
11338,ACGTCGTATCTAGGGA,188,190,2,18,8100,0,0
11339,ACGTCGAATCTAGGGA,188,225,37,19,8294,10,0
11340,ACGTCGAATCTAGGGA,188,190,2,17,9328,0,0
11341,ACGTCGAATCTAGGGA,188,191,3,13,9498,0,0
11342,ACGTCGAATCTAGGGA,188,189,1,15,9508,0,0
11343,ACGTCGAATCTAGGGA,188,189,1,20,9790,0,0
11344,ACGTCGAATCTAGGGA,188,194,6,14,9794,0,0
11345,ACGTCGAATCTAGGGA,188,191,3,18,9844,0,0
11346,ACGTCGATTCTAGGGA,188,191,3,15,9845,0,0
11347,ACGTCGAATCTAGGGA,188,195,7,18,9849,0,0
11348,TCGTCGAATCTAGGGA,188,207,19,19,9860,4,0
11349,ACGTCGAATCTAGGGA,188,197,9,23,9942,1,0
11350,ACGTCGAATCTAGGGA,188,213,25,19,10034,6,0
11351,ACGTCGAATCTAGGGA,188,197,9,18,10051,1,0
11352,ACGTCGAATCTAGGGA,188,188,0,20,10055,0,0
11353,ACGTCGAATCTAGGGA,188,195,7,19,10065,0,0
11354,ACGTCGAATCTAGGGA,188,195,7,19,10203,0,0
11355,ACGTCGAATCTAGGGA,188,191,3,17,10327,0,0
11356,ACGTCGAATCTAGGGA,188,193,5,19,10328,0,0
11357,ACGTCGAATCTAGGGA,188,197,9,15,10410,1,0
11358,ACGTCGAATCTAGGGA,188,200,12,16,10411,2,0
11359,ACGTCGAATCTAGGGA,188,193,5,19,10413,0,0
11360,ACGTCGAATCTAGGGA,188,198,10,19,10415,1,0
11361,ACGTCGAATCTAGGGA,188,205,17,21,10425,4,0
11362,ACGTCGAATCTAGGGA,188,192,4,16,10431,0,0
11363,ACGTCGATTCTAGGGA,188,192,4,15,10558,0,0
11364,ACGTCGAATCTAGGGA,188,194,6,18,10560,0,0
11365,ACGTCGAATCTAGGGA,188,210,22,15,10562,5,0
11366,ACGTCTAATCTAGGGA,188,195,7,19,10565,0,0
11367,ACGTCGAATCTAGGGA,188,194,6,15,10570,0,0
11368,ACGTCGAATCTAGGGA,188,188,0,21,10572,0,0
11369,ACGTCGAATCTAGGGA,188,220,32,18,10750,9,0
11370,ACGTCGAATCTAGGGA,188,189,1,15,10753,0,0
11371,ACGTCGAATCTAGGGA,188,190,2,20,10755,0,0
11372,ACGTCGAATCTAGGGA,188,207,19,15,10758,4,0
11373,ACGTCGAATGTAGGGA,188,195,7,16,10761,0,0
11374,ACGTCGAATCTAGGGA,188,194,6,18,10922,0,0
11375,ACGTCGATTCTAGGGA,188,192,4,15,10923,0,0
11376,ACGTCGAATCTAGGGA,188,198,10,20,10928,1,0
11377,ACGTCGAATCTAGGGA,188,222,34,19,10930,9,0
11378,ACGTCGAATCTAGGGA,188,188,0,18,10935,0,0
11379,ACGTCGAATCTAGGGA,188,201,13,16,10936,2,0
11380,ACGTCGAATCTAGGGA,188,194,6,17,10937,0,0
11381,ACGTCGAATCTAGGGA,188,190,2,18,10941,0,0
11382,ACGTCGAATCTAGGGA,188,189,1,20,10943,0,0
11383,ACGTCGAATCTAGGGA,188,197,9,18,10946,1,0
11384,ACGTCGAATCTAGGGA,188,192,4,18,11045,0,0
11385,ACGTCGAATCTAGGGA,189,190,1,17,7308,0,0
11386,ACGTCGAATCTAGGGA,189,206,17,18,8690,4,0
11387,ACGTCGAATCTATGGA,189,207,18,18,9378,5,0
11388,ACGTCGAATCTAGGGA,189,192,3,15,9517,0,0
11389,ACGTCGAATCCAGGGA,189,191,2,17,9729,0,0
11390,ACGTCGAATCTAGGGA,189,211,22,19,9816,6,0
11391,ACGTCGAATCTAGGGA,189,189,0,19,9821,0,0
11392,ACGTCGAATCTAGGGA,189,207,18,19,9925,5,0
11393,ACGTCGAATCTAGGGA,189,219,30,14,9940,9,0
11394,ACGTCGAATCTAGGGA,189,192,3,21,10199,0,0
11395,ACGTCGAATCTAGGGA,189,194,5,14,10275,0,0
11396,ACGTCGAATCTAGGGA,189,212,23,18,10284,6,0
11397,ACGTAGAATCTAGGGA,189,212,23,16,10292,6,0
11398,ACGTCGAATCTAGGGA,189,196,7,20,10318,1,0
11399,ACGTCGAATCTAGGGA,189,195,6,15,10554,1,0
11400,ACGTCGAATCTAGGGA,189,189,0,20,10617,0,0
11401,ACGTCGAATCTAGGGA,189,195,6,18,10623,1,0
11402,ACGTCGAATCTAGGGA,189,191,2,23,10624,0,0
11403,ACGTAGAATCTAGGGA,189,199,10,16,10628,2,0
11404,ACGTCGAATCTAGGGA,189,189,0,13,10705,0,0
11405,ACGTCGAATCTAGGGA,189,192,3,20,10708,0,0
11406,ACGTCGAATCTAGGGA,189,200,11,15,10710,2,0
11407,ACGTCGAATCTAGGGA,189,210,21,19,10711,6,0
11408,ACGTAGCACCTAGGGA,189,195,6,19,10714,0,0
11409,ACGTCGAATCTAGGGA,189,211,22,21,10717,5,0
11410,ACGTCGAATCTAGGGA,189,194,5,16,10718,0,0
11411,ACGTCGAATCTAGGGA,189,193,4,20,10725,0,0
11412,ACGTCGAATCTAGGGA,189,207,18,21,10762,4,0
11413,ACGTCGAATCTAGGGA,189,190,1,19,10804,0,0
11414,ACGTCTAATCTAGGGA,189,191,2,21,10805,0,0
11415,ACGTCGAATCTAGGGA,189,201,12,14,10810,2,0
11416,ACGTCGAATCTAGGGA,189,193,4,14,10815,0,0
11417,ACGTCGAATCTAGGGA,189,199,10,16,10816,1,0
11418,ACGTCGAATCTAGGGA,189,199,10,19,10817,1,0
11419,ACGTCGAATCTAGGGA,189,191,2,22,10820,0,0
11420,TCGTCGAATCTAGGGA,189,194,5,20,10828,0,0
11421,ACGTCGAATCTAGGGA,189,202,13,21,10830,2,0
11422,ACGTCGAATCTAGGGA,189,192,3,19,10833,0,0
11423,ACGTCGAATCCAGGGA,189,191,2,15,10834,0,0
11424,ACGTCGAATCTAGGGA,189,207,18,16,10838,4,0
11425,ACGTCGAATCTAGGGA,189,195,6,20,10839,0,0
11426,ACGTCGAATGTAGGGA,189,207,18,19,10843,4,0
11427,ACGTCGAATCTAGGGA,189,196,7,21,10844,0,0
11428,ACGTCGAATCTAGGGA,189,216,27,20,10995,7,0
11429,ACGTCGAATCTAGGGA,189,195,6,19,10996,0,0
11430,ACGTAGAATCTAGGGA,189,200,11,16,10999,2,0
11431,ACGTCGAATCTAGGGA,189,214,25,18,11000,6,0
11432,ACGTCGAATCTAGGGA,189,189,0,14,11002,0,0
11433,ACGTCGAATCTAGGGA,189,191,2,15,11006,0,0
11434,ACGTCGAATCTAGGGA,189,192,3,19,11008,0,0
11435,ACGTCGAACCTAGGGA,189,189,0,19,11010,0,0
11436,ACGTCGAATCTAGGGA,189,193,4,16,11011,0,0
11437,TCGTCGAATCTAGGGA,189,193,4,20,11012,0,0
11438,ACGTCGAATCTAGGGA,189,195,6,24,11013,0,0
11439,ACGTCGAATCTAGGGA,189,194,5,16,11015,0,0
11440,ACGTCGAATCTAGGGA,189,192,3,20,11016,0,0
11441,ACGTCGAATCTAGGGA,189,192,3,21,11019,0,0
11442,ACGTCGAATCTAGGGA,189,192,3,20,11023,0,0
11443,ACGTCGATTCTAGGGA,189,192,3,16,11024,0,0
11444,ACGTCGAATCTAGGGA,189,192,3,16,11026,0,0
11445,ACGTCGAATCTAGGGA,189,190,1,17,11027,0,0
11446,ACGTCGAATCTAGGGA,189,192,3,20,11028,0,0
11447,ACGTCGAATCTAGGGA,189,190,1,16,11032,0,0
11448,ACGTCGAATCTAGGGA,189,192,3,21,11034,0,0
11449,ACGTCGAATCTAGGGA,189,192,3,17,11036,0,0
11450,ACGTCGAATCTAGGGA,189,192,3,19,11038,0,0
11451,ACGTCGAATCTAGGGA,189,190,1,21,11040,0,0
11452,ACGTCTAATCTAGGGA,189,192,3,20,11041,0,0
11453,ACGTCGAATCTAGGGA,189,190,1,16,11043,0,0
11454,ACGTCGAATCTAGGGA,189,192,3,22,11044,0,0
11455,ACGTCGAATCTAGGGA,190,194,4,17,8336,0,0
11456,ACGTCGATTCTAGGGA,190,206,16,14,8765,3,0
11457,ACGTCGAATCTAGGGA,190,200,10,17,8915,1,0
11458,ACGTCGAATCTAGGGA,190,196,6,18,9261,0,0
11459,ACGTCGAATCTAGGGA,190,194,4,14,9286,0,0
11460,ACGTCGAATCTAGGGA,190,192,2,18,9312,0,0
11461,ACGTCGAATCTAGGGA,190,193,3,17,9446,0,0
11462,ACGTCGAATCTAGGGA,190,194,4,14,9629,0,0
11463,ACGTCGAATCTAGGGA,190,193,3,15,9636,0,0
11464,ACGTCGAATCTAGGGA,190,208,18,17,9798,4,0
11465,ACGTCGAATCTAGGGA,190,193,3,19,9814,0,0
11466,ACGTCGAATCTAGGGA,190,212,22,18,9974,5,0
11467,ACGTCGAATCTAGGGA,190,191,1,14,10068,0,0
11468,ACGTCGAATCTAGGGA,190,210,20,19,10070,5,0
11469,ACGTCTAATCTAGGGA,190,196,6,20,10073,0,0
11470,ACGTCGAATCTAGGGA,190,200,10,18,10078,1,0
11471,ACGTCGAATCTCGGGA,190,195,5,21,10080,0,0
11472,ACGTCGAATCTAGGGA,190,193,3,17,10147,0,0
11473,ACGTCGAATCTAGGGA,190,193,3,20,10154,0,0
11474,ACGTCGAATCTAAGGA,190,193,3,18,10180,0,0
11475,ACGTCGAATCGAGGGA,190,193,3,14,10437,0,0
11476,ACGTCGAATCTAGGGA,190,193,3,18,10439,0,0
11477,ACGTCGACTCTAGGGA,190,193,3,17,10508,0,0
11478,ACGTCGAATCTAGGGA,190,193,3,20,10511,0,0
11479,ACGTCGAATCTAGGGA,190,192,2,20,10518,0,0
11480,ACGTCGAATCTAGGGA,190,190,0,20,10522,0,0
11481,ACGTCGAATCTAGGGA,190,193,3,20,10523,0,0
11482,ACGTCGAATCTAGGGA,190,193,3,13,10524,0,0
11483,ACGTCGAATCTAGGGA,190,193,3,18,10526,0,0
11484,ACGTCGAATCTAGGGA,190,193,3,18,10527,0,0
11485,ACGCCGAATCTAGGGA,190,193,3,13,10530,0,0
11486,ACGTCGAATCTAGGGA,190,191,1,20,10532,0,0
11487,ACGTCGAATCTAGGGA,190,190,0,17,10536,0,0
11488,ACGTCGAATCTAGGGA,190,193,3,24,10540,0,0
11489,ACGTCTAATCTAGGGA,190,193,3,20,10576,0,0
11490,ACGTCGAATCTAGGGA,190,193,3,17,10578,0,0
11491,ACGTCGAATCTAGGGA,190,193,3,15,10580,0,0
11492,ACGTCGAATCTAGGGA,190,193,3,20,10588,0,0
11493,ACGTCGAATCTAGGGA,190,192,2,18,10591,0,0
11494,ACGTCGAATCTAGGGA,190,193,3,20,10594,0,0
11495,ACGTCGAATCTAGGGA,190,192,2,20,10596,0,0
11496,ACGTCGAATCTAGGGA,190,193,3,20,10678,0,0
11497,ACGTCGAATCTAGGGA,190,193,3,18,10681,0,0
11498,ACGTCTAATCTAGGGA,190,193,3,22,10694,0,0
11499,ACGTCTAATCTAGGGA,190,193,3,22,10704,0,0
11500,ACGTCGAATCTAGGGA,190,193,3,18,10765,0,0
11501,ACGTCGAATCTAGGGA,190,191,1,19,10871,0,0
11502,ACGTCGAATCTAGGGA,190,193,3,18,10875,0,0
11503,ACGTCGAATCTAGGGA,190,191,1,20,10889,0,0
11504,ACGTCGAATCTAGGGA,190,193,3,15,10894,0,0
11505,ACGTCGAATCTAGGGA,190,193,3,21,10896,0,0
11506,ACGTCGAATCTAGAGC,190,193,3,23,10900,0,0
11507,ACGTCGAATCTAGGGA,190,193,3,18,10904,0,0
11508,ACGTCGAATCTATGGA,190,190,0,19,11049,0,0
11509,ACGTCGAATCTAGGGA,190,190,0,18,11050,0,0
11510,ACGTCGAATCTAGGGA,190,193,3,16,11051,0,0
11511,ACGTCGAATCTAGGGA,190,191,1,20,11058,0,0
11512,ACGTCGAATCTAGGGA,190,193,3,20,11060,0,0
11513,ACGTCGAATCTAGGGA,190,193,3,15,11062,0,0
11514,ACGTCGAATCTAGGGA,190,190,0,15,11065,0,0
11515,ACGTCGAATCTAGGGA,190,193,3,17,11069,0,0
11516,ACGTCGAATCTAGGGA,190,190,0,21,11071,0,0
11517,ACGTCGAATCTAGGGA,191,199,8,19,8294,1,0
11518,ACGTCGAATCTAGGGA,191,193,2,17,9328,0,0
11519,ACGTCGAATCTAGGGA,191,207,16,13,9498,3,0
11520,ACGTCGAATCTAGGGA,191,227,36,15,9508,10,0
11521,ACGTCGAATCTAGGGA,191,206,15,18,9844,3,0
11522,ACGTCGATTCTAGGGA,191,195,4,15,9845,0,0
11523,ACGTCGAATCTAGGGA,191,193,2,18,9849,0,0
11524,TCGTCGAATCTAGGGA,191,194,3,19,9860,0,0
11525,ACGTCGAATCTAGGGA,191,198,7,23,9942,0,0
11526,ACGTCGAATCTAGGGA,191,191,0,18,10051,0,0
11527,ACGTCGAATCTAGGGA,191,194,3,20,10055,0,0
11528,ACGTCGAATCTAGGGA,191,204,13,19,10065,2,0
11529,ACGTCGAATCTAGGGA,191,200,9,19,10203,1,0
11530,ACGTCGAATCTAGGGA,191,199,8,17,10327,1,0
11531,ACGTCGAATCTAGGGA,191,195,4,19,10328,0,0
11532,ACGTCGAATCTAGGGA,191,192,1,16,10411,0,0
11533,ACGTCGAATCTAGGGA,191,192,1,19,10413,0,0
11534,ACGTCGAATCTAGGGA,191,196,5,19,10415,0,0
11535,ACGTCGAATCTAGGGA,191,196,5,21,10425,0,0
11536,ACGTCGAATCTAGGGA,191,197,6,16,10431,0,0
11537,ACGTCGATTCTAGGGA,191,204,13,15,10558,2,0
11538,ACGTCGAATCTAGGGA,191,194,3,18,10560,0,0
11539,ACGTCGAATCTAGGGA,191,198,7,15,10562,0,0
11540,ACGTCGAATCTAGGGA,191,191,0,15,10570,0,0
11541,ACGTCGAATCTAGGGA,191,204,13,15,10753,2,0
11542,ACGTCGAATCTAGGGA,191,191,0,20,10755,0,0
11543,ACGTCGAATCTAGGGA,191,220,29,15,10758,8,0
11544,ACGTCGAATGTAGGGA,191,228,37,16,10761,10,0
11545,ACGTCGATTCTAGGGA,191,196,5,15,10923,0,0
11546,ACGTCGAATCTAGGGA,191,208,17,19,10930,4,0
11547,ACGTCGAATCTAGGGA,191,214,23,18,10935,6,0
11548,ACGTCGAATCTAGGGA,191,229,38,16,10936,11,0
11549,ACGTCGAATCTAGGGA,191,199,8,18,10941,1,0
11550,ACGTCGAATCTAGGGA,191,198,7,20,10943,0,0
11551,ACGTCGAATCTAGGGA,191,195,4,18,11045,0,0
11552,ACGTCGAATCTAGGGA,191,196,5,18,11083,0,0
11553,ACGTCTAATCTAGGGA,191,192,1,19,11088,0,0
11554,ACGTCGAATCTAGGGA,191,203,12,19,11089,2,0
11555,ACGTCGAATCTAGGGA,191,203,12,18,11093,2,0
11556,ACGTCGAATCTAGGGA,191,191,0,16,11096,0,0
11557,ACGTCGAATCTAGGGA,191,225,34,19,11097,9,0
11558,ACGTCGAATCTAGGGA,191,200,9,18,11098,1,0
11559,ACGTCGAATCTAGGGA,191,227,36,20,11103,10,0
11560,ACGTCGAATCTAGGGA,191,218,27,18,11206,7,0
11561,ACGTCGAATCTAGGGA,191,202,11,20,11208,2,0
11562,ACGTCGAATCTAGGGA,191,192,1,18,11210,0,0
11563,ACGTCGAATCTAGGGA,191,195,4,16,11211,0,0
11564,ACGTCGAATCTAGGGA,191,206,15,20,11214,2,0
11565,ACGTCGAATCTAGGGA,191,227,36,20,11216,9,0
11566,ACGTCGAATCTAGGGA,191,192,1,15,11217,0,0
11567,ACGTCGAATCTAGGGA,192,205,13,17,7308,2,0
11568,ACGTCGAATCTGTGGA,192,196,4,18,9378,0,0
11569,ACGTCGAATCTAGGGA,192,213,21,19,9821,5,0
11570,ACGTCGAATCTAGGGA,192,194,2,14,9940,0,0
11571,ACGTCGAATCTAGGGA,192,198,6,21,10199,0,0
11572,ACGTCGAATCTAGGGA,192,210,18,18,10284,4,0
11573,ACGTAGAATCTAGGGA,192,198,6,16,10292,0,0
11574,ACGTCGAATCTAGGGA,192,195,3,18,10623,0,0
11575,ACGTAGAATCTAGGGA,192,195,3,16,10628,0,0
11576,ACGTCGAATCTAGGGA,192,195,3,13,10705,0,0
11577,ACGTAGCATCTAGGGA,192,195,3,19,10714,0,0
11578,ACGTCGAATCTAGGGA,192,195,3,21,10717,0,0
11579,ACGTCGAATCTAGGGA,192,192,0,16,10718,0,0
11580,ACGTCGAATCTAGGGA,192,195,3,20,10725,0,0
11581,ACGTCGAATCTAGGGA,192,193,1,19,10804,0,0
11582,ACGTCTAATCTAGGGA,192,195,3,21,10805,0,0
11583,ACGTCGAATCTAGGGA,192,192,0,14,10810,0,0
11584,ACGTCGAATCTAGGGA,192,195,3,14,10815,0,0
11585,ACGTCGAATCTAGGGA,192,195,3,16,10816,0,0
11586,ACGTCGAATCTAGGGA,192,195,3,22,10820,0,0
11587,TCGTCGAATCTAGGGA,192,195,3,20,10828,0,0
11588,ACGTCGAATCTAGGGA,192,195,3,21,10830,0,0
11589,ACGTCGAATCTAGGGA,192,195,3,19,10833,0,0
11590,ACGTCGAATCCAGGGA,192,195,3,15,10834,0,0
11591,ACGTCGAATCTAGGGA,192,195,3,20,10839,0,0
11592,ACGTCGAATGTAGGGA,192,195,3,19,10843,0,0
11593,ACGTCGAATCTAGGGA,192,195,3,21,10844,0,0
11594,ACGTCGAATCTAGGGA,192,195,3,20,10995,0,0
11595,ACGTCGAATCTAGGGA,192,195,3,19,10996,0,0
11596,ACGTCGAATCTAGGGA,192,195,3,15,11006,0,0
11597,ACGTCGAATCTAGGGA,192,195,3,19,11008,0,0
11598,ACGTCGAACCTAGGGA,192,195,3,19,11010,0,0
11599,TCGTCGAATCTAGGGA,192,195,3,20,11012,0,0
11600,ACGTCGAATCTAGGGA,192,193,1,24,11013,0,0
11601,ACGTCGAATCTAGGGA,192,195,3,16,11015,0,0
11602,ACGTCGAATCTAGGGA,192,194,2,20,11016,0,0
11603,ACGTCGAATCTAGGGA,192,194,2,21,11019,0,0
11604,ACGTCGAATCTAGGGA,192,195,3,20,11023,0,0
11605,ACGTCGATTCTAGGGA,192,195,3,16,11024,0,0
11606,ACGTCGAATCTAGGGA,192,193,1,16,11026,0,0
11607,ACGTCGAATCTAGGGA,192,194,2,17,11027,0,0
11608,ACGTCGAATCTAGGGA,192,192,0,20,11028,0,0
11609,ACGTCGAATCTAGGGA,192,195,3,16,11032,0,0
11610,ACGTCGAATCTAGGGA,192,195,3,19,11038,0,0
11611,ACGTCGAATCTAGGGA,192,195,3,21,11040,0,0
11612,ACGTCTAATCTAGGGA,192,195,3,20,11041,0,0
11613,ACGTCGAATCTAGGGA,192,195,3,16,11043,0,0
11614,ACGTCTAATCTAGGGA,192,193,1,21,11164,0,0
11615,ACGTCGAATCTAGGGA,192,195,3,14,11166,0,0
11616,ACGTCGAATCTAGGGA,192,195,3,16,11167,0,0
11617,ACGTCGAATCTAGGGA,192,195,3,21,11168,0,0
11618,ACGTCGAATCTAGGGA,192,193,1,15,11169,0,0
11619,ACGTCGAATCTAGGGA,192,195,3,19,11170,0,0
11620,ACGTGGAATCTAGGGA,192,195,3,21,11177,0,0
11621,ACGTCGAATCTAGGGA,192,195,3,20,11178,0,0
11622,ACGTCGAATCTAGGGA,192,195,3,18,11180,0,0
11623,ACGTCGAATCTAGGGA,192,195,3,19,11182,0,0
11624,ACGTCGAATCTAGGGA,192,195,3,20,11185,0,0
11625,ACGTCGAATCTAGGGA,192,195,3,20,11186,0,0
11626,ACGTCGAATCTAGGGA,192,195,3,22,11187,0,0
11627,ACGTCGAATCTAGGGA,192,195,3,19,11192,0,0
11628,ACGTCTAATCTAGGGA,192,195,3,20,11194,0,0
11629,ACGTCGAATCTAGGGA,192,195,3,16,11195,0,0
11630,ACGTCGAATCTAGGGA,192,195,3,22,11196,0,0
11631,ACGTCGTATCTAGGGA,192,195,3,20,11202,0,0
11632,ACGTCGAATCTAGGGA,192,192,0,16,11204,0,0
11633,ACGTCGAATCTAGGGA,193,195,2,17,8915,0,0
11634,ACGTCGAATCTAGGGA,193,209,16,18,9261,3,0
11635,ACGTCGAATCTAGGGA,193,225,32,14,9286,9,0
11636,ACGTCGAATCTAGGGA,193,200,7,17,9446,0,0
11637,ACGTCGAATCTAGGGA,193,202,9,14,9629,1,0
11638,ACGTCGAATCTAGGGA,193,211,18,15,9636,4,0
11639,ACGTCGAATCTAGGGA,193,205,12,17,9798,2,0
11640,ACGTCGAATCTAGGGA,193,223,30,18,9974,8,0
11641,ACGTCGAATCTAGGGA,193,194,1,14,10068,0,0
11642,ACGTCGAATCTAGGGA,193,217,24,19,10070,6,0
11643,ACGTCGAATCTAGGGA,193,208,15,17,10147,3,0
11644,ACGTCGAATCTAGGGA,193,194,1,20,10154,0,0
11645,ACGTCGAATCTAAGGA,193,213,20,18,10180,5,0
11646,ACGTCGAATCGAGGGA,193,193,0,14,10437,0,0
11647,ACGTCGAATCTAGGGA,193,194,1,17,10508,0,0
11648,ACGTCGAATCTAGGGA,193,193,0,20,10511,0,0
11649,ACGTCGAATCTAGGGA,193,196,3,20,10518,0,0
11650,ACGTCGAATCTAGGGA,193,196,3,20,10522,0,0
11651,ACGTCGAATCTAGGGA,193,204,11,20,10523,2,0
11652,ACGTCGAATCTAGGGA,193,221,28,13,10524,7,0
11653,ACGTCGAATCTAGGGA,193,194,1,13,10530,0,0
11654,ACGTCGAATCTAGGGA,193,202,9,20,10532,1,0
11655,ACGTCGAATCTAGGGA,193,193,0,17,10536,0,0
11656,ACGTCTAATCTAGGGA,193,207,14,20,10576,3,0
11657,ACGTCGAATCTAGGGA,193,199,6,18,10591,0,0
11658,ACGTCGAATCTAGGGA,193,199,6,20,10594,0,0
11659,ACGTCGAATCTAGGGA,193,193,0,20,10596,0,0
11660,ACGTCGAATCTAGGGA,193,208,15,20,10678,3,0
11661,ACGTCGAATCTAGGGA,193,210,17,18,10681,4,0
11662,ACGTCGAATCTAGGGA,193,213,20,18,10765,5,0
11663,ACGTCGAATCTAGGGA,193,210,17,18,10875,4,0
11664,ACGTCGAATCTAGGGA,193,227,34,15,10894,9,0
11665,ACGTCGAATCTAGAGC,193,195,2,23,10900,0,0
11666,ACGTCGAATCTAGGGA,193,193,0,18,10904,0,0
11667,ACGTCGAATCTATGGA,193,196,3,19,11049,0,0
11668,ACGTCGAATCTAGGGA,193,193,0,18,11050,0,0
11669,ACGTCGAATCTAGGGA,193,213,20,20,11058,5,0
11670,ACGTCGAATCTAGGGA,193,193,0,20,11060,0,0
11671,ACGTCGAATCTAGGGA,193,199,6,15,11062,0,0
11672,ACGTCGAATCTAGGGA,193,217,24,17,11069,6,0
11673,ACGTCGAATCTAGGGA,193,216,23,21,11071,6,0
11674,ACGTCGAATCTAGGGA,193,195,2,20,11222,0,0
11675,ACGTCGAATCTAGGGA,193,194,1,21,11223,0,0
11676,ACGTCGAATCTAGGGA,193,194,1,16,11224,0,0
11677,ACGTCGAATCTAGGGA,193,196,3,16,11226,0,0
11678,ACGTCGAATCTAGGGA,193,204,11,20,11228,2,0
11679,ACGTCGAATCTAGGGA,193,206,13,24,11230,2,0
11680,ACGTCGAATCTAGGGA,193,196,3,17,11231,0,0
11681,ACGTAGCCTCTAGGGA,193,202,9,20,11239,1,0
11682,ACGTCGAATCTAGGGA,193,200,7,17,11241,0,0
11683,ACGTCGAATCTAGGGA,193,197,4,21,11243,0,0
11684,ACGTCGTATCTAGGGA,193,194,1,20,11245,0,0
11685,ACGTCTAATCTAGGGA,193,193,0,20,11246,0,0
11686,ACGTCTAATCTAGGGA,193,195,2,22,11247,0,0
11687,ACGTCGAATCTAGGGA,193,203,10,15,11250,1,0
11688,ACGTCGAATCTAGGGA,193,195,2,20,11252,0,0
11689,ACGTCGAATCTAGGGA,194,195,1,19,8294,0,0
11690,ACGTCGAATCTAGGGA,194,199,5,17,9328,0,0
11691,ACGTCGAATCTAGGGA,194,203,9,13,9498,2,0
11692,ACGTCGAATCTAGGGA,194,201,7,15,9508,1,0
11693,ACGTCGAATCTAGGGA,194,194,0,18,9844,0,0
11694,ACGTCGATTCTAGGGA,194,194,0,15,9845,0,0
11695,ACGTCGAATCTAGGGA,194,196,2,18,9849,0,0
11696,TCGTCGAATCTAGGGA,194,194,0,19,9860,0,0
11697,ACGTCGAATCTAGGGA,194,203,9,23,9942,2,0
11698,ACGTCGAATCGAGGGA,194,203,9,18,10051,2,0
11699,ACGTCGAATCTAGGGA,194,209,15,20,10055,4,0
11700,ACGTCGAATCTAGGGA,194,201,7,19,10065,1,0
11701,ACGTCGAATCTAGGGA,194,201,7,19,10203,1,0
11702,ACGTCGAATCTAGGGA,194,194,0,19,10328,0,0
11703,ACGTCGAATCTAGGGA,194,202,8,16,10411,1,0
11704,ACGTCGAATCTAGGGA,194,194,0,19,10413,0,0
11705,ACGTCGAATCTAGGGA,194,223,29,19,10415,8,0
11706,ACGTCGAATCTAGGGA,194,211,17,21,10425,4,0
11707,ACGTCGAATCTAGGGA,194,195,1,16,10431,0,0
11708,ACGTCGAATCTAGGGA,194,206,12,18,10560,3,0
11709,ACGTCGAATCTAGGGA,194,207,13,15,10562,3,0
11710,ACGTCGAATCTAGGGA,194,200,6,15,10570,1,0
11711,ACGTCGAATCTAGGGA,194,201,7,20,10755,1,0
11712,ACGTCGAATCTAGGGA,194,200,6,15,10758,1,0
11713,ACGTCGAATGTAGGGA,194,231,37,16,10761,11,0
11714,ACGTCGATTCTAGGGA,194,194,0,15,10923,0,0
11715,ACGTCGAATCTAGGGA,194,204,10,19,10930,2,0
11716,ACGTCGAATCTAGGGA,194,207,13,18,10935,3,0
11717,ACGTCGAATCTAGGGA,194,201,7,16,10936,1,0
11718,ACGTCGAATCTAGGGA,194,209,15,18,10941,4,0
11719,ACGTCGAATCTAGGGA,194,195,1,20,10943,0,0
11720,ACGTCGAATCTAGGGA,194,216,22,18,11045,5,0
11721,ACGTCGAATCTAGGGA,194,194,0,18,11083,0,0
11722,ACGTCTAATCTAGGGA,194,195,1,19,11088,0,0
11723,ACGTCGAATCTAGGGA,194,202,8,19,11089,1,0
11724,ACGTCGAATCTAGGGA,194,206,12,18,11093,2,0
11725,ACGTCGAATCTAGGGA,194,198,4,16,11096,0,0
11726,ACGTCGAATCTAGGGA,194,195,1,19,11097,0,0
11727,ACGTCGAATCTAGGGA,194,228,34,20,11103,9,0
11728,ACGTCGAATCTAGGGA,194,207,13,18,11206,2,0
11729,ACGTCGAATCTAGGGA,194,201,7,20,11208,0,0
11730,ACGTCGAATCTAGGGA,194,199,5,16,11211,0,0
11731,ACGTCGAATCTAGGGA,194,218,24,20,11214,6,0
11732,ACGTCGAATCTAGGGA,194,198,4,20,11216,0,0
11733,ACGTCGATTCTAGGGA,194,214,20,15,11265,5,0
11734,ACGTCGAATCTAGGGA,194,204,10,18,11266,1,0
11735,ACGTCGAATCTAGGGA,194,195,1,15,11267,0,0
11736,ACGTCGAATCTAGGGA,194,195,1,18,11272,0,0
11737,ACGTCGAATCTAGGGA,194,195,1,17,11273,0,0
11738,ACGTCGAATCTAGGGA,194,200,6,19,11386,0,0
11739,ACGTCGAATCTATGGA,194,196,2,19,11387,0,0
11740,ACGTCGAATCTAGGGA,194,234,40,20,11390,11,0
11741,ACGTCGAATCTAGGGA,194,201,7,20,11392,0,0
11742,ACGTCGAATCTAGGGA,194,197,3,15,11393,0,0
11743,ACGTCGAATCTAGGGA,194,212,18,19,11396,4,0
11744,ACGTAGAATCTAGGGA,194,197,3,17,11397,0,0
11745,ACGTCGAATCTAGGGA,194,198,4,21,11398,0,0
11746,ACGTCGAATCTAGGGA,194,203,9,16,11399,1,0
11747,ACGTCGAATCTAGGGA,194,194,0,19,11401,0,0
11748,ACGTAGAATCTAGGGA,194,196,2,17,11403,0,0
11749,ACGTCGAACCTAGGGA,194,194,0,16,11406,0,0
11750,ACGTCGAATCTAGGGA,194,212,18,20,11407,4,0
11751,ACGTCGAATCTATGGA,195,231,36,18,9378,11,0
11752,ACGTCGAATCTAGGGA,195,204,9,14,9940,2,0
11753,ACGTCGAATCTAGGGA,195,204,9,21,10199,2,0
11754,ACGTCGAATCTAGGGA,195,200,5,18,10284,0,0
11755,ACGTAGAATCTAGGGA,195,198,3,16,10292,0,0
11756,ACGTAGAATCTAGGGA,195,228,33,16,10628,9,0
11757,ACGTCGAATCTAGGGA,195,197,2,13,10705,0,0
11758,ACGTAGCATCTAGGGA,195,198,3,19,10714,0,0
11759,ACGTCGAATCTAGGGA,195,195,0,21,10717,0,0
11760,ACGTCGAATCTAGGGA,195,198,3,20,10725,0,0
11761,ACGTCGAATCTAGGGA,195,195,0,19,10804,0,0
11762,ACGTCGAATCTAGGGA,195,196,1,14,10815,0,0
11763,ACGTCGAATCTAGGGA,195,198,3,16,10816,0,0
11764,ACGTCGAATCTAGGGA,195,198,3,22,10820,0,0
11765,TCGTCGAATCTAGGGA,195,198,3,20,10828,0,0
11766,ACGTCGAATCTAGGGA,195,198,3,21,10830,0,0
11767,ACGTCGAATCCAGGGA,195,198,3,15,10834,0,0
11768,ACGTCGAATCTAGGGA,195,197,2,20,10839,0,0
11769,ACGTCGAATGTAGGGA,195,198,3,19,10843,0,0
11770,ACGTCGAATCTAGGGA,195,195,0,20,10995,0,0
11771,ACGTCGAATCTAGGGA,195,197,2,19,10996,0,0
11772,ATGTCGAATCTAGGGA,195,198,3,19,11008,0,0
11773,ACGTCGAACCTAGGGA,195,198,3,19,11010,0,0
11774,TCGTCGAATCTAGGGA,195,196,1,20,11012,0,0
11775,ACGTCGAATCTAGGGA,195,198,3,16,11015,0,0
11776,ACGTCGAATCTAGGGA,195,198,3,20,11016,0,0
11777,ACGTCGAATCTAGGGA,195,198,3,21,11019,0,0
11778,ACGTCGATTCTAGGGA,195,198,3,16,11024,0,0
11779,ACGTCGAATCTAGGGA,195,198,3,17,11027,0,0
11780,ACGTCGAATCTAGGGA,195,198,3,20,11028,0,0
11781,ACGTCGAATCTAGGGA,195,198,3,16,11032,0,0
11782,ACGTCGAATCTAGGGA,195,198,3,19,11038,0,0
11783,ACGTCGAATCTAGGGA,195,198,3,21,11040,0,0
11784,ACGTCTAATCTAGGGA,195,195,0,20,11041,0,0
11785,ACGTCGAATCTAGGGA,195,198,3,16,11043,0,0
11786,ACGTCTAATCTAGGGA,195,196,1,21,11164,0,0
11787,ACGTCGAATCTAGGGA,195,198,3,14,11166,0,0
11788,ACGTCGAATCTAGGGA,195,198,3,16,11167,0,0
11789,ACGTCGAATCTAGGGA,195,195,0,21,11168,0,0
11790,ACGTCGAATCTAGGGA,195,198,3,15,11169,0,0
11791,ACGTCGAATCTAGGGA,195,198,3,19,11170,0,0
11792,ACGTGGAATCTAGGGA,195,195,0,21,11177,0,0
11793,ACGTCGAATCTAGGGA,195,198,3,18,11180,0,0
11794,ACGTCGAATCTAGGGA,195,198,3,19,11182,0,0
11795,ACGTCGAATCTAGGGA,195,198,3,20,11185,0,0
11796,ACGTCGAATCTAGGGA,195,195,0,20,11186,0,0
11797,ACGTCGAATCTAGGGA,195,195,0,22,11187,0,0
11798,ACGTCTAATCTAGGGA,195,198,3,20,11194,0,0
11799,ACGTCGAATCTAGGGA,195,196,1,16,11195,0,0
11800,ACGTCGAATCTAGGGA,195,198,3,16,11204,0,0
11801,ACGTTGAATCTAGGGA,195,198,3,20,11255,0,0
11802,ACGTCGAATCTAGGGA,195,198,3,20,11339,0,0
11803,TCGTCGAATCTAGGGA,195,198,3,20,11348,0,0
11804,ACGTCGAATCTAGGGA,195,198,3,24,11349,0,0
11805,ACGTCGAATCTAGGGA,195,198,3,20,11350,0,0
11806,ACGTCGAATCTAGGGA,195,195,0,19,11351,0,0
11807,ACGTCGAATCTAGGGA,195,196,1,16,11357,0,0
11808,ACGTCGAATCTAGGGA,195,197,2,17,11358,0,0
11809,ACGTCGAATCTAGGGA,195,198,3,20,11360,0,0
11810,ACGTCGAATCTAGGGA,195,198,3,22,11361,0,0
11811,ACGTCGAATCTAGGGA,195,198,3,16,11365,0,0
11812,ACGTCGAATCTAGGGA,195,197,2,19,11369,0,0
11813,ACGTCGAATCTAGGGA,195,198,3,16,11372,0,0
11814,ACGTCGAATCTAGGGA,195,198,3,21,11376,0,0
11815,ACGTCGAATCTAGGGA,195,198,3,20,11377,0,0
11816,ACGTCGAATCTAGGGA,195,198,3,17,11379,0,0
11817,ACGTCGAATCTAGGGA,195,198,3,19,11383,0,0
11818,ACGTCGAATCTAGGGA,196,231,35,18,9261,10,0
11819,ACGTCGAATCTAGGGA,196,245,49,14,9286,14,0
11820,ACGTCGAATCTAGGGA,196,207,11,17,9446,2,0
11821,ACGTCGAATCTAGGGA,196,199,3,15,9636,0,0
11822,ACGTCGAATCTAGGGA,196,202,6,17,9798,0,0
11823,ACGTCGAATCTAGGGA,196,198,2,18,9974,0,0
11824,ACGTCGAATCTAGGGA,196,206,10,14,10068,1,0
11825,ACGTCGAATCTAGGGA,196,197,1,19,10070,0,0
11826,ACGTCGAATCTAGGGA,196,196,0,20,10154,0,0
11827,ACGTCGAATCTAAGGA,196,210,14,18,10180,3,0
11828,ACGTCGAATCGAGGGA,196,202,6,14,10437,0,0
11829,ACGTCGAATCTAGGGA,196,197,1,17,10508,0,0
11830,ACGTCGAATCTAGGGC,196,202,6,20,10511,0,0
11831,ACGTCGAATCTAGGGA,196,207,11,20,10522,2,0
11832,ACGTCGAATCTAGGGA,196,218,22,13,10530,5,0
11833,ACGTCGAATCTAGGGA,196,196,0,20,10532,0,0
11834,ACGTCGAATCTAGGGA,196,196,0,17,10536,0,0
11835,ACGTCTAATCTAGGGA,196,201,5,20,10576,0,0
11836,ACGTCGAATCTAGGGA,196,221,25,20,10594,6,0
11837,ACGTCGAATCTAGGGA,196,198,2,20,10596,0,0
11838,ACGTCGAATCTAGGGA,196,210,14,20,10678,3,0
11839,ACGTCGAATCTAGGGA,196,198,2,18,10681,0,0
11840,ACGTCGAATCTAGGGA,196,198,2,18,10765,0,0
11841,ACGTCGAATCGAGAGC,196,200,4,23,10900,0,0
11842,ACGTCGAATCTAGGGA,196,205,9,18,10904,1,0
11843,TCGTCGAATCTATGGA,196,220,24,19,11049,6,0
11844,ACGTCGAATCTAGGGA,196,198,2,20,11060,0,0
11845,ACGTCGAATCTAGGGA,196,196,0,17,11069,0,0
11846,ACGTCGAATCTAGGGA,196,203,7,21,11071,0,0
11847,ACGTCGAATCTAGGGA,196,237,41,20,11222,12,0
11848,ACGTCGAATCTAGGGA,196,223,27,21,11223,7,0
11849,ACGTCGAATCTAGGGA,196,202,6,16,11224,0,0
11850,ACGTCGAATCTAGGGA,196,215,19,16,11226,4,0
11851,ACGTCGAATCTAGGGA,196,200,4,24,11230,0,0
11852,ACGTCGAATCTAGGGA,196,205,9,17,11231,1,0
11853,ACGTAGCCTCTAGGGA,196,207,11,20,11239,2,0
11854,ACGTCGAATCTAGGGA,196,197,1,17,11241,0,0
11855,ACGTCGAATCTAGGGA,196,205,9,21,11243,1,0
11856,ACGTCTAATCTAGGGA,196,220,24,20,11246,6,0
11857,ACGTCGAATCTAGGGA,196,204,8,15,11250,1,0
11858,ACGTCGAATCTAGGGA,196,205,9,22,11409,1,0
11859,ACGTCGAAACTAGGGA,196,201,5,22,11412,0,0
11860,ACGTCGAATCTAGGGA,196,202,6,15,11415,0,0
11861,ACGTCGAATCTAGGGA,196,196,0,17,11417,0,0
11862,ACGTCGAATCTAGGGA,196,207,11,20,11418,2,0
11863,ACGTCGAATCTAGGGA,196,207,11,22,11421,2,0
11864,ACGTCGAATCTAGGGA,196,215,19,17,11424,4,0
11865,ACGTCGAATGTAGGGA,196,210,14,20,11426,3,0
11866,ACGTCGAATCTAGGGA,196,199,3,21,11428,0,0
11867,ACGTAGAATCTAGGGA,196,208,12,17,11430,2,0
11868,ACGTCGAATCTAGGGA,196,220,24,19,11431,6,0
11869,ACGTCGAATCTAGGGA,197,207,10,19,8294,2,0
11870,ACGTCGAATCTAGGGA,197,200,3,17,9328,0,0
11871,ACGTCGAATCTAGGGA,197,197,0,15,9508,0,0
11872,ACGTCGAATCTAGGGA,197,210,13,18,9849,3,0
11873,TCGTCGAATCTAGGGA,197,200,3,19,9860,0,0
11874,ACGTCGAATCTAGGGA,197,200,3,18,10051,0,0
11875,ACGTCGAATCTAGGGA,197,199,2,20,10055,0,0
11876,ACGTCGAATCTAGGGA,197,201,4,19,10065,0,0
11877,ACGTCGACTCTAGGGA,197,197,0,19,10203,0,0
11878,ACGTCGAATCTAGGGA,197,212,15,16,10411,4,0
11879,ACGTCGAATCTAGGGA,197,199,2,19,10413,0,0
11880,ACGTCGAATCTAGGGA,197,202,5,19,10415,0,0
11881,ACGTCGAATCTAGGGA,197,212,15,21,10425,3,0
11882,ACGTCGAATCTAGGGA,197,205,8,16,10431,1,0
11883,ACGTCGAATCTAGGGA,197,210,13,18,10560,2,0
11884,ACGTCGAATCTAGGGA,197,197,0,15,10562,0,0
11885,ACGTCGAATCTAGGGA,197,208,11,15,10570,2,0
11886,ACGTCGATTCTAGGGA,197,202,5,15,10923,0,0
11887,ACGTCGAATCTAGGGA,197,198,1,18,10935,0,0
11888,ACGTCGAATCTAGGGA,197,197,0,20,10943,0,0
11889,ACGTCGAATCTAGGGA,197,204,7,18,11083,0,0
11890,ACGTCGAATCTAGGGA,197,198,1,19,11089,0,0
11891,ACGTCGAATCTAGGGA,197,198,1,18,11093,0,0
11892,ACGTCGAATCTAGGGA,197,212,15,16,11096,3,0
11893,ACGTCGAATCTAGGGA,197,213,16,19,11097,3,0
11894,ACGTCGAATCTAGGGA,197,201,4,20,11208,0,0
11895,ACGTCGAATCTAGGGA,197,198,1,16,11211,0,0
11896,ACGTCGAATCTAGGGA,197,200,3,20,11214,0,0
11897,ACGTCGAATCTAGGGA,197,207,10,18,11266,1,0
11898,ACGTCGAATCTAGGGA,197,199,2,15,11267,0,0
11899,ACGTCGAATCTAGGGA,197,199,2,18,11272,0,0
11900,ACGTCGAATCTAGGGA,197,201,4,17,11273,0,0
11901,ACGTCGAATCTAGGGA,197,207,10,19,11386,1,0
11902,ACGTCGAATCTATGGA,197,206,9,19,11387,1,0
11903,ACGTCGAATCTAGGGA,197,202,5,20,11390,0,0
11904,ACGTCGAATCTAGGGA,197,206,9,20,11392,1,0
11905,ACGTCGAATCTAGGGA,197,206,9,15,11393,1,0
11906,ACGTCGAATCTAGGGA,197,207,10,19,11396,1,0
11907,ACGTAGAATCTAGGGA,197,205,8,17,11397,1,0
11908,ACGTAGAATCTAGGGA,197,197,0,17,11403,0,0
11909,ACGTCGAATCTAGGGA,197,210,13,16,11406,2,0
11910,ACGTCGAATCTAGGGA,197,200,3,20,11407,0,0
11911,ACGTCGATTCTAGGGA,197,200,3,15,11456,0,0
11912,ACGTCGAATCTAGGGA,197,200,3,18,11457,0,0
11913,ACGTCGAATCTAGGGA,197,199,2,18,11464,0,0
11914,ACGTCGAATCTAGGGA,197,200,3,19,11466,0,0
11915,ACGTCGAATCTAGGGA,197,199,2,20,11468,0,0
11916,ACGTCGAATCTAGGGA,197,197,0,19,11470,0,0
11917,ACGTCGAATCTATGGA,198,200,2,18,9378,0,0
11918,ACGTCGAATCTAGGGA,198,200,2,14,9940,0,0
11919,ACGTCGAATCTAGGGA,198,212,14,21,10199,3,0
11920,ACGTCGAATCTAGGGA,198,198,0,18,10284,0,0
11921,ACGTAGAATCTAGGGA,198,248,50,16,10628,15,0
11922,ACGTCGAATCTAGGGA,198,227,29,13,10705,8,0
11923,ACGTAGCATCTAGGGA,198,219,21,19,10714,5,0
11924,ACGTCGAATCTAGGGA,198,206,8,20,10725,1,0
11925,ACGTCGAATCTAGGGA,198,215,17,14,10815,4,0
11926,ACGTCGAATCTAGGGA,198,211,13,16,10816,2,0
11927,ACGTCGAATCTAGGGA,198,202,4,22,10820,0,0
11928,ACGTCGAATCTAGGGA,198,200,2,21,10830,0,0
11929,ACGTCGAATCCAGGGA,198,201,3,15,10834,0,0
11930,ACGTCGAATCTAGGGA,198,204,6,20,10839,0,0
11931,ACGTCGAATGTAGGGA,198,205,7,19,10843,0,0
11932,ACGACGAATCTAGGGA,198,199,1,19,10996,0,0
11933,ACGTCGAATCTAGGGA,198,204,6,19,11008,0,0
11934,TCGTCGAATCTAGGGA,198,206,8,20,11012,1,0
11935,ACGTCGAATCTAGGGA,198,207,9,21,11019,1,0
11936,ACGTCGAATCTAGGGA,198,223,25,17,11027,6,0
11937,ACGTCGAATCTAGGGA,198,208,10,20,11028,1,0
11938,ACGTCGAATCTAGGGA,198,201,3,16,11032,0,0
11939,ACGTCGAATCTAGGGA,198,199,1,19,11038,0,0
11940,ACGTCGAATCTAGGGA,198,198,0,21,11040,0,0
11941,ACGTCTAATCTAGGGA,198,201,3,20,11041,0,0
11942,ACGTCGAATCTAGGGA,198,201,3,16,11043,0,0
11943,ACGTCTAATCTAGGGA,198,201,3,21,11164,0,0
11944,ACGTCGAATCTAGGGA,198,201,3,16,11167,0,0
11945,ACGTCGAATCTAGGGA,198,201,3,21,11168,0,0
11946,ACGTCGAATCTAGGGA,198,201,3,15,11169,0,0
11947,ACGTGGAATCTAGGGA,198,201,3,21,11177,0,0
11948,ACGTCGAATCTAGGGA,198,201,3,19,11182,0,0
11949,ACGTCGAATCTAGGGA,198,201,3,20,11185,0,0
11950,ACGTCGAATCTAGGGA,198,200,2,20,11186,0,0
11951,ACGTCGAATCTAGGGA,198,199,1,22,11187,0,0
11952,ACGTCTAATCTAGGGA,198,201,3,20,11194,0,0
11953,ACGTCGAATCTAGGGA,198,201,3,16,11195,0,0
11954,ACGTCGAATCTAGGGA,198,201,3,16,11204,0,0
11955,ACGTCGAATCTAGGGA,198,201,3,20,11339,0,0
11956,TCGTCGAATCTAGGGA,198,201,3,20,11348,0,0
11957,ACGTCGAATCTAGGGA,198,199,1,20,11350,0,0
11958,ACGTTGAATCTAGGGA,198,201,3,17,11358,0,0
11959,ACGTCGAATCTAGGGA,198,201,3,22,11361,0,0
11960,ACGTCGAATCTAGGGA,198,201,3,16,11365,0,0
11961,ACGTCGAATCTAGGGA,198,199,1,19,11369,0,0
11962,ACGTCGAATCTAGGGA,198,200,2,16,11372,0,0
11963,ACGTCGAATCTAGGGA,198,201,3,20,11377,0,0
11964,ACGTCGAATCTAGGGA,198,201,3,17,11379,0,0
11965,ACGTCGAATCTAGGGA,198,201,3,20,11517,0,0
11966,ACGTCGAATCTAGGGA,198,201,3,14,11519,0,0
11967,ACGTCGAATCTAGGGA,198,200,2,16,11520,0,0
11968,ACGTCGAATCTAGGGA,198,201,3,19,11521,0,0
11969,ACGTCGAATCTAGGGA,198,198,0,20,11528,0,0
11970,ACGTCGAATCTAGGGA,198,201,3,20,11529,0,0
11971,ACGTCGAATCTAGGGA,198,200,2,18,11530,0,0
11972,ACGTCGATTCTAGGGA,198,199,1,16,11537,0,0
11973,ACGTCGAATCTAGGGA,198,201,3,16,11541,0,0
11974,ACGTCGAATCTAGGGA,198,200,2,16,11543,0,0
11975,ACGTCGAATGTAGGGA,198,201,3,17,11544,0,0
11976,ACGTCGAATCTAGGGA,198,201,3,20,11546,0,0
11977,ACGTCGAATCTAGGGA,198,201,3,19,11547,0,0
11978,ACGTCGAATCTAGGGA,198,201,3,17,11548,0,0
11979,ACGTCGAATCTAGGGA,198,201,3,19,11549,0,0
11980,ACGTCGAATCTAGGGA,198,199,1,20,11554,0,0
11981,ACGTCGAATCTAGGGA,198,201,3,19,11555,0,0
11982,ACGTCGAATCTAGGGA,198,198,0,20,11557,0,0
11983,ACGTCGAATCTAGGGA,198,201,3,19,11558,0,0
11984,ACGTCGAATCTAGGGA,198,198,0,21,11559,0,0
11985,ACGTCGAATCTAGGGA,198,201,3,19,11560,0,0
11986,ACGTCGAATCTAGGGA,198,201,3,21,11561,0,0
11987,ACGTCGAATCTAGGGA,199,219,20,18,9261,5,0
11988,ACGTCGAATCTAGGGA,199,200,1,14,9286,0,0
11989,ACGTCGAATCTAGGGA,199,203,4,15,9636,0,0
11990,ACGTCGAATCTAGGGA,199,210,11,14,10068,2,0
11991,ACGTCGAATCTAGGGA,199,199,0,19,10070,0,0
11992,ACGTCGAATCTAGGGA,199,224,25,20,10154,6,0
11993,ACGTCGAATCTAGGGA,199,230,31,18,10180,8,0
11994,ACGTCGAATCGAGGGA,199,225,26,14,10437,7,0
11995,ACGTCGAATCTAGGGA,199,212,13,13,10530,2,0
11996,ACGTCGAATCTAGGGA,199,202,3,20,10532,0,0
11997,ACGTCTAATCTAGGGA,199,208,9,20,10576,1,0
11998,ACGTCGAATCTAGGGT,199,205,6,20,10594,0,0
11999,ACGTCGAATCTAGGGA,199,199,0,20,10678,0,0
12000,ACGTCGAATCTAGGGA,199,224,25,18,10765,6,0
12001,ACGTCGAATCTAGGGA,199,203,4,18,10904,0,0
12002,ACGTCGAATCTAGGGA,199,213,14,17,11069,3,0
12003,ACGTCGAATCTAGGGA,199,200,1,21,11071,0,0
12004,ACGTCGAATCTAGGGA,199,213,14,21,11223,3,0
12005,ACGTCGAATCTAGGGA,199,235,36,24,11230,10,0
12006,ACGTCTAATCTAGGGA,199,202,3,20,11246,0,0
12007,ACGTCGAATCTAGGGA,199,220,21,15,11250,5,0
12008,ACGTCGAATCTAGGGA,199,219,20,22,11409,5,0
12009,ACGTCGAATCTAGGGA,199,203,4,22,11412,0,0
12010,ACGTCGAATCTAGGGA,199,209,10,15,11415,1,0
12011,ACGTCGAATCTAGGGA,199,203,4,22,11421,0,0
12012,ACGTCGAATCTAGGGA,199,199,0,17,11424,0,0
12013,ACGTCGAATGTAGGGA,199,199,0,20,11426,0,0
12014,ACGTCGAATCTAGGGA,199,199,0,21,11428,0,0
12015,ACGTAGAATCTAGGGA,199,210,11,17,11430,2,0
12016,ACGTCGAATCTAGGGA,199,207,8,19,11431,1,0
12017,ACGTCGAATCTAGGGA,199,199,0,18,11567,0,0
12018,ACGTCGAATCTAGGGA,199,210,11,20,11569,2,0
12019,ACGTCGAATCTAGGGA,199,232,33,19,11572,9,0
12020,ACGTCGAATCTAGGGA,199,199,0,14,11691,0,0
12021,ACGTCGAATCTAGGGA,199,211,12,16,11692,2,0
12022,ACGTCGAATCTAGGGA,199,231,32,24,11697,9,0
12023,ACGTCGAATCGAGGGA,199,223,24,19,11698,6,0
12024,ACGTCGAATCTAGGGA,199,203,4,21,11699,0,0
12025,ACGTCGAATCTAGGGA,199,200,1,20,11700,0,0
12026,ACGTCGAATCTAGGGA,199,209,10,20,11701,1,0
12027,ACGTCGAATCTAGGGA,199,218,19,17,11703,4,0
12028,ACGTCGAATCTAGGGA,199,202,3,20,11705,0,0
12029,ACGTCGAATCTAGGGA,199,205,6,22,11706,0,0
12030,ACGTCGAATCTAGGGA,199,222,23,19,11708,6,0
12031,ACGTCGAATCTAGGGA,199,199,0,16,11709,0,0
12032,ACGTCGAATCTAGGGA,199,201,2,16,11710,0,0
12033,ACGTCGAATCTAGGGA,199,205,6,21,11711,0,0
12034,ACGTCGAATCTAGGGA,199,205,6,16,11712,0,0
12035,ACGTCGAATGTAGGGA,199,206,7,17,11713,0,0
12036,ACGTCGAATCTAGGGA,199,206,7,20,11715,0,0
12037,ACGTCGAATCTAGGGA,199,204,5,19,11716,0,0
12038,ACGTCGAATCTAGGGA,199,204,5,17,11717,0,0
12039,ACGTCGAATCTAGGGA,199,202,3,19,11718,0,0
12040,ACGTCGAATCTAGGGA,200,203,3,19,8294,0,0
12041,ACGTCGAATCTAGGGA,200,211,11,15,9508,2,0
12042,TCGTCGAATTTAGGGA,200,231,31,19,9860,9,0
12043,ACGTGGAATCTAGGGA,200,206,6,18,10051,0,0
12044,ACGTCGAATCTAGGGA,200,200,0,20,10055,0,0
12045,ACGTCGAATCTAGGGA,200,223,23,19,10203,6,0
12046,ACGTCGAATCTAGGGA,200,202,2,16,10411,0,0
12047,ACGTCGAATCTAGGGA,200,202,2,19,10413,0,0
12048,ACGTCGAATCTAGGGA,200,200,0,16,10431,0,0
12049,ACGTCGAATCTAGGGA,200,201,1,18,10560,0,0
12050,ACGTCGAATCTAGGGA,200,201,1,15,10562,0,0
12051,ACGTCGAATCTAGGGA,200,203,3,15,10570,0,0
12052,ACGTCGAATCTAGGGA,200,202,2,20,10943,0,0
12053,ACGTCGAATCTAGGGA,200,202,2,18,11083,0,0
12054,ACGTCGAATCTAGGGA,200,210,10,19,11089,1,0
12055,ACGTCGAATCTAGGGA,200,218,18,18,11093,4,0
12056,ACGTCGAATCTAGGGA,200,201,1,19,11097,0,0
12057,ACGTCGAATCTAGGGA,200,200,0,20,11208,0,0
12058,ACGTCGAATCTAGGGA,200,207,7,16,11211,0,0
12059,ACGTCGAATCTAGGGA,200,209,9,20,11214,1,0
12060,ACGTCGAATCTAGGGA,200,209,9,18,11266,1,0
12061,ACGTCGAATCTAGGGA,200,207,7,15,11267,0,0
12062,ACGTCGAATCTAGGGA,200,200,0,18,11272,0,0
12063,ACTTCGAATCTAGGGA,200,206,6,17,11273,0,0
12064,ACGTCGAATCTAGGGA,200,202,2,19,11386,0,0
12065,ACGTCGAATCTATGGA,200,227,27,19,11387,7,0
12066,ACGTCGAATCTAGGGA,200,200,0,20,11390,0,0
12067,ACGTCGAATCTAGGGA,200,203,3,20,11392,0,0
12068,ACGTCGAATCTAGGGA,200,200,0,15,11393,0,0
12069,ACGTCGAATCTAGGGA,200,203,3,19,11396,0,0
12070,ACGTAGAATCTAGGGA,200,203,3,17,11397,0,0
12071,ACGTCGAATCTAGGGA,200,203,3,20,11407,0,0
12072,ACGTCGATTCTAGGGA,200,203,3,15,11456,0,0
12073,ACGTCGAATCTAGGGA,200,201,1,18,11464,0,0
12074,ACGTCGAATCTAGGGA,200,200,0,19,11466,0,0
12075,ACGTCGAATCTAGGGA,200,203,3,20,11468,0,0
12076,ACGTCGAATCTAGGGA,200,203,3,21,11564,0,0
12077,ACGTCGAATCTAGGGA,200,203,3,21,11565,0,0
12078,ACGTCGAATCTAGGGA,200,203,3,19,11634,0,0
12079,ACGTCGAATCTAGGGA,200,203,3,15,11635,0,0
12080,ACGTCGAATCTAGGGA,200,203,3,15,11637,0,0
12081,ACGTCGAATCTAGGGA,200,203,3,16,11638,0,0
12082,ACGTCGAATCTAGGGA,200,203,3,18,11639,0,0
12083,ACGTCGAATCTAGGGA,200,200,0,19,11640,0,0
12084,ACGTCGAATCTAGGGA,200,203,3,20,11642,0,0
12085,ACGTCGAATCTAGGGA,200,203,3,18,11643,0,0
12086,ACGTCGAATCTAAGGA,200,203,3,19,11645,0,0
12087,ACGTCGAATCTAGGGA,200,203,3,21,11651,0,0
12088,ACGTCGAATCTAGGGA,200,201,1,14,11652,0,0
12089,ACGTCGAATCTAGGGA,200,203,3,21,11654,0,0
12090,ACGTCTAATCTAGGGA,200,203,3,21,11656,0,0
12091,ACGTCGAATCTAGGGA,200,203,3,21,11660,0,0
12092,ACGTCGAATCTAGGGA,200,203,3,19,11661,0,0
12093,ACGTCGAATCTAGGGA,200,201,1,19,11662,0,0
12094,ACGTCGAATCTAGGGA,200,203,3,19,11663,0,0
12095,ACGTCGAATCTAGGGA,200,203,3,16,11664,0,0
12096,ACGTCGAATCTAGGGA,200,203,3,21,11669,0,0
12097,ACGTCGAATCTAGGGA,200,203,3,18,11672,0,0
12098,ACGTCGAATCTAGGGA,200,201,1,22,11673,0,0
12099,ACGTCGAATCTAGGGA,200,203,3,21,11678,0,0
12100,ACGTCGAATCTAGGGA,200,203,3,25,11679,0,0
12101,ACGTAGCCTCTAGGGA,200,203,3,21,11681,0,0
12102,ACGTCGAATCTAGGGA,200,203,3,16,11687,0,0
12103,ACGTCGAATCTATGGA,200,200,0,19,11751,0,0
12104,ACGTCGAATCTAGGGA,200,203,3,15,11752,0,0
12105,ACGTCGAATCTAGGGA,200,202,2,22,11753,0,0
12106,ACGTCGAATCTATGGA,201,213,12,18,9378,2,0
12107,ACGTCGAATCTAGGGA,201,201,0,14,9940,0,0
12108,ACGTCGAATCTAGGGA,201,213,12,18,10284,2,0
12109,ACGTCGAATCTAGGGA,201,212,11,13,10705,2,0
12110,ACGTAGCATCTAGGGA,201,206,5,19,10714,0,0
12111,ACGTCGAATCTAGGGA,201,212,11,20,10725,2,0
12112,ACGTCGAATCTAGGGA,201,209,8,14,10815,1,0
12113,ACGTCGAATCTAGGGA,201,207,6,16,10816,0,0
12114,ACGTCGAATCTAGGGA,201,206,5,22,10820,0,0
12115,ACGTCGAATCTAGGGA,201,210,9,21,10830,1,0
12116,ACGTCGAATCCAGGGA,201,213,12,15,10834,2,0
12117,ACGTCGAATCTAGGGA,201,215,14,20,10839,3,0
12118,ACGTCGAATGTAGGGA,201,210,9,19,10843,1,0
12119,TCGTCGAATCTAGGGA,201,204,3,20,11012,0,0
12120,ACGTCGAATCTAGGGA,201,212,11,17,11027,2,0
12121,ACGTCGAATCTAGGGA,201,206,5,20,11028,0,0
12122,ACGTCGAATCTAGGGA,201,213,12,19,11038,2,0
12123,ACGTCGAATCTAGGGA,201,204,3,21,11040,0,0
12124,ACGTCGAATCTAGGGA,201,206,5,16,11043,0,0
12125,ACGTCTAATCTAGGGA,201,211,10,21,11164,1,0
12126,ACGTCGAATCTAGGGA,201,201,0,16,11167,0,0
12127,ACGTCGAATCTAGGGA,201,208,7,15,11169,0,0
12128,ACGTCGAATCTAGGGA,201,224,23,20,11185,6,0
12129,ACGTCGAATCTAGGGA,201,206,5,20,11186,0,0
12130,ACGTCGAATCTAGGGA,201,201,0,22,11187,0,0
12131,ACGTCGAATCTAGGGA,201,209,8,16,11195,1,0
12132,ACGTCGAATCTAGGGA,201,217,16,20,11339,3,0
12133,TCGTCGAATCTAGGGA,201,205,4,20,11348,0,0
12134,ACGTCGAATCTAGGGA,201,236,35,20,11350,10,0
12135,ACGTCGAATCTAGGGA,201,205,4,22,11361,0,0
12136,ACGTCGAATCTAGGGA,201,205,4,16,11365,0,0
12137,ACGTCGAATCTAGGGA,201,222,21,19,11369,5,0
12138,ACGTCGAATCTAGGGA,201,212,11,16,11372,2,0
12139,ACGTCGAATCTAGGGA,201,205,4,20,11377,0,0
12140,ACGTCGAATCTAGGGA,201,212,11,14,11519,2,0
12141,ACGTCGAATCTAGGGA,201,219,18,16,11520,3,0
12142,ACGTCGAATCTAGGGA,201,208,7,19,11521,0,0
12143,ACGTCGTATCTAGGGA,201,207,6,20,11528,0,0
12144,ACGTCGATTCTAGGGA,201,219,18,16,11537,3,0
12145,ACGTCGAATCTAGGGA,201,206,5,16,11541,0,0
12146,ACGTCGAATCTAGGGA,201,209,8,16,11543,0,0
12147,ACGTCGAATGTAGGGA,201,212,11,17,11544,1,0
12148,ACGTCGAATCTAGGGA,201,210,9,20,11546,0,0
12149,ACGTCGAATCTAGGGA,201,207,6,19,11547,0,0
12150,ACGTCGAATCTAGGGA,201,201,0,17,11548,0,0
12151,ACGTCGAATCTAGGGA,201,213,12,20,11554,1,0
12152,ACGTCGAATCTAGGGA,201,216,15,19,11555,2,0
12153,ACGTCGAATCTAGGGA,201,207,6,20,11557,0,0
12154,ACGTCGAATCTAGGGA,201,207,6,21,11559,0,0
12155,ACGTCGAATCTAGGGA,201,231,30,19,11560,7,0
12156,ACGTAGAATCTAGGGA,201,201,0,21,11561,0,0
12157,ACGTCGCATCTAGGGA,201,203,2,19,11720,0,0
12158,ACGTCGAATCTAGGGA,201,210,9,20,11723,0,0
12159,ACGTCGAATCTAGGGA,201,202,1,19,11724,0,0
12160,ACGTCGAATCTAGGGA,201,210,9,21,11727,0,0
12161,ACGTCGAATCTAGGGA,201,209,8,19,11728,0,0
12162,ACGTCGAATCTAGGGA,201,223,22,21,11731,5,0
12163,ACGTCGATTCTAGGGA,201,204,3,16,11733,0,0
12164,ACGTCGAATCTAGGGA,201,202,1,19,11734,0,0
12165,ACGTCGAATCTAGGGA,201,201,0,21,11740,0,0
12166,ACGTCGAATCTAGGGA,201,204,3,20,11743,0,0
12167,ACGTCGAATCTAGGGA,201,202,1,17,11746,0,0
12168,ACGTCGAATCTAGGGA,201,201,0,21,11750,0,0
12169,ACGTCGAATCTAGGGA,202,230,28,14,9286,7,0
12170,ACGTCGAATCTAGGGA,202,217,15,15,9636,3,0
12171,ACGTCGAATCTAGGGA,202,205,3,14,10068,0,0
12172,ACGTCGAATCTAGGGA,202,205,3,20,10154,0,0
12173,ACGTCGAATCGAGGGA,202,205,3,14,10437,0,0
12174,ACGTCGAATCTAGGGA,202,205,3,13,10530,0,0
12175,ACGTCGAATCTAGGGA,202,205,3,20,10532,0,0
12176,ACGTCTAATCTAGGGA,202,202,0,20,10576,0,0
12177,ACGTCGAATCTAGGGA,202,204,2,20,10594,0,0
12178,ACGTCGAATCTAGGGA,202,205,3,18,10765,0,0
12179,ACGTCGAATCTAGGGA,202,205,3,18,10904,0,0
12180,ACGTCGAATCTAGGGA,202,205,3,21,11071,0,0
12181,ACGTCGAATCTAGGGA,202,205,3,21,11223,0,0
12182,ACGTCGAATCTAGGGA,202,205,3,24,11230,0,0
12183,ACGTCTAATCTAGGGA,202,205,3,20,11246,0,0
12184,ACGTCGAATCTAGGGA,202,205,3,15,11250,0,0
12185,ACGTCGAATCTAGGGA,202,205,3,22,11409,0,0
12186,ACGTCGAATCTAGGGA,202,205,3,22,11412,0,0
12187,ACGTCGAATCTAGGGA,202,205,3,17,11424,0,0
12188,ACGTCGAATGTAGGGA,202,202,0,20,11426,0,0
12189,ACGTCGAATCTAGGGG,202,203,1,21,11428,0,0
12190,ACGTCGAATCTAGGGA,202,205,3,19,11431,0,0
12191,ACGTCGAATCTAGGGA,202,205,3,18,11567,0,0
12192,ACGTCGAATCTAGGGA,202,205,3,20,11569,0,0
12193,ACGTCGAATCTAGGGA,202,205,3,19,11572,0,0
12194,ACGTCGAATCTAGGGA,202,205,3,14,11691,0,0
12195,ACGTCGAATCTAGGGA,202,205,3,24,11697,0,0
12196,ACGTCGAATCGAGGGA,202,205,3,19,11698,0,0
12197,ACGTCGAATCTAGGGA,202,203,1,21,11699,0,0
12198,ACGTCGAATCTAGGGA,202,203,1,20,11705,0,0
12199,ACGTCGAATCTAGGGA,202,205,3,22,11706,0,0
12200,ACGTCGAATCTAGGGA,202,205,3,19,11708,0,0
12201,ACGTCGAATCTAGGGA,202,205,3,16,11709,0,0
12202,ACGTCGAATGTAGGGA,202,205,3,17,11713,0,0
12203,ACGTCGAATCTAGGGA,202,205,3,20,11715,0,0
12204,ACGTCGAATCTAGGGA,202,205,3,19,11716,0,0
12205,ACGTCGAATCTAGGGA,202,202,0,19,11718,0,0
12206,ACGTAGAATCTAGGGA,202,204,2,17,11756,0,0
12207,ACGTCGAATCTAGGGA,202,205,3,20,11869,0,0
12208,ACGTCGAATCTAGGGA,202,205,3,19,11872,0,0
12209,ACGTCGAATCTAGGGA,202,205,3,17,11878,0,0
12210,ACGTCGAATCTAGGGA,203,203,0,15,9508,0,0
12211,TCGTCGAATCTAGGGA,203,207,4,19,9860,0,0
12212,ACGTCGAATCTAGGGA,203,203,0,18,10051,0,0
12213,ACGTCGAATCTAGGGA,203,213,10,19,10203,1,0
12214,ACGTCGAATCTAGGGA,203,208,5,16,10411,0,0
12215,ACGTCGAATCTAGGGA,203,210,7,19,10413,0,0
12216,ACGTCGAATCTAGGGA,203,206,3,18,10560,0,0
12217,ACGTCGAATCTAGGGA,203,216,13,15,10562,2,0
12218,ACGTCGAATCTAGGGA,203,221,18,15,10570,4,0
12219,ACGTCGAATCTCGGGA,203,206,3,20,10943,0,0
12220,ACGTCGAATCTAGGGA,203,211,8,18,11083,1,0
12221,ACGTCGAATCTAGGGA,203,207,4,18,11093,0,0
12222,ACGTCGAATCTAGGGA,203,204,1,16,11211,0,0
12223,ACGTCGAATCTAGGGA,203,205,2,18,11266,0,0
12224,ACGTCGAATCTAGGGA,203,228,25,15,11267,6,0
12225,ACGTCGAATCTAGGGA,203,204,1,18,11272,0,0
12226,ACGTCGAATCTAGGGA,203,212,9,17,11273,1,0
12227,ACGTCGAATCTAGGGA,203,205,2,19,11386,0,0
12228,ACGTCGAATCTATGGA,203,206,3,19,11387,0,0
12229,ACGTCGAATCTAGGGA,203,207,4,20,11390,0,0
12230,ACGTCGAATCTAGGGA,203,214,11,20,11392,2,0
12231,ACGTCGAATCTAGGGA,203,217,14,15,11393,3,0
12232,ACGTCGAATCTAGGGA,203,232,29,19,11396,8,0
12233,ACGTAGAATCTAGGGA,203,207,4,17,11397,0,0
12234,ACGTCGAATCTAGGGA,203,215,12,20,11407,2,0
12235,ACGTCGATTCTAGGGA,203,214,11,15,11456,2,0
12236,ACGTCGAATCTAGGGA,203,205,2,18,11464,0,0
12237,ACGTCGAATCTAGGGA,203,207,4,19,11466,0,0
12238,ACGTCGAATCTAGGGA,203,213,10,20,11468,1,0
12239,ACGTCGAATCTAGGGA,203,227,24,21,11564,6,0
12240,ACGTCGAATCTAGGGA,203,223,20,21,11565,5,0
12241,ACGTCGAATCTAGGGA,203,206,3,19,11634,0,0
12242,ACGTCGAATCTAGGGA,203,205,2,15,11635,0,0
12243,ACGTCGAATCTAGGGA,203,203,0,16,11638,0,0
12244,ACGTCGAATCTAGGGA,203,206,3,18,11639,0,0
12245,ACGTCGAATCTAGGGA,203,203,0,19,11640,0,0
12246,ACGTCGAATCTAGGGA,203,219,16,20,11642,3,0
12247,ACGTCGAATCTAGGGA,203,204,1,18,11643,0,0
12248,ACGTCGAATCTAAGGA,203,216,13,19,11645,2,0
12249,ACGTCGAATCTAGGGA,203,216,13,21,11651,2,0
12250,ACGTCGAATCTAGGGA,203,204,1,14,11652,0,0
12251,ACGTCTAATCTAGGGA,203,211,8,21,11656,1,0
12252,ACGTCGAATCTAGGGA,203,203,0,21,11660,0,0
12253,ACGTCGAATCTAGGGA,203,218,15,19,11661,3,0
12254,ACGTCGAATCTAGGGA,203,231,28,19,11662,7,0
12255,ACGTCGAATCTAGGGA,203,208,5,19,11663,0,0
12256,ACGTCGAATCTAGGGA,203,220,17,16,11664,4,0
12257,ACGTCGAATCTAGCGA,203,208,5,21,11669,0,0
12258,ACGTCGAATCTAGGGA,203,214,11,18,11672,2,0
12259,ACGTCGAATCTAGGGA,203,218,15,22,11673,3,0
12260,ACGTCGAATCTAGGGA,203,206,3,21,11678,0,0
12261,ACGTCGAATCTAGGGA,203,208,5,25,11679,0,0
12262,ACGTCGAATCTATGGA,203,224,21,19,11751,4,0
12263,ACGTCGAATCTAGGGA,203,204,1,15,11752,0,0
12264,ACGTCGAATCTAGGGA,203,218,15,22,11753,2,0
12265,ACGTCGAATCTAGGGA,203,214,11,19,11818,1,0
12266,ACGTCGAATCTAGGGA,203,209,6,15,11819,0,0
12267,ACGTCGAATCTAGGGA,203,203,0,18,11820,0,0
12268,ACGTCGAATCTAGGGA,203,243,40,15,11824,11,0
12269,ACGTCGAATCTAAGGA,203,203,0,19,11827,0,0
12270,ACGTCGAATCTAGGGA,203,204,1,21,11831,0,0
12271,ACGTCGAATCTAGGGA,203,233,30,14,11832,7,0
12272,ACGTCGAATCTAGGGA,203,210,7,21,11836,0,0
12273,ACGTCGAATCTAGGGA,203,209,6,21,11838,0,0
12274,ACGTCGAATCTAGGGA,203,205,2,19,11842,0,0
12275,TCGTCGAATCTATGGA,203,210,7,20,11843,0,0
12276,ACGTCGAATCTAGGGA,203,210,7,21,11847,0,0
12277,ACGTCGAATCTAGGGA,203,221,18,22,11848,3,0
12278,ACGTCGAATCTAGGGA,203,204,1,17,11850,0,0
12279,ACGTCGAATCTAGGGA,203,206,3,18,11852,0,0
12280,ACGTAGCCTCTAGGGA,203,206,3,21,11853,0,0
12281,ACGTCGAATCTAGGGA,203,206,3,22,11855,0,0
12282,ACGTCTAATCTAGGGA,203,206,3,21,11856,0,0
12283,ACGTCGAATCTAGGGA,203,206,3,16,11857,0,0
12284,ACGTCGAATCTAGGGA,203,206,3,23,11858,0,0
12285,ACGTCGAATCTAGGGA,203,206,3,21,11862,0,0
12286,ACGTCGAATCTAGGGA,203,205,2,23,11863,0,0
12287,ACGTCGAATCTAGGGA,203,206,3,18,11864,0,0
12288,ACGTGGAATGTAGGGA,203,206,3,21,11865,0,0
12289,ACGTAGAATCTAGGGA,203,206,3,18,11867,0,0
12290,ACGTCGAATCTAGGGA,203,204,1,20,11868,0,0
12291,ACGTCGAATCTATGGA,204,205,1,18,9378,0,0
12292,ACGTCGAATCTAGGGA,204,217,13,14,9940,2,0
12293,ACGTCGAATCTAGGGA,204,210,6,18,10284,0,0
12294,ACGTCGAATCTAGGGA,204,204,0,13,10705,0,0
12295,ACGTAGCATCTAGGGA,204,241,37,19,10714,10,0
12296,ACGTCGAATCTAGGGA,204,219,15,16,10816,3,0
12297,ACGTCGAATCCAGGGA,204,210,6,15,10834,0,0
12298,ACGTCGAATCTAGGGA,204,212,8,20,10839,1,0
12299,TCGTCGAATCTAGGGA,204,215,11,20,11012,2,0
12300,ACGTCGAATCTAGGGA,204,216,12,17,11027,2,0
12301,ACGTCGAATCTAGGGA,204,206,2,20,11028,0,0
12302,ACGTCGAATCTAGGGA,204,206,2,16,11043,0,0
12303,ACGTCTAATCTAGGGA,204,211,7,21,11164,0,0
12304,ACGTCGAATCTAGGGA,204,215,11,15,11169,2,0
12305,ACGTCGAATCTAGGGA,204,210,6,20,11185,0,0
12306,ACGTCGAATCTAGGGA,204,209,5,22,11187,0,0
12307,ACGTCGAATCTAGGGA,204,223,19,16,11195,4,0
12308,ACGTCGAATCTAGGGA,204,206,2,20,11339,0,0
12309,TCGTCGAATCTAGGGA,204,260,56,20,11348,17,0
12310,ACGTCGAATCTAGGGA,204,213,9,20,11350,1,0
12311,ACGTCGAATCTAGGGA,204,205,1,22,11361,0,0
12312,ACGTCGAATCTAGGGA,204,205,1,16,11365,0,0
12313,ACGTCGAATCTAGGGA,204,207,3,19,11369,0,0
12314,ACGTCGAATCTAGGGA,204,207,3,16,11372,0,0
12315,ACGTCGAATCTAGGGA,204,207,3,20,11377,0,0
12316,ACGTCGAATCTAGGGA,204,207,3,14,11519,0,0
12317,ACGTCGAATCTAGGGA,204,207,3,16,11520,0,0
12318,ACGTCGAATCTAGGGA,204,207,3,19,11521,0,0
12319,ACGTCGAATCTAGGGA,204,207,3,16,11543,0,0
12320,ACGTCGAATGTAGGGA,204,207,3,17,11544,0,0
12321,ACGTCGAATCTAGGGA,204,206,2,20,11546,0,0
12322,ACGTCGAATCTAGGGA,204,205,1,19,11547,0,0
12323,ACGTCGAATCTAGGGA,204,205,1,17,11548,0,0
12324,ACGTCGAATCTAGGGA,204,207,3,20,11557,0,0
12325,ACGTCGAATCTAGGGA,204,204,0,21,11559,0,0
12326,ACGTCGAATCTAGGGA,204,207,3,19,11560,0,0
12327,ACGTCGAATCTAGGGA,204,207,3,19,11720,0,0
12328,ACGTCGAATCTAGGGA,204,207,3,19,11724,0,0
12329,ACGTCGAATCTAGGGA,204,207,3,21,11727,0,0
12330,ACGTCGAATCTAGGGA,204,207,3,19,11728,0,0
12331,ACGTCGAATCTAGGGA,204,207,3,21,11731,0,0
12332,ACGTCGATTCTAGGGA,204,207,3,16,11733,0,0
12333,ACGTCGAATCTAGGGA,204,205,1,21,11740,0,0
12334,ACGTCGAATCTAGGGA,204,207,3,20,11743,0,0
12335,ACGTCGAATCTAGGGA,204,204,0,21,11750,0,0
12336,ACGTCGAATCTAGGGA,204,207,3,22,11881,0,0
12337,ACGTCGAATCTAGGGA,204,207,3,17,11882,0,0
12338,ACGTCGAATCTAGGGA,204,207,3,19,11883,0,0
12339,ACGTCGAATCTAGGGA,204,207,3,16,11885,0,0
12340,ACGTCGAATCTAGGGA,204,204,0,17,11892,0,0
12341,ACGTCGAATCTAGGGA,204,207,3,20,11893,0,0
12342,ACGTCGAATCTAGGGA,204,207,3,19,11897,0,0
12343,ACGTCGAATCTAGGGA,204,207,3,20,11901,0,0
12344,ACGTCGAATCTATGGA,204,207,3,20,11902,0,0
12345,ACGTCGAATCTAGGGA,204,205,1,21,11904,0,0
12346,ACGTCGAATCTAGGGA,204,207,3,16,11905,0,0
12347,ACGTCGAATCTAGGGA,204,207,3,20,11906,0,0
12348,ACGTAGAATCTAGGGA,204,207,3,18,11907,0,0
12349,ACGTCGAATCTAGGGA,204,207,3,17,11909,0,0
12350,ACGTCGAATCTAGGGA,205,210,5,14,9286,0,0
12351,ACGTCGAATCTAGGGA,205,209,4,20,10154,0,0
12352,ACGTCGAATCGAGGGA,205,207,2,14,10437,0,0
12353,ACGTCTAATCTAGGGA,205,206,1,20,10576,0,0
12354,ACGTCGAATCTAGGGA,205,210,5,20,10594,0,0
12355,ACGTCGAATCTAGGGA,205,209,4,21,11071,0,0
12356,ACGTCGAATCTAGGGA,205,217,12,21,11223,2,0
12357,ACGTCGAATCTAGGGA,205,208,3,24,11230,0,0
12358,ACGTCGAATCTAGGGA,205,217,12,22,11409,2,0
12359,ACGTCGAATCTAGGGA,205,205,0,22,11412,0,0
12360,ACGTCGAATCTAGGGA,205,206,1,17,11424,0,0
12361,ACGTCGAATGTAGGGA,205,210,5,20,11426,0,0
12362,ACGTTGAATCTAGGGA,205,238,33,21,11428,9,0
12363,ACGTCGAATCTAGGGA,205,205,0,19,11431,0,0
12364,ACGTCGAATCTAGGGA,205,211,6,20,11569,0,0
12365,ACGTCGAATCTAGGGA,205,231,26,19,11572,7,0
12366,ACGTCGAATCTAGGGA,205,205,0,21,11699,0,0
12367,ACGTCGAATCTAGGGA,205,213,8,20,11705,1,0
12368,ACGTCGAATCTAGGGA,205,216,11,22,11706,2,0
12369,ACGTCGAATCTAGGGA,205,205,0,19,11708,0,0
12370,ACGTCGAATCTAGGGA,205,205,0,16,11709,0,0
12371,ACGTCGAATGTAGGGA,205,209,4,17,11713,0,0
12372,ACGTCGAATCTAGGGA,205,205,0,19,11716,0,0
12373,ACGTCGAATCTAGGGA,205,250,45,19,11718,13,0
12374,ACGTAGAATCTAGGGA,205,208,3,17,11756,0,0
12375,ACGTCGAATCTAGGGA,205,209,4,20,11869,0,0
12376,ACGTCGAATCTAGGGA,205,205,0,19,11872,0,0
12377,ACGTCGAATCTAGGGA,205,211,6,17,11878,0,0
12378,ACGTCGAATCTAGGGA,205,210,5,22,11919,0,0
12379,ACGTAGAATCTAGGGA,205,206,1,17,11921,0,0
12380,ACGTCGAATCTAGGGA,205,208,3,14,11922,0,0
12381,ACGTAGCATCTAGGGA,205,222,17,20,11923,4,0
12382,ACGTCGAATCTAGGGA,205,213,8,21,11924,1,0
12383,ACGTCGAATCTAGGGA,205,207,2,15,11925,0,0
12384,ACGTCGAATCTAGGGA,205,213,8,17,11926,1,0
12385,TCGTCGAATCTAGGGA,205,223,18,21,11934,4,0
12386,ACGTCGAATCTAGGGA,205,211,6,22,11935,0,0
12387,ACGTCGAATCTAGGGA,205,205,0,18,11936,0,0
12388,ACGTCGAATCTAGGGA,205,212,7,16,12041,0,0
12389,TCGTCGAATTTAGGGA,205,210,5,20,12042,0,0
12390,ACGTCGAATCTAGGGA,206,208,2,15,9508,0,0
12391,TCGTCGAATCTAGGGA,206,206,0,19,9860,0,0
12392,ACGTCGAATCTAGGGA,206,227,21,18,10051,6,0
12393,ACGTCGAATCTAGGGA,206,213,7,19,10203,1,0
12394,ACGTCGAATCTAGGGA,206,207,1,15,10562,0,0
12395,ACGTCGAATCTAGGGA,206,207,1,15,10570,0,0
12396,ACGTCGAATCTAGGGA,206,228,22,18,11083,6,0
12397,ACGTCGAATCTAGGGA,206,224,18,18,11093,5,0
12398,ACGTCGAATCTAGGGA,206,210,4,18,11266,0,0
12399,ACGTCGAATCTAGGGA,206,213,7,15,11267,0,0
12400,ACGTCGAATCTAGGGA,206,206,0,18,11272,0,0
12401,ACGTCGAATCTAGGGA,206,207,1,17,11273,0,0
12402,ACGTCGAATCTATGGA,206,211,5,19,11387,0,0
12403,ATGTCGAATCTAGGGA,206,212,6,20,11390,0,0
12404,ACGTCGAATCTAGGGA,206,220,14,20,11392,3,0
12405,ACGTCGAATCTAGGGA,206,209,3,15,11393,0,0
12406,ACGTCGAATCTAGGGA,206,216,10,19,11396,1,0
12407,ACGTAGAATCTAGGGA,206,207,1,17,11397,0,0
12408,ACGTCGAATCTAGGGA,206,210,4,20,11407,0,0
12409,ACGTCGAATCTAGGGA,206,209,3,18,11464,0,0
12410,ACGTCGAATCTAGGGA,206,219,13,19,11466,2,0
12411,ACGTCGAATCTAGGGA,206,207,1,20,11468,0,0
12412,ACGTCGAATCTAGGGA,206,209,3,21,11565,0,0
12413,ACGTCGAATCTAGGGA,206,213,7,19,11634,0,0
12414,ACGTCGAATCTAGGGA,206,216,10,15,11635,1,0
12415,ACGTCGAATCTAGGGA,206,247,41,16,11638,12,0
12416,ACGTCGAATCTAGGGA,206,209,3,19,11640,0,0
12417,ACGTCGCATCTAGGGA,206,206,0,20,11642,0,0
12418,ACGTCGAATCTAGGGA,206,209,3,18,11643,0,0
12419,ACGTCGAATCTAAGGA,206,206,0,19,11645,0,0
12420,ACGTCGAATCTAGGGA,206,209,3,14,11652,0,0
12421,ACGTCTAATCTAGGGA,206,208,2,21,11656,0,0
12422,ACGTCGAATCTAGGGA,206,207,1,21,11660,0,0
12423,ACGTCGAATCTAGGGA,206,209,3,19,11661,0,0
12424,ACGTCGAATCTAGGGA,206,209,3,19,11662,0,0
12425,ACGTCGAATCTAGGGA,206,209,3,19,11663,0,0
12426,ACGTCGAATCTAGGGA,206,208,2,16,11664,0,0
12427,ACGTCGAATCTAGGGA,206,209,3,21,11669,0,0
12428,ACGTCGAATCTAGGGA,206,209,3,18,11672,0,0
12429,ACGTCGAATCTAGGGA,206,207,1,22,11673,0,0
12430,ACGTCGAATCTATGGA,206,209,3,19,11751,0,0
12431,ACGTCGAATCTAGGGA,206,208,2,19,11818,0,0
12432,ACGTCGAATCTAGGGA,206,209,3,15,11819,0,0
12433,ACTTCGAATCTAGGGA,206,209,3,18,11820,0,0
12434,ACGTCGAATCTAAGGA,206,209,3,19,11827,0,0
12435,ACGTCGAATCTAGGGA,206,209,3,21,11831,0,0
12436,ACGTCGAATCTAGGGA,206,207,1,14,11832,0,0
12437,ACGTCGAATCTAGGGA,206,209,3,21,11836,0,0
12438,ACGTCGAATCTAGGGA,206,209,3,21,11838,0,0
12439,TCGTCGAATCTATGGA,206,206,0,20,11843,0,0
12440,ACGTCGAATCTAGGGA,206,209,3,21,11847,0,0
12441,ACGTCGAATCTAGGGA,206,206,0,22,11848,0,0
12442,ACGTCGAATCTAGGGA,206,209,3,17,11850,0,0
12443,ACGAAGCCTCTAGGGA,206,209,3,21,11853,0,0
12444,ACGTCTAATCTAGGGA,206,209,3,21,11856,0,0
12445,ACGTCGAATCTAGGGA,206,209,3,21,11862,0,0
12446,ACGTCGAATCTAGGGA,206,209,3,23,11863,0,0
12447,ACGTCGAATCTAGGGA,206,209,3,18,11864,0,0
12448,ACGTCGAATGTAGGGA,206,208,2,21,11865,0,0
12449,ACGTAGAATCTAGGGA,206,207,1,18,11867,0,0
12450,ACGTCGAATCTAGGGA,206,206,0,20,11868,0,0
12451,ACGTCGAATCTAGGGA,206,206,0,21,11937,0,0
12452,ACGTCGAATCTAGGGA,206,207,1,19,11987,0,0
12453,ACGTCGAATCTAGGGA,206,209,3,15,11990,0,0
12454,ACGTCGAATCTAGGGA,206,209,3,21,11992,0,0
12455,ACGTCGAATCTAGGGA,206,209,3,19,11993,0,0
12456,ACGTCGAATCGAGGGA,206,206,0,15,11994,0,0
12457,ACGTCGAATCTAGGGA,206,209,3,14,11995,0,0
12458,ACGTCTAATCTAGGGA,206,206,0,21,11997,0,0
12459,ACGTCGAATCTAGGGA,206,206,0,19,12000,0,0
12460,ACGTCGAATCTAGGGA,206,206,0,18,12002,0,0
12461,ACGTCGAATCTAGGGA,206,209,3,22,12004,0,0
12462,ACGTCGAATCTAGGGA,206,206,0,25,12005,0,0
12463,ACGTCGAATCTAGGGC,206,209,3,16,12007,0,0
12464,ACGTCGAATCTAGGGA,206,209,3,23,12008,0,0
12465,ACGTCGAATCTAGGGA,206,209,3,16,12010,0,0
12466,ACGTAGAATCTAGGGA,206,209,3,18,12015,0,0
12467,ACGTCGAATCTAGGGA,206,208,2,20,12016,0,0
12468,ACGTCGAATCTAGGGA,206,209,3,21,12018,0,0
12469,ACGTCGAATCTAGGGA,206,207,1,20,12019,0,0
12470,ACGTTGAATCTAGGGA,206,208,2,17,12021,0,0
12471,ACGTCGAATCTAGGGA,206,209,3,25,12022,0,0
12472,ACGTCGAATCGAGGGA,206,209,3,20,12023,0,0
12473,ACGTCGAATCTAGGGA,206,209,3,21,12026,0,0
12474,ACGTCGAATCTAGGGA,206,209,3,18,12027,0,0
12475,ACGTCGAATCTAGGGA,206,209,3,20,12030,0,0
12476,ACGTCGAATCTATGGA,207,221,14,18,9378,3,0
12477,ACGTCGAATCTAGGGA,207,235,28,13,10705,7,0
12478,ACGTAGCATCTAGGGA,207,212,5,19,10714,0,0
12479,ACGTCGAATCCAGGGA,207,212,5,15,10834,0,0
12480,TCGTCGAATCTAGGGA,207,207,0,20,11012,0,0
12481,ACGTCGAATCTAGGGA,207,211,4,20,11028,0,0
12482,ACGTCGAATCTAGGGA,207,216,9,16,11043,1,0
12483,ACGTCTAATCTAGGGA,207,214,7,21,11164,0,0
12484,ACGTCGAATCTAGGGA,207,209,2,15,11169,0,0
12485,ACGTCGAATCTAGGGA,207,209,2,22,11187,0,0
12486,ACGTCGAATCTAGGGA,207,207,0,16,11195,0,0
12487,ACGTCGAATCTAGGGA,207,215,8,20,11339,1,0
12488,ACGTCGAATCTAGGGA,207,213,6,20,11350,0,0
12489,ACGTCGAATCTAGGGA,207,218,11,16,11365,2,0
12490,ACGTCGAATCTAGGGA,207,236,29,19,11369,8,0
12491,ACGTCGAATCTAGGGA,207,207,0,20,11377,0,0
12492,ACGTCGAATCTAGGGA,207,212,5,16,11520,0,0
12493,ACGTCGAATCTAGGGA,207,229,22,16,11543,5,0
12494,ACGTCGAATGTAGGGA,207,210,3,17,11544,0,0
12495,ACGTCGAATCTAGGGA,207,207,0,20,11546,0,0
12496,ACGTCGAATCTAGGGA,207,211,4,19,11547,0,0
12497,ACGTCGAATCTAGGGA,207,211,4,17,11548,0,0
12498,ACGTCGAATCTAGGGA,207,208,1,20,11557,0,0
12499,ACGTCGAATCTAGGGA,207,209,2,21,11559,0,0
12500,ACGTCGAATCTAGGGA,207,217,10,19,11560,1,0
12501,ACGTCGAATCTAGGGA,207,209,2,19,11720,0,0
12502,ACGTCGAATCTAGGGA,207,212,5,21,11727,0,0
12503,ACGTCGAATCTAGGGA,207,220,13,21,11731,2,0
12504,ACGTCGATTCTAGGGA,207,221,14,16,11733,3,0
12505,ACGTCGAATCTAGGGA,207,225,18,21,11740,4,0
12506,ACGTCGAATCTAGGGA,207,212,5,20,11743,0,0
12507,ACGTCGAATCTAGGGA,207,222,15,21,11750,3,0
12508,ACGTCGAATCTAGGGA,207,209,2,22,11881,0,0
12509,ACGTCGAATCTAGGGA,207,211,4,19,11883,0,0
12510,ACGTCGAATCTAGGGA,207,207,0,16,11885,0,0
12511,ACGTCGAATCTAGGGA,207,256,49,17,11892,14,0
12512,ACGTCGAATCTAGGGA,207,237,30,20,11893,8,0
12513,ACGTCGAATCTAGGGA,207,208,1,17,11909,0,0
12514,ACGTCGAATCTAGGGA,207,207,0,20,12045,0,0
12515,ACGTCGAATCTAGGGA,207,210,3,20,12054,0,0
12516,ACGTCGAATCTAGGGA,207,211,4,19,12055,0,0
12517,ACGTCGAATCTAGGGA,207,208,1,21,12059,0,0
12518,ACGTCGAATCTAGGGA,207,209,2,19,12060,0,0
12519,ACGTCGAATCTAGGGA,208,214,6,14,9286,1,0
12520,ACGTCGAATCGAGGGA,208,216,8,14,10437,1,0
12521,ACGTCTAATCTAGGGA,208,213,5,20,10576,0,0
12522,ACGTCGAATCTAGGGA,208,214,6,20,10594,1,0
12523,ACGTCGAATCTAGGGA,208,214,6,21,11071,1,0
12524,ACGTCGAATCTAGGGA,208,212,4,21,11223,0,0
12525,ACGTCGAATCTAGGGA,208,234,26,24,11230,7,0
12526,ACGTCGAATCTAGGGA,208,210,2,22,11409,0,0
12527,ACGTCGAATCTAGGGA,208,234,26,21,11428,7,0
12528,ACGTCGAATCTAGGGA,208,212,4,19,11431,0,0
12529,ACGTCGAATCTAGGGA,208,211,3,20,11569,0,0
12530,ACGTCGAATCTAGGGA,208,233,25,19,11572,7,0
12531,ACGTCGAATCTAGGGA,208,208,0,21,11699,0,0
12532,ACGTCGAATCTAGGGA,208,223,15,20,11705,4,0
12533,ACGTCGAATCTAGGGA,208,210,2,22,11706,0,0
12534,ACGTCGAATGTAGGGA,208,225,17,17,11713,4,0
12535,ACGTCGAATCTAGGGA,208,213,5,19,11718,0,0
12536,ACGTAGAATCTAGGGA,208,210,2,17,11756,0,0
12537,ACGTCGAATCTAGGGA,208,212,4,19,11872,0,0
12538,ACGTCGAATCTAGGGA,208,253,45,17,11878,14,0
12539,ACGTCGAATCTAGGGA,208,218,10,22,11919,2,0
12540,ACGTAGAATCTAGGGA,208,210,2,17,11921,0,0
12541,ACGTCGAATCTAGGGA,208,265,57,14,11922,18,0
12542,ACGTAGCATCTAGGGA,208,210,2,20,11923,0,0
12543,ACGTCGAATCTAGGGA,208,217,9,15,11925,2,0
12544,ACGTCGAATCTAGGGA,208,211,3,17,11926,0,0
12545,ACGTCGAATCTAGGGA,208,222,14,18,11936,3,0
12546,ACGTCGAATCTAGGGA,208,219,11,16,12041,2,0
12547,TCGTCGAATTTAGGGA,208,239,31,20,12042,9,0
12548,ACGTCGAATCTATGGA,208,225,17,20,12065,4,0
12549,ACGTCGAATCTATGGA,208,211,3,19,12106,0,0
12550,ACGTCGAATCTAGGGA,208,230,22,19,12108,5,0
12551,ACGTCGAATCTAGGGA,208,215,7,14,12109,0,0
12552,ACGTCGAATCTAGGGA,208,213,5,21,12111,0,0
12553,ACGTCGAATCTAGGGA,208,211,3,15,12112,0,0
12554,ACGTCGAATCTAGGGA,208,211,3,22,12115,0,0
12555,ACGTCGAATCCAGGGA,208,208,0,16,12116,0,0
12556,ACGTCGAATCTAGGGA,208,211,3,21,12117,0,0
12557,ACGTCGAATGTAGGGA,208,211,3,20,12118,0,0
12558,ACGTCGAATCTAGGGA,208,211,3,18,12120,0,0
12559,ACGTCGAATCTAGGGA,208,209,1,20,12122,0,0
12560,ACGTCTAATCTAGGGA,208,210,2,22,12125,0,0
12561,ACGTCGAATCTAGGGA,208,211,3,21,12128,0,0
12562,ACGTCTAATCTAGGGA,208,211,3,17,12131,0,0
12563,ACGTCGAATCTAGGGA,208,211,3,21,12132,0,0
12564,ACGTCGAATCTAGGGA,208,211,3,21,12134,0,0
12565,ACGTCGAATCTAGGGA,208,211,3,20,12137,0,0
12566,ACGTCGAATCTAGGGA,208,211,3,17,12138,0,0
12567,ACGTCGAATCTAGGGA,208,211,3,15,12140,0,0
12568,TCGTCGAATCTAGGGA,209,227,18,19,9860,4,0
12569,ACGTCGAATCTAGGGA,209,222,13,18,10051,2,0
12570,ACGTCGAATCTAGGGA,209,209,0,15,10562,0,0
12571,ACGTCGAATCTAGGGA,209,209,0,15,10570,0,0
12572,ACGTCGAATCTAGGGA,209,210,1,18,11083,0,0
12573,ACGTCGAATCTAGGGA,209,210,1,18,11093,0,0
12574,ACGTCGAATCTAGGGA,209,217,8,18,11266,1,0
12575,ACGTCGAATCTAGGGA,209,225,16,18,11272,3,0
12576,ACGTCGAATCTAGGGA,209,219,10,17,11273,1,0
12577,ACGTCGAATCTAGGGA,209,213,4,20,11390,0,0
12578,ACGTCGAATCTAGGGA,209,213,4,15,11393,0,0
12579,ACGTCGAATCTAGGGA,209,214,5,19,11396,0,0
12580,ACGTAGAATCTAGGGA,209,209,0,17,11397,0,0
12581,ACGTCGAATCTAGGGA,209,211,2,20,11407,0,0
12582,ACGTCGAACCTAGGGA,209,213,4,19,11466,0,0
12583,ACGTCGAATCTAGGGA,209,215,6,20,11468,0,0
12584,ACGTCGAATCTAGGGA,209,209,0,21,11565,0,0
12585,ACGTCGAATCTAGAGA,209,210,1,15,11635,0,0
12586,ACGTCGAATCTAGGGA,209,226,17,16,11638,4,0
12587,ACGTCGAATCTAGGGA,209,213,4,19,11640,0,0
12588,ACGTCGAATCTAGGGA,209,214,5,20,11642,0,0
12589,ACGTCGAATCTAAGGA,209,217,8,19,11645,1,0
12590,ACGTCGAATCTAGGGA,209,210,1,14,11652,0,0
12591,ACGTCGAATCTAGGGA,209,242,33,19,11661,9,0
12592,ACGTCGAATCTAGGGA,209,212,3,19,11662,0,0
12593,ACGTCGAATCTAGGGA,209,228,19,19,11663,4,0
12594,ACGTCGAATCTAGGGA,209,215,6,16,11664,0,0
12595,ACGTCGAATCTAGGGA,209,211,2,21,11669,0,0
12596,ACGTCGAATCTAGGGA,209,210,1,18,11672,0,0
12597,ACGTCGAATCTAGGGA,209,220,11,22,11673,2,0
12598,ACGTCGAATCTATGGA,209,220,11,19,11751,2,0
12599,ACGTCGAATCTAGGGA,209,210,1,19,11818,0,0
12600,ACGTCGAATCTAGGGA,209,214,5,15,11819,0,0
12601,ACGTCGAATCTAAGGA,209,215,6,19,11827,0,0
12602,ACGTCGAATCTAGGGA,209,210,1,14,11832,0,0
12603,ACGTCGAATCTAGGGA,209,214,5,21,11836,0,0
12604,ACGTCGAATCTAGGGA,209,210,1,21,11838,0,0
12605,TCGTCGAATCTATGGA,209,209,0,20,11843,0,0
12606,ACGTCGAATCTAGGGA,209,214,5,21,11847,0,0
12607,ACGTCGAATCTAGGGA,209,212,3,22,11848,0,0
12608,ACGTCGAATCTAGGGA,209,212,3,17,11850,0,0
12609,ACGTCTAATCTAGGGA,209,210,1,21,11856,0,0
12610,ACGTCGAATCTAGGGA,209,218,9,18,11864,1,0
12611,ACGTCGAATGTAGGGA,209,210,1,21,11865,0,0
12612,ACGTCGAATCTAGGGA,209,210,1,20,11868,0,0
12613,ACGTCGAATCTAGGGA,209,212,3,19,11987,0,0
12614,ACGTCGAATCTAGGGA,209,211,2,15,11990,0,0
12615,ACGTCGAATCTAGGGA,209,210,1,21,11992,0,0
12616,ACGTCGAATCTAGGGA,209,225,16,19,11993,3,0
12617,ACGTCGAATCGAGGGA,209,213,4,15,11994,0,0
12618,ACGTCGAATCTAGGGA,209,209,0,14,11995,0,0
12619,ACGTCGAATCTAGGGA,209,209,0,19,12000,0,0
12620,ACGTCGAATCTAGGGA,209,214,5,18,12002,0,0
12621,ACGTCGAATCTAGGGA,209,212,3,22,12004,0,0
12622,ACGTCGAATCTAGGGA,209,224,15,25,12005,3,0
12623,ACGTCGAATCTAGGGA,209,256,47,16,12007,14,0
12624,ACGTCGAATCTAGGGA,209,224,15,23,12008,3,0
12625,ACGTAGAATCTAGGGA,209,209,0,18,12015,0,0
12626,ACGTCGAATCTAGGGA,209,233,24,21,12018,6,0
12627,ACGTCGAATCTAGGGA,209,216,7,20,12019,0,0
12628,ACGTCGAATCTAGGGA,209,209,0,17,12021,0,0
12629,ACGTCGAATCTAGGGA,209,212,3,25,12022,0,0
12630,ACGTCGAATCGAGGGA,209,212,3,20,12023,0,0
12631,ACGTCGAATCTAGGGA,209,211,2,18,12027,0,0
12632,ACGTCGAATCTAGGGA,209,212,3,20,12030,0,0
12633,ACGTCGAATCTAGGGA,209,212,3,15,12169,0,0
12634,ACGTCGAATCTAGGGA,210,223,13,13,10705,2,0
12635,ACGTCGAATCCAGGGA,210,221,11,15,10834,2,0
12636,TCGTCGCATCTAGGGA,210,218,8,20,11012,1,0
12637,ACGTCGAATCTAGGGA,210,219,9,20,11028,1,0
12638,ACGTCGAATCTAGGGA,210,211,1,16,11043,0,0
12639,ACGTCTAATCTAGGGA,210,211,1,21,11164,0,0
12640,ACGTCGAATCTAGGGA,210,213,3,15,11169,0,0
12641,ACGTCGAATCTAGGGA,210,211,1,22,11187,0,0
12642,ACGTCGAATCTAGGGA,210,213,3,20,11339,0,0
12643,ACGTCGAATCTAGGGA,210,218,8,20,11350,1,0
12644,ACGTCGAATCTAGGGA,210,216,6,19,11369,0,0
12645,ACGTCGAATCTAGGGA,210,246,36,20,11377,10,0
12646,ACGTCGAATCTAGGGA,210,219,9,16,11520,1,0
12647,ACGTCGAATCTAGGGA,210,223,13,16,11543,2,0
12648,ACGTCGAATGTAGGGA,210,212,2,17,11544,0,0
12649,ACGTCGAATCTAGGGA,210,229,19,19,11547,4,0
12650,ACGTCGAATCTAGGGA,210,216,6,17,11548,0,0
12651,ACGTCGAATCTAGGGA,210,210,0,20,11557,0,0
12652,ACGTCGAATCTAGGGA,210,212,2,21,11559,0,0
12653,ACGTCGAATCTAGGGA,210,211,1,19,11560,0,0
12654,ACGTCGAATCTAGGGA,210,217,7,19,11720,0,0
12655,ACGTCGAATCTAGGGA,210,210,0,21,11727,0,0
12656,ACGTCGAATCTAGGGA,210,237,27,21,11731,7,0
12657,ACGTCGATTCTAGGGA,210,217,7,16,11733,0,0
12658,ACGTCGAATCTAGGGA,210,210,0,21,11740,0,0
12659,ACGTCGAATCTAGGGA,210,215,5,20,11743,0,0
12660,ACGTCGAATCTAGGGA,210,216,6,21,11750,0,0
12661,ACGTCGAATCTAGGGA,210,210,0,22,11881,0,0
12662,ACGTCGAATCTAGGGA,210,243,33,17,11892,9,0
12663,ACGTCGAATCTAGGGA,210,214,4,20,11893,0,0
12664,ACGTCGAATCTAGGGA,210,217,7,20,12045,0,0
12665,ACGTCGAATCTAGGGA,210,261,51,19,12055,15,0
12666,ACGTCGAATCTAGGGA,210,213,3,17,12141,0,0
12667,ACGTCGATTCTAGGGA,210,213,3,17,12144,0,0
12668,ACGTCGAATGTAGGGA,210,213,3,18,12147,0,0
12669,ACGTCGAATCTAGGGA,210,210,0,21,12151,0,0
12670,ACGTCGAATCTAGGGA,210,213,3,20,12152,0,0
12671,ACGTCGAATCTAGGGA,210,213,3,20,12155,0,0
12672,ACGTCGAATCTAGGGA,210,213,3,22,12162,0,0
12673,ACGTCGAATCTAGGGA,210,213,3,16,12170,0,0
12674,ACGTCGAATCTAGGGA,210,213,3,20,12213,0,0
12675,ACGTCGAATCTAGGGA,210,213,3,16,12217,0,0
12676,ACGTCGAATCTAGGGA,210,213,3,16,12218,0,0
12677,ACGTCGAATCTAGGGA,210,213,3,19,12220,0,0
12678,ACGTCGAATCTAGGGA,210,212,2,16,12224,0,0
12679,ACGTCGAATCTAGGGA,210,212,2,18,12226,0,0
12680,ACGTCGAATCTAGGGA,210,213,3,21,12230,0,0
12681,ACGTCGAATCTAGGGA,210,213,3,16,12231,0,0
12682,ACGTCGAATCTAGGGA,210,210,0,20,12232,0,0
12683,ACGTCGAATCTAGGGA,210,213,3,21,12234,0,0
12684,ACGTCGATTCTAGGGA,210,211,1,16,12235,0,0
12685,ACGTCGAATCTAGGGA,210,211,1,21,12238,0,0
12686,ACGTCGAATCTAGGGA,210,213,3,22,12239,0,0
12687,ACGTCGAATCTAGGGA,210,213,3,22,12240,0,0
12688,ACGTCGAATCTAGGGA,210,213,3,21,12246,0,0
12689,ACGTCGAATCTAAGGA,210,213,3,20,12248,0,0
12690,ACGTCGAATCTAGGGA,210,213,3,22,12249,0,0
12691,ACGTCTAATCTAGGGA,210,213,3,22,12251,0,0
12692,ACGTCGAATCTAGGGA,210,211,1,20,12253,0,0
12693,ACGTCGAATCTAGGGA,210,213,3,20,12254,0,0
12694,ACGTCGAATCTAGGGA,210,213,3,17,12256,0,0
12695,ACGTCGAATCTAGGGA,210,212,2,19,12258,0,0
12696,ACGTCGAATCTAGGGA,210,213,3,23,12259,0,0
12697,ACGTCGAATCTAGGGA,211,216,5,14,9286,0,0
12698,ACGTCGAATCGAGGGA,211,213,2,14,10437,0,0
12699,ACGTCTAATCTAGGGA,211,217,6,20,10576,0,0
12700,ACGTCGAATCTAGGGA,211,212,1,20,10594,0,0
12701,ACGTCGAATCTAGGGA,211,228,17,21,11071,4,0
12702,ACGTCGAATCTAGGGA,211,214,3,24,11230,0,0
12703,ACGTCGAATCTAGGGA,211,216,5,21,11428,0,0
12704,ACGTCGAATCTAGGGA,211,214,3,19,11431,0,0
12705,ACGTCGAATCTAGGGA,211,215,4,20,11569,0,0
12706,ACGTCGAATCTAGGGA,211,242,31,20,11705,8,0
12707,ACGTCGAATGTAGGGA,211,214,3,17,11713,0,0
12708,ACGTAGAATCTAGGGA,211,226,15,17,11756,3,0
12709,ACGTCGAATCTAGGGA,211,224,13,17,11878,2,0
12710,ACGTCGAATCTAGGGA,211,213,2,22,11919,0,0
12711,ACGTAGAATCTAGGGA,211,216,5,17,11921,0,0
12712,ACGTCGAATCTAGGGA,211,219,8,14,11922,1,0
12713,ACGTAGCATCTAGGGA,211,213,2,20,11923,0,0
12714,ACGTCGAATCTAGGGA,211,213,2,15,11925,0,0
12715,ACGTCGAATCTAGGGA,211,227,16,18,11936,3,0
12716,TCGTCGAATATAGGGA,211,218,7,20,12042,0,0
12717,ACGTCGAATCTATGGA,211,212,1,20,12065,0,0
12718,ACGTCGAATCTATGGA,211,214,3,19,12106,0,0
12719,ACGTCGAATCTAGGGA,211,215,4,19,12108,0,0
12720,ACGTCGAATCTAGGGA,211,225,14,14,12109,3,0
12721,ACGTCGAATCTAGGGA,211,211,0,21,12111,0,0
12722,ACGTCGAATCCAGGGA,211,211,0,16,12116,0,0
12723,ACGTCGAATCTAGGGA,211,221,10,21,12117,1,0
12724,ACGTCGAATCTAGGGA,211,213,2,18,12120,0,0
12725,ACGTCGAATCTAGGGA,211,211,0,20,12122,0,0
12726,ACGTCGAATCTAGGGA,211,214,3,21,12128,0,0
12727,ACGTCGAATCTAGGGA,211,211,0,21,12132,0,0
12728,ACGTCGAATCTAGGGA,211,219,8,21,12134,1,0
12729,ACGTCGAATCTAGGGA,211,234,23,20,12137,6,0
12730,ACGTCGAATCTAGGGA,211,225,14,17,12138,3,0
12731,ACGTCGAATCTAGGGA,211,247,36,15,12140,10,0
12732,ACGTCGAATCTAGGGA,211,229,18,15,12292,4,0
12733,ACGTAGCATCTAGGGA,211,218,7,20,12295,0,0
12734,ACGTCGAATCTAGGGA,211,211,0,17,12296,0,0
12735,ACGTCGAATCTAGGGA,211,216,5,21,12298,0,0
12736,TCGTCGAATCTAGGGA,211,224,13,21,12299,2,0
12737,ACGTCGAATCTAGGGA,211,230,19,18,12300,4,0
12738,ACGTCGAATCTAGGGA,211,212,1,16,12304,0,0
12739,ACGTCGAATCTAGGGA,211,233,22,17,12307,5,0
12740,TCGTCGAATCTAGGGA,211,220,9,21,12309,1,0
12741,ACGTCGAATCTAGGGA,211,220,9,21,12310,1,0
12742,ACGTCGAATCTAGGGA,211,211,0,19,12392,0,0
12743,ACGTCGAATCTAGGGA,211,215,4,20,12393,0,0
12744,ACGTCGAATCTAGGGA,211,217,6,19,12396,0,0
12745,ACGTCGAATCTAGGGA,211,242,31,19,12397,8,0
12746,TCGTCGAATCTAGGGA,212,224,12,19,9860,3,0
12747,ACGTCGAATCTAGGGA,212,226,14,15,10562,3,0
12748,ACGTCGAATCTAGGGA,212,228,16,15,10570,4,0
12749,ACGTCGAATCTAGGGA,212,218,6,18,11083,1,0
12750,ACGTCGAATCTAGGGA,212,216,4,17,11273,0,0
12751,ACGTCGAATCTAGGGA,212,215,3,15,11393,0,0
12752,ACGTCGAATCTAGGGA,212,219,7,21,11565,1,0
12753,ACGTCGAATCTAGGGA,212,231,19,15,11635,5,0
12754,ACGTCGAATCTAGGGA,212,228,16,19,11640,4,0
12755,ACGTCGAATCTAGGGA,212,227,15,20,11642,4,0
12756,ACGTCGAATCTAAGGA,212,216,4,19,11645,0,0
12757,ACGTCGAATCTAGGGA,212,219,7,14,11652,1,0
12758,ACGTCGAATCTAGGGA,212,219,7,19,11662,1,0
12759,ACGTCGAATCTAGGGA,212,221,9,16,11664,2,0
12760,ACGTCGAATCTAGGGA,212,217,5,21,11669,0,0
12761,ACGTCGAATCTAGGGA,212,214,2,18,11672,0,0
12762,ACGTCGAATCTAGGGA,212,230,18,22,11673,5,0
12763,ACGTCGAATCTATGGA,212,230,18,19,11751,5,0
12764,ACGTCGAATCTAGGGA,212,213,1,19,11818,0,0
12765,ACGTCGAATCTAGGGA,212,213,1,15,11819,0,0
12766,ACGTCGAATCTAGGGA,212,214,2,14,11832,0,0
12767,ACGTCGAATCTAGGGA,212,216,4,21,11836,0,0
12768,TCGTCGAATCTATGGA,212,232,20,20,11843,5,0
12769,ACGTCGAATCTAGGGA,212,213,1,21,11847,0,0
12770,ACGTCGAATCTAGGGA,212,220,8,22,11848,1,0
12771,ACGTCGAATCTAGGGA,212,218,6,17,11850,0,0
12772,ACGTCTAATCTAGGGA,212,212,0,21,11856,0,0
12773,ACGTCGAATCTAGGGA,212,226,14,18,11864,3,0
12774,ACGTCGAATCTAGGGA,212,215,3,20,11868,0,0
12775,ACGTCGAATCTAGGGA,212,215,3,19,11987,0,0
12776,ACGTCGAATCTAGGGA,212,212,0,21,11992,0,0
12777,ACGTCGAATCTAGGGA,212,215,3,19,11993,0,0
12778,ACGTCGAATCGAGGGA,212,215,3,15,11994,0,0
12779,ACGTCGAATCTAGGGA,212,212,0,19,12000,0,0
12780,ACGTCGAATCTAGGGA,212,215,3,18,12002,0,0
12781,ACGTCGAATCTAGGGA,212,215,3,22,12004,0,0
12782,ACGTCGAATCTAGGGA,212,212,0,25,12005,0,0
12783,ACGTCGAATCTAGGGA,212,214,2,16,12007,0,0
12784,ACGTCGAATCTAGCGA,212,215,3,23,12008,0,0
12785,ACGTCGAATCTAGGGA,212,215,3,20,12019,0,0
12786,ACGTCGAATCTAGGGA,212,215,3,25,12022,0,0
12787,ACGTCGAATCGAGGGA,212,214,2,20,12023,0,0
12788,ACGTCGAATCTAGGGA,212,215,3,18,12027,0,0
12789,ACGTCGAATCTAGGGA,212,215,3,20,12030,0,0
12790,ACGTCGAATCTAGGGA,212,215,3,15,12169,0,0
12791,ACGTCGAATCTATGGA,212,214,2,20,12262,0,0
12792,ACGTCGAATCTAGGGA,212,215,3,23,12264,0,0
12793,ACGTCGAATCTAGGGA,212,212,0,20,12265,0,0
12794,ACGTCGAATCTAGGGA,212,213,1,16,12268,0,0
12795,ACGTCGAATCTAGGGA,212,215,3,15,12271,0,0
12796,ACGTCGAATCTAGGGA,212,215,3,23,12277,0,0
12797,ACGTCGAATCTAGGGA,212,215,3,22,12356,0,0
12798,ACGTCGAATCTAGGGA,212,215,3,23,12358,0,0
12799,ACGTTGAATCTAGGGA,212,215,3,22,12362,0,0
12800,ACGACGAATCTAGGGA,212,212,0,20,12365,0,0
12801,ACGTCGAATCTAGGGA,212,215,3,21,12367,0,0
12802,ACGTCGAATCTAGGGA,212,212,0,23,12368,0,0
12803,ACGTCGAATCTAGGGA,212,214,2,20,12373,0,0
12804,ACGTAGCATCTAGGGA,212,215,3,21,12381,0,0
12805,ACGTCGAATCTAGGGA,212,215,3,22,12382,0,0
12806,ACGTCGAATCTAGGGA,212,212,0,18,12384,0,0
12807,TCGTCGAATCTAGGGA,212,215,3,22,12385,0,0
12808,ACGTCGAATCTAGGGA,213,229,16,13,10705,3,0
12809,ACGTCGAATCCAGGGA,213,225,12,15,10834,2,0
12810,TCGTCGAATCTAGGGA,213,221,8,20,11012,1,0
12811,ACGTTGAATCTAGGGA,213,214,1,20,11028,0,0
12812,ACGTCGAATCTAGGGA,213,216,3,16,11043,0,0
12813,ACGTCGAATCTAGGGA,213,216,3,22,11187,0,0
12814,ACGTCGAATCTAGGGA,213,213,0,20,11339,0,0
12815,ACGTCGAATCTAGGGA,213,213,0,19,11369,0,0
12816,ACGTCGAATCTAGGGA,213,220,7,20,11377,0,0
12817,ACGTCGAATCTAGGGA,213,214,1,16,11520,0,0
12818,ACGTCGAATCTAGGGA,213,221,8,16,11543,1,0
12819,ACGTCGAATGTAGGGA,213,230,17,17,11544,4,0
12820,ACGTCGAATCTAGGGA,213,222,9,19,11547,1,0
12821,ACGTCGAATCTAGGGA,213,221,8,17,11548,1,0
12822,ACGTCGAATCTAGGGA,213,219,6,20,11557,0,0
12823,ACGTCGAATCTAGGGA,213,220,7,21,11559,0,0
12824,ACGTCGAATCTAGGGA,213,253,40,19,11560,11,0
12825,ACGTCGAATCTAGGGA,213,218,5,19,11720,0,0
12826,ACGTCGAATCTAGGGA,213,216,3,21,11727,0,0
12827,ACGTCGAATCTAGGGA,213,219,6,21,11731,0,0
12828,ACGTCGATTCTGGGGA,213,227,14,16,11733,3,0
12829,ACGTCGAATCTAGGGA,213,213,0,21,11740,0,0
12830,ACGTCGAATCTAGGGA,213,218,5,20,12045,0,0
12831,ACGTCGAATCTAGGGA,213,225,12,19,12055,2,0
12832,ACGTCGAATCTAGGGA,213,222,9,17,12141,1,0
12833,ACGTCGATTCTAGGGA,213,231,18,17,12144,4,0
12834,ACGTCGAATCTAGGGA,213,234,21,20,12152,5,0
12835,ACGTCGAATCTAGGGA,213,213,0,20,12155,0,0
12836,ACGTCGAATCTAGGGA,213,222,9,22,12162,1,0
12837,ACGTCGAATCTAGGGA,213,214,1,16,12170,0,0
12838,ACGTCGAATCTAGGGA,213,224,11,16,12217,2,0
12839,ACGTCGAATCTAGGGA,213,230,17,16,12218,4,0
12840,ACGTCGAATCTAGGGA,213,231,18,16,12224,4,0
12841,ACGTCGAATCTAGGGA,213,221,8,21,12230,1,0
12842,ACGTCGAATCTAGGGA,213,217,4,16,12231,0,0
12843,ACGTCGAATCTAGGGA,213,221,8,20,12232,1,0
12844,ACGTCGAATCTAGGGA,213,229,16,21,12234,3,0
12845,ACGTCGATTCTAGGGA,213,229,16,16,12235,3,0
12846,ACGTCGAATCTAGGGA,213,214,1,22,12239,0,0
12847,ACGTCGAATCTAGGGA,213,214,1,22,12240,0,0
12848,ACGTCGAATCTAGGGA,213,220,7,21,12246,0,0
12849,ACGTCGAATCTAAGGA,213,216,3,20,12248,0,0
12850,ACGTCGAATCTAGGGA,213,213,0,22,12249,0,0
12851,ACGTCGAATCTAGGGA,213,221,8,20,12253,1,0
12852,ACGTCGAATCTAGGGA,213,220,7,20,12254,0,0
12853,ACGTCGAATCTAGGGA,213,262,49,17,12256,14,0
12854,ACGTCGAATCTAGGGA,213,218,5,19,12258,0,0
12855,ACGTCGAATCTAGGGA,213,213,0,23,12259,0,0
12856,ACGTCGAATCTAGGGA,213,217,4,21,12404,0,0
12857,ACGTCGAATCTAGGGA,213,238,25,20,12406,6,0
12858,ACGTCGAATCTAGGGA,213,213,0,20,12410,0,0
12859,ACGTCGAATCTAGGGA,213,214,1,16,12414,0,0
12860,ACGTCGAATCTAGGGA,213,216,3,17,12415,0,0
12861,ACGTCGAATCTAGGGA,213,216,3,15,12519,0,0
12862,ACGTCGAATCGAGGGA,213,216,3,15,12520,0,0
12863,ACGTCGAATCTAGGGA,213,216,3,21,12522,0,0
12864,ACGTCGAATCTAGGGA,213,213,0,22,12523,0,0
12865,ACGTCGAATCTAGGGA,213,216,3,25,12525,0,0
12866,ACGTCGAATCTAGGGA,213,216,3,22,12527,0,0
12867,ACGTCGAATCTAGGGA,213,215,2,20,12530,0,0
12868,ACGTCGAATCTAGGGA,213,216,3,21,12532,0,0
12869,ACGTCGAATGTAGGGA,213,216,3,18,12534,0,0
12870,ACGTCGAATCTAGGGA,213,216,3,18,12538,0,0
12871,ACGTCGAATCTAGGGA,213,216,3,23,12539,0,0
12872,ACGTCGAATCTAGGGA,213,216,3,15,12541,0,0
12873,ACGTCGAATCTAGGGA,213,216,3,16,12543,0,0
12874,ACGTCGAATCTAGGGA,213,214,1,19,12545,0,0
12875,ACGTCGAATCTAGGGA,213,216,3,17,12546,0,0
12876,TCGTCGAATTTAGGGA,213,216,3,21,12547,0,0
12877,ACGTCGAATCTAGGGA,214,214,0,14,9286,0,0
12878,ACGTCGAATCGAGGGA,214,230,16,14,10437,3,0
12879,ACGTCTAATCTAGGGA,214,219,5,20,10576,0,0
12880,ACGTCGAATCTAGGGA,214,220,6,20,10594,0,0
12881,ACGTCGAATCTAGGGA,214,224,10,21,11071,1,0
12882,ACGTCGAATCTAGGGA,214,218,4,24,11230,0,0
12883,ACGTCGAATCTAGGGA,214,218,4,21,11428,0,0
12884,ACGTCGAATCTAGGGA,214,246,32,20,11705,9,0
12885,ACGTCGAATGTAGGGA,214,236,22,17,11713,5,0
12886,ACGTAGAATCTAGGGA,214,218,4,17,11756,0,0
12887,ACGTAGAATCTAGGGA,214,215,1,17,11921,0,0
12888,ACGTCGAATCTAGGGA,214,214,0,14,11922,0,0
12889,ACGTAGCATCTAGGGA,214,214,0,20,11923,0,0
12890,ACGTCGAATCTAGGGA,214,262,48,15,11925,14,0
12891,ACGTCGAATCTAGGGA,214,220,6,18,11936,0,0
12892,TCGTCGAATTTAGGGA,214,217,3,20,12042,0,0
12893,ACGTCGAATCTATGGA,214,217,3,20,12065,0,0
12894,ACGTCGAATCTAGGGA,214,217,3,21,12117,0,0
12895,ACGTCGAATCTAGGGA,214,236,22,21,12128,5,0
12896,ACGTCGAATCTAGGGA,214,234,20,21,12132,5,0
12897,ACGTCGAATCTAGGGA,214,220,6,21,12134,0,0
12898,ACGTCGAATCTAGGGA,214,242,28,20,12137,7,0
12899,ACGTCGAATCTAGGGA,214,224,10,15,12292,1,0
12900,ACGTAGCATCTAGGGA,214,214,0,20,12295,0,0
12901,ACGTCGAATCTAGGGA,214,217,3,17,12296,0,0
12902,TCGTCGAATCTAGGGA,214,218,4,21,12299,0,0
12903,ACGTCGAATCTAGGGA,214,218,4,18,12300,0,0
12904,ACGTCGAATCTAGGGA,214,214,0,16,12304,0,0
12905,ACGTCGAATCTAGGGA,214,227,13,17,12307,2,0
12906,TCGTCGAATCTAGGGA,214,217,3,21,12309,0,0
12907,ACGTCGAATCTAGGGC,214,215,1,19,12392,0,0
12908,ACGTCGAATCTAGGGA,214,215,1,19,12396,0,0
12909,ACGTCGAATCTAGGGA,214,217,3,19,12397,0,0
12910,ACGTCGAATCTATGGA,214,217,3,19,12476,0,0
12911,ACGTGGAATCTAGGGA,214,217,3,14,12477,0,0
12912,ACGTCGAATCTAGGGA,214,216,2,17,12482,0,0
12913,ACGTCGAATCTAGGGA,214,217,3,21,12487,0,0
12914,ACGTCGAATCTAGGGA,214,217,3,17,12489,0,0
12915,ACGTCGAATCTAGGGA,214,217,3,20,12490,0,0
12916,ACGTCGAATCTAGGGA,214,217,3,17,12493,0,0
12917,ACGTCGAATCTAGGGA,214,217,3,20,12500,0,0
12918,ACGTCGAATCTAGGGA,214,217,3,22,12503,0,0
12919,ACGTCGATTCTAGGGA,214,217,3,17,12504,0,0
12920,ACGTCGAATCTAGGGA,214,216,2,22,12505,0,0
12921,ACGTCGAATCTAGGGA,214,214,0,22,12507,0,0
12922,ACGTCGAATCTAGGGA,214,216,2,18,12511,0,0
12923,ACGTCGAATCTAGGGA,214,217,3,21,12512,0,0
12924,TCGTCGAATCTAGGGA,215,242,27,19,9860,7,0
12925,ACGTCGAATCTAGGGC,215,218,3,15,10562,0,0
12926,ACGTCGAATCTAGGGA,215,223,8,15,10570,1,0
12927,ACGTCGAATCTAGGGA,215,219,4,18,11083,0,0
12928,ACGTCGAATCTAGGGA,215,223,8,17,11273,1,0
12929,ACGTCGAATCTAGGGA,215,244,29,15,11393,8,0
12930,ACGTCGAATCTAGGGA,215,239,24,21,11565,6,0
12931,ACGTCGAATCTAGGGA,215,223,8,15,11635,1,0
12932,ACGTCGAATCTAGGGA,215,216,1,19,11640,0,0
12933,ACGTCGAATCTAGGGA,215,218,3,20,11642,0,0
12934,ACGTCGAATCTGGGGA,215,227,12,14,11652,2,0
12935,ACGTCGAATCTAGGGA,215,222,7,16,11664,0,0
12936,ACGTCGAATCTAGGGA,215,225,10,18,11672,1,0
12937,ACGTCGAATCTAGGGA,215,223,8,22,11673,1,0
12938,ACGTCGAATCTATGGA,215,221,6,19,11751,0,0
12939,ACGTCGAATCTAGGGA,215,230,15,19,11818,3,0
12940,ACGTCGAATCTAGGGA,215,222,7,15,11819,0,0
12941,ACGTCGAATCTAGGGA,215,227,12,14,11832,2,0
12942,ACGTCGAATCTAGGGA,215,242,27,21,11836,7,0
12943,TCGTCGAATCTATGGA,215,218,3,20,11843,0,0
12944,ACGTCGAATCTAGGGA,215,220,5,21,11847,0,0
12945,ACGTCGAATCTAGGGA,215,236,21,22,11848,5,0
12946,ACGTCTAATCTAGGGA,215,224,9,21,11856,1,0
12947,ACGTCGAATCTAGGGA,215,220,5,20,11868,0,0
12948,ACGTCGAATCTAGGGA,215,218,3,19,11987,0,0
12949,ACGTCGAATCTAGGGA,215,219,4,21,11992,0,0
12950,ACGTCGAATCTAGGGA,215,218,3,19,11993,0,0
12951,ACGTCGAATCGAGGGA,215,218,3,15,11994,0,0
12952,ACGTCGAATCTAGGGA,215,218,3,19,12000,0,0
12953,ACGTCGAATCTAGGGA,215,217,2,25,12005,0,0
12954,ACGTCGAATCTAGGGA,215,215,0,16,12007,0,0
12955,ACGTCGAATCTAGGGA,215,216,1,23,12008,0,0
12956,ACGTCGAATCTAGGGA,215,218,3,20,12019,0,0
12957,ACGTCGAATCTAGGGA,215,218,3,25,12022,0,0
12958,ACGTCGAATCGGGGGA,215,216,1,20,12023,0,0
12959,ACGTCGAATCTAGGGA,215,218,3,18,12027,0,0
12960,ACGTCGAATCTAGGGA,215,218,3,20,12030,0,0
12961,ACGTCGAATCTAGGGA,215,218,3,15,12169,0,0
12962,ACGTCGAATCTATGGA,215,218,3,20,12262,0,0
12963,ACGTCGAATCTAGGGA,215,218,3,23,12264,0,0
12964,ACGTCGAATCTAGGGA,215,216,1,16,12268,0,0
12965,ACGTCGAATCTAGGGA,215,218,3,15,12271,0,0
12966,ACGTCGAATCTAGGGA,215,218,3,23,12277,0,0
12967,ACGTCGAATCTAGGGA,215,216,1,22,12356,0,0
12968,ACGTCGAATCTAGGGA,215,216,1,23,12358,0,0
12969,ACGTTGAATCTAGGGA,215,218,3,22,12362,0,0
12970,ACGTCGAATCTAGGGA,215,216,1,20,12365,0,0
12971,ACGTCGAATCTAGGGA,215,218,3,23,12368,0,0
12972,ACGTCGAATCTAGGGA,215,218,3,20,12373,0,0
12973,ACGTAGCATCTAGGGA,215,217,2,21,12381,0,0
12974,TCGTCGAATCTTGGGA,215,218,3,22,12385,0,0
12975,ACGTCGAATCTATGGA,215,218,3,21,12548,0,0
12976,ACGTCGAATCTAGGGA,215,217,2,20,12550,0,0
12977,ACGTCGAATCTAGGGA,216,240,24,13,10705,6,0
12978,ACGTCGAATCCAGGGA,216,217,1,15,10834,0,0
12979,ACGTCGAATCTAGGGA,216,218,2,20,11028,0,0
12980,ACGTCGAATCTAGGGA,216,216,0,22,11187,0,0
12981,ACGTCGAATCTAGGGA,216,236,20,20,11339,5,0
12982,ACGTCGAATCTAGGGA,216,220,4,19,11369,0,0
12983,ACGTCGAATCTAGGGA,216,222,6,20,11377,0,0
12984,ACGTCGAATCTAGGGA,216,219,3,16,11520,0,0
12985,GCGTCGAATCTAGGGA,216,223,7,16,11543,0,0
12986,ACGTCGAATGTAGGGA,216,223,7,17,11544,0,0
12987,ACGTCGAATCTAGGGA,216,220,4,17,11548,0,0
12988,ACGTCGAATCTAGGGA,216,226,10,20,11557,1,0
12989,ACGTCGAATCTAGGGA,216,234,18,21,11559,4,0
12990,ACGTCGAATCTAGGGA,216,238,22,19,11560,5,0
12991,ACGTCGAATCTAGGGA,216,226,10,21,11727,1,0
12992,ACGTCGAATCTAGGGA,216,216,0,21,11731,0,0
12993,ACGTCGAATCTAGGGA,216,216,0,21,11740,0,0
12994,ACGTCGAATCTAGGGA,216,218,2,20,12045,0,0
12995,ACGTCGAATCTAGGGA,216,219,3,19,12055,0,0
12996,ACGTCGAATCTAGGGA,216,216,0,17,12141,0,0
12997,ACGTCGATTCTAGGGA,216,224,8,17,12144,1,0
12998,ACGTCGAATCTAGGGA,216,227,11,20,12155,2,0
12999,ACGTCGAATCTAGGGA,216,223,7,22,12162,0,0
13000,ACGTCGAATCTAGGGA,216,223,7,16,12170,0,0
13001,ACGTCGAATCTAGGGA,216,237,21,16,12218,5,0
13002,ACGTCGAATCTAGGGA,216,233,17,16,12224,4,0
13003,ACGTCGAATCTAGGGA,216,223,7,16,12231,0,0
13004,ACGTCGAATCTAGGGA,216,224,8,20,12232,1,0
13005,ACGTCGAATCTAGGGA,216,233,17,22,12239,4,0
13006,ACGTCGAATCTAGGGA,216,229,13,22,12240,2,0
13007,ACGTCGAATGTAGGGA,216,219,3,21,12246,0,0
13008,ACGTCGAATCTAGGGA,216,223,7,20,12253,0,0
13009,ACGTCGAATCTAGGGA,216,245,29,20,12254,8,0
13010,ACGTCGAATCTAGGGA,216,235,19,17,12256,4,0
13011,ACGTCGAATCTAGGGA,216,249,33,23,12259,9,0
13012,ACGTCGAATCTAGGGA,216,230,14,21,12404,3,0
13013,ACGTCGAATCTAGGGA,216,233,17,20,12410,4,0
13014,ACGTCGAATCTAGGGA,216,216,0,17,12415,0,0
13015,ACGTCGAATCTAGGGA,216,223,7,25,12525,0,0
13016,ACGTCGAATCTAGGGA,216,238,22,22,12527,5,0
13017,ACGTCGAATCTAGGGA,216,219,3,20,12530,0,0
13018,ACGTCGAATCTAGGGA,216,242,26,21,12532,7,0
13019,ACGTCGAATGTAGGGA,216,250,34,18,12534,9,0
13020,ACGTCGAATCTAGGGA,216,226,10,18,12538,1,0
13021,ACGTCGAATCTAGGGA,216,221,5,23,12539,0,0
13022,ACGTCGAATCTAGGGA,216,220,4,15,12541,0,0
13023,ACGTCGAATCTAGGGA,216,219,3,16,12543,0,0
13024,ACGTCGAATCAAGGGA,216,219,3,19,12545,0,0
13025,ACGTCGAATCTAGGGA,216,217,1,17,12546,0,0
13026,TCGTCGAATTTAGGGA,216,219,3,21,12547,0,0
13027,TCGTCGAATCTAGGGA,216,219,3,20,12568,0,0
13028,ACGTCGAATCTAGGGA,216,219,3,19,12569,0,0
13029,ACGTCGAATCTAGGGA,216,219,3,19,12574,0,0
13030,ACGTCGAATCTAGGGA,216,219,3,19,12575,0,0
13031,ACGTCGAATCTAGGGA,216,219,3,18,12576,0,0
13032,ACGTCGAATCTAGGGA,216,217,1,17,12586,0,0
13033,ACGTCGAATCTAAGGA,216,219,3,20,12589,0,0
13034,ACGTCGAATCTAGGGA,216,219,3,20,12591,0,0
13035,ACGTCGAATCTAGGGA,216,219,3,20,12593,0,0
13036,ACGTCGAATCTAGGGA,216,219,3,23,12597,0,0
13037,ACGTCGAATCTATGGA,216,218,2,20,12598,0,0
13038,ACGTCGAATCTAGGGA,216,219,3,19,12610,0,0
13039,ACGTCGAATCTAGGGA,216,216,0,20,12616,0,0
13040,ACGTCGAATCTAGGGA,216,217,1,26,12622,0,0
13041,ACGTCGAATCTAGGGA,216,219,3,17,12623,0,0
13042,ACGTCGAATCTAGGGA,216,219,3,24,12624,0,0
13043,ACGTCGAATCTAGGGA,216,218,2,22,12626,0,0
13044,ACGTCGAATCTAGGGA,217,231,14,14,9286,3,0
13045,ACGTCGAATCTAGGGA,217,237,20,20,10594,5,0
13046,ACGTCGAATCTAGGGA,217,221,4,21,11071,0,0
13047,ACGTCGAATCTAGGGA,217,217,0,20,11705,0,0
13048,ACGTCGAATGTAGGGA,217,233,16,17,11713,3,0
13049,ACGTAGAATCTAGGGA,217,221,4,17,11756,0,0
13050,ACGTAGAATCTAGGGA,217,222,5,17,11921,0,0
13051,ACGTCGAATCTAGGGA,217,220,3,14,11922,0,0
13052,ACGTAGCATCTAGGGA,217,224,7,20,11923,0,0
13053,ACGTCGAATCTAGGGA,217,225,8,18,11936,1,0
13054,TCGTCGAATTTAGGGA,217,219,2,20,12042,0,0
13055,ACGTCGAATCTATGGA,217,217,0,20,12065,0,0
13056,ACGTCGAATCTAGGGA,217,235,18,21,12128,4,0
13057,ACGTCGAATCTAGGGA,217,223,6,21,12134,0,0
13058,ACGTCGAATCTAGGGA,217,228,11,20,12137,2,0
13059,ACGTAGCATCTAGGGA,217,221,4,20,12295,0,0
13060,ACGTCGAATCTAGGGA,217,217,0,17,12296,0,0
13061,ACGTCGAATCTAGGGA,217,227,10,17,12307,1,0
13062,TCGTCGAATCTAGGGA,217,219,2,21,12309,0,0
13063,ACGTCGAATCTAGGGC,217,227,10,19,12392,1,0
13064,ACGTCGAATCTAGGGA,217,218,1,19,12396,0,0
13065,ACGTCGAGTCTAGGGA,217,226,9,19,12397,1,0
13066,ACGTCGAATCTATGGA,217,225,8,19,12476,1,0
13067,ACGTCGAATCTAGGGA,217,222,5,14,12477,0,0
13068,ACGTCGAATCTAGGGA,217,218,1,17,12489,0,0
13069,ACGTCGAATCTAGGGA,217,224,7,20,12490,0,0
13070,ACGTCGAATCTAGGGA,217,218,1,17,12493,0,0
13071,ACGTCGAATCTAGGGA,217,219,2,22,12503,0,0
13072,ACGTCGATTCTAGGGA,217,219,2,17,12504,0,0
13073,ACGTCGAATCTAGGGA,217,222,5,22,12505,0,0
13074,ACGTCGAATCTAGGGA,217,221,4,22,12507,0,0
13075,ACGTCTAATCTAGGGA,217,221,4,18,12511,0,0
13076,ACGTCGAATCTAGGGA,217,220,3,21,12512,0,0
13077,ACGTCGAATCTAGGGA,217,220,3,14,12634,0,0
13078,ACGTCGAATCCAGGGA,217,220,3,16,12635,0,0
13079,TCGTCGCATCTAGGGA,217,219,2,21,12636,0,0
13080,ACGTCGAATCTAGGGA,217,220,3,21,12637,0,0
13081,ACGTCGAATCTAGGGA,217,220,3,21,12643,0,0
13082,ACGTCGAATCTAGGGA,217,220,3,21,12645,0,0
13083,ACGTCGAATCTAGGGA,217,220,3,17,12646,0,0
13084,ACGTCGAATCTAGGGA,217,217,0,17,12647,0,0
13085,ACGTCGAATCTAGGGA,217,220,3,20,12649,0,0
13086,ACGTCGAATCTAGGGA,217,220,3,22,12656,0,0
13087,ACGTCGAATCTAGGGA,217,220,3,18,12662,0,0
13088,ACGTCGAATCTAGGGA,217,219,2,20,12665,0,0
13089,TCGTCGAATCTAGGGA,217,219,2,20,12746,0,0
13090,ACGTCGAATCTAGGGA,217,220,3,16,12747,0,0
13091,ACGTCGAATCTAGGGA,217,220,3,16,12748,0,0
13092,ACGTCGAATCTAGGGA,217,220,3,19,12749,0,0
13093,ACGTCGAATCTAGGGA,217,220,3,22,12752,0,0
13094,ACGTCGAATCTAGGGA,217,220,3,16,12753,0,0
13095,ACGTCGAATCTAGGGA,217,220,3,20,12754,0,0
13096,ACGTCGAATCTAGGGA,217,217,0,21,12755,0,0
13097,ACGTCGAATCTAGGGA,217,220,3,15,12757,0,0
13098,ACGTCGAATCTAGGGA,217,218,1,20,12758,0,0
13099,ACGTCGAATCTAGGGA,217,220,3,17,12759,0,0
13100,ACGTCGAATCTAGGGA,217,220,3,23,12762,0,0
13101,ACGTCGAATCTATGGA,217,217,0,20,12763,0,0
13102,ACGTCGAATCTAGGGA,218,218,0,15,10562,0,0
13103,ACGTCGAATCTAGGGA,218,221,3,15,10570,0,0
13104,ACGTCGAATCTAGGGA,218,231,13,17,11273,2,0
13105,ACGTCGAATCTAGGGA,218,224,6,15,11393,0,0
13106,ACGTCGAATCTAGGGA,218,220,2,21,11565,0,0
13107,ACGTCGAATCTAGGGA,218,235,17,15,11635,4,0
13108,ACGTCGAATCTAGGGA,218,259,41,19,11640,12,0
13109,ACGTCGAATCTAGGGA,218,253,35,14,11652,10,0
13110,ACGTCGAATCTAGGGA,218,222,4,16,11664,0,0
13111,ACGTCGAATCTATGGA,218,219,1,19,11751,0,0
13112,ACGTCGAATCTAGGGA,218,222,4,19,11818,0,0
13113,ACGTCGAATCTAGGGA,218,227,9,15,11819,1,0
13114,ACGTCGAATCTAGGGA,218,233,15,21,11836,3,0
13115,TCGTCGAATCTATGGA,218,227,9,20,11843,1,0
13116,ACGTCGAATCTAGGGA,218,240,22,21,11847,5,0
13117,ACGTCGAATCTAGGGA,218,222,4,22,11848,0,0
13118,ACGTTTAATCTAGGGA,218,229,11,21,11856,2,0
13119,ACGTCGAATCTAGGGA,218,223,5,20,11868,0,0
13120,ACGTCGAATCTAGGGA,218,218,0,19,11987,0,0
13121,ACGTCGAATCTAGGGA,218,219,1,21,11992,0,0
13122,ACGTCGAATCTAGGGA,218,229,11,19,11993,2,0
13123,ACGTCGAATCGAGGGA,218,221,3,15,11994,0,0
13124,ACGTCGAATCTAGGGA,218,224,6,19,12000,0,0
13125,ACGTCGAATCTAGGGA,218,243,25,25,12005,6,0
13126,ACGTCGAATCTAGGGA,218,245,27,16,12007,7,0
13127,ACGTCGAATCTAGGGA,218,230,12,23,12008,2,0
13128,ACGTCGAATCTAGGGA,218,218,0,20,12019,0,0
13129,ACGTCGAATCTAGGGA,218,224,6,25,12022,0,0
13130,ACGTCGAATCGAGGGA,218,278,60,20,12023,18,0
13131,ACGTCGAATCTAGGGA,218,239,21,20,12030,5,0
13132,ACGTCGAATCTAGGGA,218,219,1,15,12169,0,0
13133,ACGTCGAATCTATGGA,218,219,1,20,12262,0,0
13134,ACGTCGAATCTAGGGA,218,221,3,16,12268,0,0
13135,ACGTCGAATCTAGGGA,218,220,2,15,12271,0,0
13136,ACGTCGAATCTAGGGA,218,218,0,23,12277,0,0
13137,ACGTTGAATCTAGGGA,218,224,6,22,12362,0,0
13138,ACGTCGAATCTAGGGA,218,218,0,20,12365,0,0
13139,ACGTCGAATCTAGGGA,218,218,0,20,12373,0,0
13140,ACGTAGCATCTAGGGA,218,244,26,21,12381,7,0
13141,TCGTCGAATCTAGGGA,218,227,9,22,12385,1,0
13142,ACGTCGAATCTATGGA,218,219,1,21,12548,0,0
13143,ACGTCGAATCTAGGGA,218,232,14,20,12550,3,0
13144,ACGTCGAATCTAGGGA,218,220,2,22,12701,0,0
13145,ACGTCGAATCTAGGGA,218,221,3,21,12706,0,0
13146,ACGTAGAATCTAGGGA,218,242,24,18,12708,6,0
13147,ACGTCGAATCTAGGGA,218,259,41,18,12709,12,0
13148,ACGTCGAATCTAGGGA,218,231,13,15,12712,2,0
13149,ACGTCGAATCTAGGGA,218,246,28,19,12715,7,0
13150,ACGTCGAATCTAGGGA,218,220,2,15,12720,0,0
13151,ACGTCGAATCTAGGGA,218,221,3,22,12723,0,0
13152,ACGTCGAATCTAGGGA,218,236,18,22,12728,4,0
13153,ACGTCGAATCTAGGGA,218,241,23,21,12729,6,0
13154,ACGTCGAATCTAGGGA,218,219,1,18,12730,0,0
13155,ACGTCGAATCTAGGGA,218,222,4,16,12731,0,0
13156,ACGTCGAATCTAGGGA,218,218,0,16,12732,0,0
13157,TCGTCGAATCTAGGGA,218,221,3,22,12736,0,0
13158,ACGTCGAATCTAGGGA,218,221,3,19,12737,0,0
13159,ACGTCGAATCTAGGGA,218,221,3,18,12739,0,0
13160,TCGTCGAATCTAGGGA,218,221,3,22,12740,0,0
13161,ACGTCGAATCTAGGGA,218,221,3,22,12741,0,0
13162,ACGTCGAATCTAGGGA,218,221,3,20,12745,0,0
13163,ACGTCGAATCTAGGGA,219,219,0,13,10705,0,0
13164,ACGTCGAATCTAGGGA,219,224,5,20,11028,0,0
13165,ACGTCGAATCTAGGGA,219,228,9,22,11187,1,0
13166,ACGTCGAATCTAGGGA,219,219,0,20,11339,0,0
13167,ACGTCGAATCTAGGGA,219,219,0,19,11369,0,0
13168,ACGTCGAATCTAGGGA,219,263,44,20,11377,13,0
13169,ACGTCGAATCTAGGGA,219,222,3,16,11520,0,0
13170,ACGTCGAATCTAGGGA,219,221,2,16,11543,0,0
13171,ACGTCGAATGTAGGGA,219,221,2,17,11544,0,0
13172,ACGTCGAATCTAGGGA,219,221,2,17,11548,0,0
13173,ACGTCGAATCTAGGGA,219,229,10,20,11557,1,0
13174,ACGTCGAATCTAGGGA,219,268,49,21,11559,14,0
13175,ACGTCGAATCTAGGGA,219,226,7,21,11727,0,0
13176,ACGTCGAATCTAGGGA,219,231,12,21,11740,2,0
13177,ACGTCGAATCTAGGGA,219,222,3,20,12045,0,0
13178,ACGTCGAATCTAGGGA,219,221,2,20,12155,0,0
13179,ACGTCGAATCTAGGGA,219,220,1,22,12162,0,0
13180,ACGTCGAATCTAGGGA,219,222,3,16,12218,0,0
13181,ACGTCGAATCTAGGGA,219,222,3,16,12224,0,0
13182,ACGTCGAATCTAGGGA,219,222,3,20,12232,0,0
13183,ACGTCGAATCTAGGGA,219,222,3,22,12239,0,0
13184,ACGTCGAATCTAGGGA,219,222,3,22,12240,0,0
13185,ACGTCGAATCTAGGGA,219,221,2,20,12254,0,0
13186,ACGTCGAATCTAGGGA,219,222,3,17,12256,0,0
13187,ACGTCGAATCTAGGGA,219,222,3,21,12404,0,0
13188,ACGTCGAATCTAGGGA,219,222,3,17,12415,0,0
13189,ACGTCGAATCTAGGGA,219,222,3,25,12525,0,0
13190,ACGTCGAATCTAGGGA,219,222,3,22,12527,0,0
13191,AAGTCGAATCTAGGGA,219,219,0,20,12530,0,0
13192,ACGTCGAATCTAGGGA,219,222,3,21,12532,0,0
13193,ACGTCGAATGTAGGGA,219,222,3,18,12534,0,0
13194,ACGTCGAATCTAGGGA,219,222,3,18,12538,0,0
13195,ACGTCGAATCTAGGGA,219,222,3,15,12541,0,0
13196,ACGTCGAATCTAGGGA,219,222,3,19,12545,0,0
13197,TCGTCGAATTTAGGGA,219,222,3,21,12547,0,0
13198,TCGTCGAATCTAGGGA,219,222,3,20,12568,0,0
13199,ACGTCGAATCTAGGGA,219,222,3,19,12569,0,0
13200,ACGTCGAATCTAGGGA,219,222,3,19,12575,0,0
13201,ACGTCGAATCTAGGGA,219,222,3,17,12586,0,0
13202,ACGTCGAATCTAGGGA,219,219,0,20,12591,0,0
13203,ACGTCGAATCTAGGGA,219,220,1,20,12593,0,0
13204,ACGTCGAATCTAGGGA,219,222,3,23,12597,0,0
13205,ACGTCGAATCTATGGA,219,220,1,20,12598,0,0
13206,ACGTCGAATCTAGGGA,219,222,3,20,12616,0,0
13207,ACGTCGAATCTAGGGA,219,221,2,26,12622,0,0
13208,ACGTCGAATCTAGGGA,219,222,3,17,12623,0,0
13209,ACGTCGAATCTAGGGA,219,221,2,24,12624,0,0
13210,ACGTCGAATCTAGGGA,219,222,3,22,12626,0,0
13211,TCGTCGAATCTATGGA,219,222,3,21,12768,0,0
13212,ACGTCGAATCTAGGGA,219,222,3,23,12770,0,0
13213,ACGTCGAATCTAGGGA,219,222,3,19,12773,0,0
13214,ACGTCGAATCTAGGGA,220,222,2,14,9286,0,0
13215,ACGTCGAATCTAGGGA,220,234,14,20,10594,3,0
13216,ACGTCGAATCTAGGGA,220,227,7,20,11705,0,0
13217,ACGTCGAATGTAGGGA,220,259,39,17,11713,11,0
13218,ACGTAGAATCTAGGGA,220,230,10,17,11756,1,0
13219,ACGTAGAATCTAGGGA,220,233,13,17,11921,2,0
13220,ACGTCGAATCTAGGGA,220,221,1,14,11922,0,0
13221,ACGTCGAATCTAGGGA,220,227,7,18,11936,0,0
13222,TCGTCGAATTTAGGGA,220,238,18,20,12042,4,0
13223,ACGTCGAATCTATGGA,220,227,7,20,12065,0,0
13224,ACGTCGAATCTAGGGA,220,223,3,21,12128,0,0
13225,ACGTCGAATCTAGGGA,220,221,1,21,12134,0,0
13226,ACGTCGAATCTAGGGA,220,221,1,20,12137,0,0
13227,ACGTAGCATCTAGGGA,220,220,0,20,12295,0,0
13228,ACGTCGAATCTAGGGA,220,223,3,17,12307,0,0
13229,TCGTCGAATCTAGGGA,220,232,12,21,12309,2,0
13230,ACGTCGAATCTAGGGA,220,227,7,19,12392,0,0
13231,ACGTCGAATCTAGGGA,220,234,14,19,12396,3,0
13232,ACGTCGAATCTAGGGA,220,228,8,19,12397,1,0
13233,ACGTCGAATCTATGGA,220,222,2,19,12476,0,0
13234,ACGTCGAATCTAGGGA,220,243,23,14,12477,6,0
13235,ACGTCGAATCTAGGGA,220,221,1,20,12490,0,0
13236,ACGTCGAATCTAGGGA,220,245,25,17,12493,6,0
13237,ACGTCGATTCTAGGGA,220,242,22,17,12504,5,0
13238,ACGTCGAATCTTGGGA,220,222,2,22,12505,0,0
13239,ACGTCGAATCTAGGGA,220,221,1,22,12507,0,0
13240,ACGTCGAATCTAGGGA,220,223,3,18,12511,0,0
13241,ACGTCGAATCTAGGGA,220,228,8,21,12512,1,0
13242,ACGTCGAATCTAGGGA,220,221,1,14,12634,0,0
13243,ACGTCGAATCCAGGGA,220,244,24,16,12635,6,0
13244,ACGTCGAATCTAGGGA,220,221,1,21,12645,0,0
13245,ACGTCGAATCTAGGGA,220,224,4,17,12647,0,0
13246,ACGTCGAATCTAGGGA,220,222,2,20,12649,0,0
13247,ACGTCGAATCTAGGGA,220,230,10,22,12656,1,0
13248,ACGTCGAATCTAGGGA,220,286,66,18,12662,20,0
13249,ACGTCGAATCTAGGGA,220,246,26,20,12665,7,0
13250,TCGTCGAATCTAGGGA,220,242,22,20,12746,5,0
13251,ACGTCGAATCTAGGGA,220,231,11,16,12747,2,0
13252,ACGTCGAATCTAGGGA,220,221,1,16,12748,0,0
13253,ACGTCGAATCTAGGGA,220,237,17,16,12753,4,0
13254,ACGTCGAATCTAGGGA,220,236,16,20,12754,3,0
13255,ACGTCGAATCTAGGGA,220,226,6,21,12755,0,0
13256,ACGTCGAATCTAGGGA,220,242,22,17,12759,5,0
13257,ACGTCGAATCTAGGGA,220,233,13,23,12762,2,0
13258,ACGTCGAATCTATGGA,220,227,7,20,12763,0,0
13259,ACGTCGAATCTAGGGA,220,228,8,14,12808,1,0
13260,ACGTCGAATCCAGGGA,220,222,2,16,12809,0,0
13261,TCGTCGAATCTAGGGA,220,235,15,21,12810,3,0
13262,ACGTCGAATCTAGGGA,220,223,3,17,12818,0,0
13263,ACGTCGAATGTAGGGA,220,256,36,18,12819,10,0
13264,ACGTCGAATCTAGGGA,220,223,3,20,12820,0,0
13265,ACGTCGAATCTAGGGA,220,223,3,18,12821,0,0
13266,ACGTCGAATCTAGGGA,220,228,8,20,12824,1,0
13267,ACGTCGATTCTGGGGA,220,285,65,17,12828,20,0
13268,ACGTCGAATCTAGGGA,220,228,8,20,12831,1,0
13269,ACGTCGAATCTAGGGA,220,238,18,18,12832,4,0
13270,ACGTCGATTCTAGGGA,220,228,8,18,12833,1,0
13271,ACGTCGAATCTAGGGA,220,221,1,21,12834,0,0
13272,ACGTCGAATCTAGGGA,220,227,7,23,12836,0,0
13273,ACGTCGAATCTAGGGA,220,221,1,17,12838,0,0
13274,ACGTCGAATCTAGGGA,220,220,0,17,12839,0,0
13275,ACGTCGAATCTAGGGA,220,226,6,17,12840,0,0
13276,ACGTCGAATCTAGGGA,220,227,7,22,12841,0,0
13277,ACGTCGAATCTAGGGA,220,224,4,21,12843,0,0
13278,ACGTCGAATCTAGGGA,220,247,27,22,12844,6,0
13279,ACGTCGATTCTAGGGA,220,221,1,17,12845,0,0
13280,ACGTCGAATCTAGGGA,220,227,7,21,12851,0,0
13281,ACGTCGAATCTAGGGA,220,238,18,18,12853,3,0
13282,ACGTCGAATCTAGGGA,220,220,0,21,12857,0,0
13283,ACGTCGAATCTAGGGA,221,221,0,15,10570,0,0
13284,ACGTCGAATCTAGGGA,221,244,23,17,11273,5,0
13285,ACGTCGAATCTAGGGA,221,224,3,21,11565,0,0
13286,GCGTCGAATCTAGGGA,221,224,3,15,11635,0,0
13287,ACGTCGAATCTAGGGA,221,224,3,19,11640,0,0
13288,ACGTCGAATCTAGGGA,221,224,3,16,11664,0,0
13289,ACGTCGAATCTATGGA,221,224,3,19,11751,0,0
13290,ACGTCGAATCTAGGGA,221,224,3,19,11818,0,0
13291,ACGTCGAATCTAGGGA,221,224,3,15,11819,0,0
13292,ACGTCGAATCGAGGGA,221,224,3,21,11847,0,0
13293,ACGTCGAATCTAGGGA,221,224,3,22,11848,0,0
13294,ACGTCGAATCTAGGGT,221,222,1,21,11992,0,0
13295,ACGTCGAATCTAGGGA,221,223,2,19,11993,0,0
13296,ACGTCGAATCGAGGGA,221,222,1,15,11994,0,0
13297,ACGTCGAATCTAGGGA,221,224,3,19,12000,0,0
13298,ACGTCGAATCTAGGGA,221,224,3,25,12005,0,0
13299,ACGTCGAATCTAGGGA,221,224,3,20,12019,0,0
13300,ACGTCGAATCTAGGGA,221,224,3,25,12022,0,0
13301,ACGTCGAATCGAGGGA,221,224,3,20,12023,0,0
13302,ACGTCGAATATAGGGA,221,224,3,20,12030,0,0
13303,ACGTCGAATCTAGGGA,221,224,3,15,12169,0,0
13304,ACGTCGAATCTATGGA,221,224,3,20,12262,0,0
13305,ACGTCGAATCTAGGGA,221,224,3,16,12268,0,0
13306,ACGTCGAATCTAGGGA,221,221,0,15,12271,0,0
13307,ACGTTGAATCTAGGGA,221,224,3,22,12362,0,0
13308,ACGTCGAATCTAGGGA,221,224,3,20,12365,0,0
13309,ACGTCGAATCTAGGGA,221,224,3,20,12373,0,0
13310,ACGTAGCATCTAGGGA,221,224,3,21,12381,0,0
13311,TCGTCGAATCTAGGGA,221,224,3,22,12385,0,0
13312,ACGTCGAATCTATGGA,221,224,3,21,12548,0,0
13313,ACGTCGAATCTAGGGA,221,224,3,20,12550,0,0
13314,ACGTCGAATCTAGGGA,221,222,1,22,12701,0,0
13315,ACGTCGAATCTAGGGA,221,224,3,21,12706,0,0
13316,ACGTAGAATCTAGGGA,221,224,3,18,12708,0,0
13317,ACGTCGAATCTAGGGA,221,224,3,18,12709,0,0
13318,ACGTCGAATCTAGGGA,221,224,3,19,12715,0,0
13319,ACGTCGAATCTAGGGA,221,224,3,15,12720,0,0
13320,ACGTCGAATCTAGGGA,221,224,3,21,12729,0,0
13321,ACGTCGAATCTAGGGA,221,224,3,18,12730,0,0
13322,ACGTCGAATCTAGGGA,221,222,1,16,12731,0,0
13323,ACGTCGAATCTAGGGA,221,224,3,16,12732,0,0
13324,TCGTCGAATCTAGGGA,221,224,3,22,12736,0,0
13325,ACGTCGAATCTATGGA,221,224,3,19,12737,0,0
13326,ACGTCGAATCTAGGGA,221,224,3,18,12739,0,0
13327,ACGTCGAATCTAGGGA,221,224,3,20,12745,0,0
13328,ACGCCGAATCGAGGGA,221,224,3,15,12878,0,0
13329,ACGTCGAATCTAGGGA,221,224,3,22,12881,0,0
13330,ACGTCGAATCTAGGGA,221,224,3,21,12884,0,0
13331,ACGTCGAATGTAGGGA,221,224,3,18,12885,0,0
13332,ACGTCGAATCTAGGGA,221,222,1,16,12890,0,0
13333,ACGTCGAATCTAGGGA,221,224,3,22,12895,0,0
13334,ACGTCGAATCTAGGGA,221,224,3,22,12896,0,0
13335,ACGTCGAATCTAGGGA,221,224,3,21,12898,0,0
13336,ACGTCGAATCTAGGGA,221,222,1,16,12899,0,0
13337,ACGTCGAATCTAGGGA,221,224,3,18,12905,0,0
13338,ACGTCGAATCTAGGGA,222,235,13,20,11028,2,0
13339,ACGTCGAATCTAGGGA,222,223,1,22,11187,0,0
13340,ACGTCGAATCTAGGGA,222,241,19,20,11339,4,0
13341,ACGTCGAATCTAGGGA,222,225,3,16,11520,0,0
13342,ACGTCGAATGTAGGGA,222,229,7,17,11544,0,0
13343,ACGTCGAATCTAGGGA,222,233,11,17,11548,2,0
13344,ACGTCGAATCTAGGGA,222,225,3,20,11557,0,0
13345,ACGTCGAATCTAGGGA,222,262,40,21,11559,11,0
13346,ACGTCGAATCTAGGGA,222,226,4,21,11727,0,0
13347,ACGTCGAATCTAGGGA,222,224,2,21,11740,0,0
13348,ACGTCGAATCTAGGGA,222,227,5,20,12045,0,0
13349,ACGTCGAATCTAGGGA,222,223,1,20,12155,0,0
13350,ACGTCGAATCTAGGGA,222,223,1,22,12162,0,0
13351,ACGTCGAATCTAGGGA,222,252,30,16,12224,8,0
13352,ACGTCGAATCTAGGGA,222,222,0,20,12232,0,0
13353,ACGTCGAATCTAGGGA,222,223,1,22,12239,0,0
13354,ACGTCGAATCTAGGGA,222,229,7,22,12240,0,0
13355,ACGTCGAATCTAGGGA,222,247,25,20,12254,6,0
13356,ACGTCGAATCTAGGGA,222,269,47,17,12415,14,0
13357,ACGTCGAATCTAGGGA,222,225,3,25,12525,0,0
13358,ACGTCGAATCTAGGGA,222,229,7,22,12527,0,0
13359,ACGTCGAATCTAGGGA,222,241,19,20,12530,4,0
13360,ACGTCGAATCTAGGGA,222,232,10,21,12532,1,0
13361,ACGTCGAATGTAGGGA,222,222,0,18,12534,0,0
13362,ACGTCGAATCTAGGGA,222,242,20,18,12538,5,0
13363,ACGTCGAATCTAGGGA,222,224,2,15,12541,0,0
13364,TCGTCGAATTTAGGGA,222,222,0,21,12547,0,0
13365,TCGTCGAATCTAGGGA,222,231,9,20,12568,1,0
13366,ACGTCGAATCTAGGGA,222,225,3,19,12575,0,0
13367,ACGTCGAATCTAGGGA,222,227,5,17,12586,0,0
13368,ACGTCGAATCTAGGGA,222,227,5,20,12591,0,0
13369,ACGTCGAATCTAGGGA,222,223,1,20,12593,0,0
13370,ACGTCGAATCTAGGGA,222,222,0,20,12616,0,0
13371,ACGTCGAATCTAGGGA,222,231,9,26,12622,1,0
13372,ACGTCGAATCTAGGGA,222,225,3,17,12623,0,0
13373,ACGTCGAATCTAGGGA,222,223,1,24,12624,0,0
13374,ACGTCGAATATAGGGA,222,227,5,22,12626,0,0
13375,TCGTCGAATCTATGGA,222,231,9,21,12768,1,0
13376,ACGTCGAATCTAGGGA,222,240,18,19,12773,4,0
13377,TCGTCGAATCTAGGGA,222,233,11,20,12924,2,0
13378,ACGTCGAATCTAGGGA,222,234,12,16,12926,2,0
13379,ACGTCGAATCTAGGGA,222,244,22,18,12928,5,0
13380,ACGTCGAATCTAGGGA,222,226,4,16,12929,0,0
13381,ACGTCGAATCTAGGGA,222,229,7,22,12930,0,0
13382,ACGTCGAATCTAGGGA,222,256,34,16,12931,9,0
13383,ACGTCGAATCTGGGGA,222,224,2,15,12934,0,0
13384,ACGTCGAATCTAGGGA,222,240,18,19,12936,4,0
13385,ACGTCGAATCTAGGGA,222,263,41,23,12937,12,0
13386,ACGTCGAATCTAGGGA,222,224,2,20,12939,0,0
13387,ACGTCGAATCTAGGGA,222,249,27,15,12941,7,0
13388,ACGTCGAATCTAGGGA,222,227,5,22,12942,0,0
13389,ACGTCGAATCTAGGGA,222,223,1,23,12945,0,0
13390,ACGTCTAATCTAGGGA,222,224,2,22,12946,0,0
13391,ACGTCGAATCTAGGGA,223,244,21,14,9286,6,0
13392,ACGTCGAATGTAGGGA,223,224,1,17,11713,0,0
13393,ACGTAGAATCTAGGGA,223,230,7,17,11756,1,0
13394,ACGTAGAATCTAGGGA,223,245,22,17,11921,6,0
13395,ACGTCGAATCTAGGGA,223,224,1,14,11922,0,0
13396,TCGTCGAATTTAGGGA,223,241,18,20,12042,4,0
13397,ACGTCGAATCTATGGA,223,226,3,20,12065,0,0
13398,ACGTCGAATCTAGGGA,223,234,11,21,12128,2,0
13399,ACGTCGAATCTAGGGA,223,225,2,21,12134,0,0
13400,ACGTAGCATCTAGGGA,223,230,7,20,12295,0,0
13401,TCGTCGAATCTAGGGA,223,226,3,21,12309,0,0
13402,ACGTCGAATCTAGGGA,223,225,2,19,12392,0,0
13403,ACGTCGAATCTAGGGA,223,225,2,19,12396,0,0
13404,ACGTCGAATCTAGGGA,223,227,4,19,12397,0,0
13405,ACGTCGAATCTAGGGA,223,236,13,14,12477,2,0
13406,ACGTCGAATCTAGGGA,223,225,2,20,12490,0,0
13407,ACGTCGAATCTAGGGA,223,233,10,17,12493,1,0
13408,ACGTCGAATCTAGGGA,223,223,0,22,12505,0,0
13409,ACGTCGAATCTAGGGA,223,233,10,18,12511,1,0
13410,ACGTCGAATCTAGGGA,223,229,6,21,12512,0,0
13411,ACGTCGAATCTAGGGA,223,223,0,21,12645,0,0
13412,ACGTCGAATCTAGGGA,223,237,14,20,12649,3,0
13413,ACGTCGAATCTAGGGA,223,237,14,22,12656,3,0
13414,ACGTCGAATCTAGGGA,223,224,1,18,12662,0,0
13415,ACGTCGAATCTAGGGA,223,224,1,20,12665,0,0
13416,TCGTCGAATCTAGGGA,223,233,10,20,12746,1,0
13417,ACGTCGAATCTAGGGA,223,224,1,16,12747,0,0
13418,ACGTCGAATCTAGGGA,223,228,5,16,12748,0,0
13419,ACGTCGAATCTAGGGA,223,246,23,16,12753,6,0
13420,ACGTCGAATCTAGGGA,223,223,0,20,12754,0,0
13421,ACGTCGAATCTAGGGA,223,236,13,21,12755,2,0
13422,ACGTCGAATCTAGGGA,223,226,3,23,12762,0,0
13423,ACGTCGAATCTATGGA,223,241,18,20,12763,3,0
13424,ACGTCGAATCTAGGGA,223,230,7,14,12808,0,0
13425,ACGTCGAATCCAGGGA,223,226,3,16,12809,0,0
13426,ACGTCGAATGTAGGGA,223,224,1,18,12819,0,0
13427,ACGTCGAATCTAGGGA,223,235,12,20,12824,1,0
13428,ACGTCGATTCTGGGGA,223,231,8,17,12828,0,0
13429,ACGTCGAATCTAGGGA,223,231,8,20,12831,0,0
13430,ACGTCGATTCTAGGGA,223,224,1,18,12833,0,0
13431,ACGTCGAATCTAGGGA,223,235,12,21,12834,1,0
13432,ACGTCGAATCTAGGGA,223,225,2,17,12838,0,0
13433,ACGTCGAATCTAGGGA,223,241,18,17,12839,3,0
13434,ACGTCGAATCTAGGGA,223,224,1,17,12840,0,0
13435,ACGTCGAATCTAGGGA,223,226,3,22,12844,0,0
13436,ACGTCGATTCTAGGGA,223,226,3,17,12845,0,0
13437,ACGTCGAATCTAGGGA,223,229,6,18,12853,0,0
13438,ACGTCGAATCTAGGGA,223,225,2,21,12857,0,0
13439,ACGTCGAATCTAGGGA,223,241,18,14,12977,3,0
13440,ACGTCGAATCTAGGGA,223,225,2,21,12981,0,0
13441,ACGTCGAATCTAGGGA,223,227,4,21,12988,0,0
13442,ACCTCGAATCTAGGGA,223,224,1,22,12989,0,0
13443,ACGTCGAATCTAGGGA,223,224,1,20,12990,0,0
13444,ACGTCGAATCTAGGGA,223,234,11,22,12991,1,0
13445,ACGTCGATTCTAGGGA,223,229,6,18,12997,0,0
13446,ACGTCGAATCTAGGGA,223,227,4,21,12998,0,0
13447,ACGTCGAATCTAGGGA,223,227,4,17,13001,0,0
13448,ACGTCGAATCTAGGGA,223,223,0,17,13002,0,0
13449,ACGTCGAATCTAGGGA,223,225,2,21,13004,0,0
13450,ACGTCGAATCTAGGGA,223,226,3,23,13005,0,0
13451,ACGTCGAATCTAGGGA,223,226,3,23,13006,0,0
13452,ACGTCGAATCTAGGGA,223,226,3,21,13009,0,0
13453,ACGTCGAATCTAGGGA,223,226,3,18,13010,0,0
13454,ACGTCGAATCTAGGGA,223,226,3,24,13011,0,0
13455,ACGTCGAATCTAGGGA,223,226,3,22,13012,0,0
13456,ACGTCGAATCTAGGGA,223,226,3,21,13013,0,0
13457,ACGTCGAATCTAGGGA,223,224,1,23,13016,0,0
13458,ACGTCGAATCTAGGGA,223,226,3,22,13018,0,0
13459,ACGTCGAATGTAGGGA,223,226,3,19,13019,0,0
13460,ACGTCGAATCTAGGGA,223,225,2,19,13020,0,0
13461,ACGTCGAATCTAGGGA,224,235,11,15,10570,2,0
13462,ACGTCGAATCTAGGGA,224,247,23,17,11273,6,0
13463,ACGTCGAATCTAGGGA,224,229,5,21,11565,0,0
13464,ACGTCGAATCTAGGGA,224,266,42,15,11635,12,0
13465,ACGTCGAATCTAGGGA,224,226,2,16,11664,0,0
13466,AAGTCGAATCTATGGA,224,246,22,19,11751,5,0
13467,ACGTCGAATCTAGGGA,224,243,19,19,11818,4,0
13468,ACGTCGAATCTAGGGA,224,226,2,15,11819,0,0
13469,ACGTCGAATCTAGGGA,224,230,6,21,11847,0,0
13470,ACGTCGAATCTAGGGA,224,224,0,19,11993,0,0
13471,ACGTCGAATCGAGGGA,224,258,34,15,11994,9,0
13472,ACGTCGAATCTAGGGA,224,231,7,25,12005,0,0
13473,ACGTCGAATCTAGGGA,224,228,4,20,12019,0,0
13474,ACGTCGAATCTAGGGA,224,235,11,25,12022,2,0
13475,ACGTCGAATCTAGGGA,224,228,4,15,12169,0,0
13476,ACGTCGAATCTAGGGA,224,225,1,16,12268,0,0
13477,ACGTCGAATCTAGGGA,224,225,1,15,12271,0,0
13478,ACGTTGAATCTAGGGA,224,225,1,22,12362,0,0
13479,ACGTCGAATCTAGGGA,224,227,3,20,12365,0,0
13480,ACGTCGAATCTAGGGA,224,227,3,20,12373,0,0
13481,ACGTCGAATCTATGGA,224,227,3,21,12548,0,0
13482,ACGTCGAATCTAGGGA,224,227,3,20,12550,0,0
13483,ACGTCGAATCTAGGGA,224,225,1,22,12701,0,0
13484,ACGTCGAATCTAGGGA,224,226,2,21,12706,0,0
13485,ACGTAGAATCTAGGGA,224,227,3,18,12708,0,0
13486,ACGTCGAATCTAGGGA,224,227,3,19,12715,0,0
13487,ACGTCGAATCTCGGGA,224,227,3,15,12720,0,0
13488,ACGTCGAATCTAGGGA,224,226,2,21,12729,0,0
13489,ACGTCGAATCTAGGGA,224,227,3,18,12730,0,0
13490,ACGTCGAATCTAGGGA,224,224,0,16,12731,0,0
13491,ACGTCGAATCTAGGGA,224,227,3,16,12732,0,0
13492,ACGTCGAATCTAGGGA,224,227,3,19,12737,0,0
13493,ACGTCGAATCTAGGGA,224,227,3,18,12739,0,0
13494,ACGTCGAATCAAGGGA,224,227,3,20,12745,0,0
13495,ACGTCGAATCGAGGGA,224,227,3,15,12878,0,0
13496,ACGTCGAATCTAGGGA,224,224,0,21,12884,0,0
13497,ACGTCGAATGTAGGGA,224,227,3,18,12885,0,0
13498,ACGTCGAATCTAGGGA,224,227,3,16,12890,0,0
13499,ACGTCGAATCTAGGGA,224,227,3,22,12895,0,0
13500,ACGTCGAATCTAGGGA,224,227,3,22,12896,0,0
13501,ACGTCGAATCTAGGGA,224,227,3,21,12898,0,0
13502,ACGTCGAATCTAGGGA,224,225,1,18,12905,0,0
13503,ACGTCGAATCTAGGGA,224,227,3,15,13044,0,0
13504,ACGTCGAATCTAGGGA,224,225,1,21,13045,0,0
13505,ACGTCGAATGTAGGGA,224,226,2,18,13048,0,0
13506,ACGTCGAATCTAGGGA,224,224,0,19,13053,0,0
13507,ACGTCGAATCTAGGGA,224,227,3,22,13056,0,0
13508,ACGTCGAATCTAGGGA,224,227,3,21,13058,0,0
13509,ACGTCGAATCTAGGGA,224,227,3,18,13061,0,0
13510,ACGTCGAATCTAGGGC,224,227,3,20,13063,0,0
13511,ACGTCGAGTCTAGGGA,224,227,3,20,13065,0,0
13512,ACGTCGAATCTATGGA,224,226,2,20,13066,0,0
13513,ACGTCGAATCTAGGGA,225,233,8,20,11028,1,0
13514,ACGTCGAATCTAGGGA,225,252,27,22,11187,7,0
13515,ACGTCGAATCTAGGGA,225,234,9,16,11520,1,0
13516,ACGTCGAATGTAGGGA,225,225,0,17,11544,0,0
13517,ACGTCGAATCTAGGGA,225,230,5,17,11548,0,0
13518,ACGTCGAATCTAGGGA,225,229,4,21,11559,0,0
13519,ACGTCGAATCTAGGGA,225,238,13,21,11727,2,0
13520,ACGTCGAATCTAGGGA,225,232,7,21,11740,0,0
13521,ACGTCGAATCTAGGGA,225,229,4,20,12155,0,0
13522,ACGTCGAATCTAGGGA,225,236,11,16,12224,2,0
13523,ACGTCGAATCTAGGGA,225,233,8,20,12232,1,0
13524,ACGTCGAATCTAGGGA,225,240,15,22,12239,3,0
13525,ACGTCGAATCTAGGGA,225,227,2,20,12254,0,0
13526,ACGTCGAATCTAGGGA,225,225,0,17,12415,0,0
13527,ACGTCGAATCTAGGGA,225,225,0,25,12525,0,0
13528,ACGTCGAATCTAGGGA,225,225,0,22,12527,0,0
13529,ACGTCGAATCTAGGGA,225,227,2,20,12530,0,0
13530,ACGTCGAATCTAGGGA,225,225,0,18,12538,0,0
13531,ACGTCGAATCTAGGGA,225,242,17,15,12541,4,0
13532,TCGTCGAATTTAGGGA,225,229,4,21,12547,0,0
13533,TCGTCGAATCTAGGGA,225,231,6,20,12568,0,0
13534,ACGTCGAATCTAGGGA,225,268,43,17,12586,12,0
13535,ACGTCGAATCTAGGGA,225,233,8,20,12591,1,0
13536,ACGTCGAATCTAGGGA,225,233,8,20,12593,1,0
13537,ACGTCGAATCTAGGGA,225,228,3,17,12623,0,0
13538,ACGTCGAATCTAGGGA,225,260,35,22,12626,10,0
13539,TCGTCGAATCTATGGA,225,229,4,21,12768,0,0
13540,ACGTCGAATCTAGGGA,225,225,0,19,12773,0,0
13541,TCGTCGAATCTAGGGA,225,227,2,20,12924,0,0
13542,ACGTCGAATCTAGGGA,225,234,9,16,12929,1,0
13543,ACGTCGAATCTAGGGA,225,240,15,22,12930,3,0
13544,ACGTCGAATCTGGGGA,225,231,6,15,12934,0,0
13545,ACGTCGAATCTAGGGA,225,234,9,20,12939,1,0
13546,ACGTCGAATCTAGGGA,225,231,6,15,12941,0,0
13547,ACGTCGAATCTAGGGA,225,230,5,22,12942,0,0
13548,ACGTCGAATCTAGGGA,225,234,9,23,12945,1,0
13549,ACGTCGAATCTAGGGA,225,231,6,18,13104,0,0
13550,ACGTCGAATCTAGGGA,225,232,7,16,13107,0,0
13551,ACGTCGAATCTAGGGA,225,229,4,20,13108,0,0
13552,ACGTCGAATCTAGGGA,225,226,1,15,13109,0,0
13553,ACGTCGAATCTAGGGA,225,262,37,16,13113,10,0
13554,ACGTCGAATCTAGGGA,225,259,34,22,13114,9,0
13555,TCGTCGAATCTATGGA,225,229,4,21,13115,0,0
13556,ACGTCGAATCTAGGGA,225,243,18,22,13116,3,0
13557,ACGTTTAATCTAGGGA,225,246,21,22,13118,4,0
13558,ACGTCGAATCTAGGGA,225,233,8,20,13122,0,0
13559,ACGTCGAATCTAGGGA,225,237,12,26,13125,1,0
13560,ACGTCGAATCTAGGAA,225,230,5,17,13126,0,0
13561,ACGTCGAATCTATGGA,225,227,2,24,13127,0,0
13562,ACGTCGAATCGAGGGA,225,238,13,21,13130,2,0
13563,ACGTCGAATCTAGGGA,225,235,10,21,13131,1,0
13564,ACGTAGCATCTAGGGA,225,237,12,22,13140,1,0
13565,TCGTCGAATCTAGGGA,225,225,0,23,13141,0,0
13566,ACGTCGAATCTAGGGA,225,226,1,21,13143,0,0
13567,ACGTAGAATCTAGGGA,225,226,1,19,13146,0,0
13568,ACGTCGAATCTAGGGA,225,227,2,19,13147,0,0
13569,ACGTCGAATCTAGGGA,225,262,37,16,13148,10,0
13570,ACGTCGAATCTAGGGA,225,228,3,20,13149,0,0
13571,ACGTCGAATCTAGGGA,225,240,15,23,13152,2,0
13572,ACGTCGAATCTAGGGA,225,225,0,22,13153,0,0
13573,ACGTCGAATCTAGGGA,226,242,16,14,9286,3,0
13574,ACGTCGAATGTAGGGA,226,227,1,17,11713,0,0
13575,ACGTAGAATCTAGGGA,226,226,0,17,11756,0,0
13576,ACGTAGAATCTAGGGA,226,227,1,17,11921,0,0
13577,ACGTCGAATCTAGGGA,226,228,2,14,11922,0,0
13578,TCGTCGAATTTAGGGA,226,226,0,20,12042,0,0
13579,ACGTCGAATCTATGGA,226,234,8,20,12065,1,0
13580,ACGTCGAATCTAGGGA,226,226,0,21,12134,0,0
13581,ACGTAGCATCTAGGGA,226,227,1,20,12295,0,0
13582,TCGTCGAATCTAGGGA,226,229,3,21,12309,0,0
13583,ACGTCGAATCTAGGGA,226,229,3,19,12392,0,0
13584,ACGTCGAATCTAGGGA,226,229,3,19,12396,0,0
13585,ACGTCGAATCTAGGGA,226,229,3,14,12477,0,0
13586,ACGTCGAATCTAGGGA,226,229,3,20,12490,0,0
13587,ACGTCGAATCTAGGGA,226,229,3,17,12493,0,0
13588,ACGTCGAATCTAGCGA,226,226,0,18,12511,0,0
13589,ACGTCGAATCTAGGGA,226,229,3,21,12512,0,0
13590,ACGTCGAATCTAGGGA,226,229,3,21,12645,0,0
13591,ACGTCGAATCTAGGGA,226,226,0,20,12649,0,0
13592,GCGTCGAATCTAGGGA,226,229,3,22,12656,0,0
13593,ACGTCGAATCTAGGGA,226,229,3,18,12662,0,0
13594,ACGTCGAATCTAGGGA,226,227,1,20,12665,0,0
13595,ACGTCGAATCTAGGGA,226,229,3,16,12748,0,0
13596,ACGTCGAATCTAGGGA,226,229,3,16,12753,0,0
13597,ACGTCGAATCTAGGGA,226,229,3,20,12754,0,0
13598,ACGTCGAATCTAGGGA,226,229,3,21,12755,0,0
13599,ACGTCGAATCTAGGGA,226,229,3,23,12762,0,0
13600,ACGTCGAATCTATGGA,226,229,3,20,12763,0,0
13601,ACGTCGAATCTAGGGA,226,226,0,14,12808,0,0
13602,ACGTCGAATGTAGGGA,226,229,3,18,12819,0,0
13603,ACGTCGAATCTAGGGA,226,229,3,20,12824,0,0
13604,ACGTCGATTCTGGGGA,226,229,3,17,12828,0,0
13605,ACGTCGATTCTAGGGA,226,229,3,18,12833,0,0
13606,ACGTCGAATCTAGGGA,226,229,3,21,12834,0,0
13607,ACGTCGAATCTAGGGA,226,229,3,17,12839,0,0
13608,ACGTCGAATCTAGGGA,226,227,1,17,12840,0,0
13609,ACGTCGAATCTAGGGA,226,229,3,22,12844,0,0
13610,ACGTCGATTCTAGGGA,226,229,3,17,12845,0,0
13611,ACGTCGAATCTAGGGA,226,229,3,18,12853,0,0
13612,ACGTCGAATCTAGGGA,226,229,3,21,12857,0,0
13613,ACGTCGAATCTAGGGA,226,229,3,14,12977,0,0
13614,ACGTCGAATCTAGGGA,226,228,2,21,12981,0,0
13615,ACGTCGAATCTAGGGA,226,229,3,22,12989,0,0
13616,ACGTCGAATCTAGGGA,226,229,3,20,12990,0,0
13617,ACGTCGAATCTAGGGA,226,229,3,21,12998,0,0
13618,ACGTCGAATCTAGGGA,226,229,3,17,13001,0,0
13619,ACGTCGAATCTAGGGA,226,229,3,17,13002,0,0
13620,ACGTCGAATCTAGGGA,226,228,2,23,13005,0,0
13621,ACGTCGAATCTAGGGA,226,229,3,23,13006,0,0
13622,ACGTCGAATCTAGGGA,226,229,3,21,13009,0,0
13623,ACGTCGAATCTAGGGA,226,229,3,18,13010,0,0
13624,ACGTCGAATCTAGGGA,226,226,0,24,13011,0,0
13625,ACGTCGAATCTAGGGA,226,228,2,22,13012,0,0
13626,ACGTCGAATCTAGGGA,226,229,3,21,13013,0,0
13627,ACCTCGAATCTAGGGA,226,226,0,23,13016,0,0
13628,ACGTCGAATCTAGGGA,226,229,3,22,13018,0,0
13629,ACGTCGAATGTAGGGA,226,229,3,19,13019,0,0
13630,ACGTCGAATCTAGGGA,226,229,3,23,13165,0,0
13631,ACGTCGAATCTAGGGA,226,229,3,21,13168,0,0
13632,ACGTCGAATCTAGGGA,226,229,3,21,13173,0,0
13633,ACGTCGAATCTAGGGA,226,229,3,22,13174,0,0
13634,ACGTCGAATCTAGGGA,227,231,4,15,10570,0,0
13635,ACGTCGAATCTAGGGA,227,229,2,17,11273,0,0
13636,ACGTCGAATCTATGGA,227,234,7,19,11751,0,0
13637,ACGTCGAATCTAGGGA,227,228,1,19,11818,0,0
13638,ACGTCGAATCTAGGGA,227,234,7,15,11819,0,0
13639,ACGTCGAATCTAGGGA,227,228,1,21,11847,0,0
13640,ACGTCGAATCTAGGGA,227,236,9,19,11993,1,0
13641,ACGTCGAATCTAGGGA,227,236,9,25,12005,1,0
13642,ACGTCGAATCTAGGGA,227,275,48,20,12019,14,0
13643,ACGTCGAATCTAGGGA,227,229,2,25,12022,0,0
13644,ACGTCGAATCTAGGGA,227,233,6,15,12169,0,0
13645,ACGTCGAATCTAGGGA,227,233,6,16,12268,0,0
13646,ACGTCGAATCTAGGGA,227,237,10,15,12271,1,0
13647,ACGTTGAATCTAGGGA,227,241,14,22,12362,3,0
13648,ACGTCGAATCTAGGGA,227,233,6,20,12365,0,0
13649,ACGTCGAATCTAGGGA,227,227,0,20,12373,0,0
13650,ACGTCGAATCTAGGGA,227,228,1,20,12550,0,0
13651,ACGTCGAATCTAGGGA,227,227,0,22,12701,0,0
13652,ACGTCGAATCTAGGGA,227,228,1,21,12706,0,0
13653,ACGTCGAATCTAGGGA,227,229,2,21,12729,0,0
13654,ACGTCGAATCTAGGGA,227,232,5,16,12731,0,0
13655,ACGTCGAATCTAGGGA,227,233,6,16,12732,0,0
13656,ACGTCGAATCTAGGGA,227,294,67,19,12737,20,0
13657,ACGTCGAATCTAGGGA,227,234,7,18,12739,0,0
13658,ACGTCGAATCTAGGGA,227,239,12,20,12745,2,0
13659,ACGTCGAATCGAGGGA,227,245,18,15,12878,4,0
13660,ACGTCGAATCTAGGGA,227,243,16,21,12884,3,0
13661,ACGTCGAATGTAGGGA,227,269,42,18,12885,12,0
13662,ACGTCGAATCTAGGGA,227,234,7,16,12890,0,0
13663,ACGTCGAATCTAGGGA,227,231,4,22,12895,0,0
13664,ACGTCGAATCTAGGGA,227,231,4,22,12896,0,0
13665,ACGTCGAATCTAGGGA,227,227,0,21,12898,0,0
13666,ACGTCGAATCTAGGGA,227,230,3,15,13044,0,0
13667,ACGTCGAATCTAGGGA,227,227,0,21,13045,0,0
13668,ACGTCGAATGTAGGGA,227,228,1,18,13048,0,0
13669,ACGTCGAATCTAGGGA,227,232,5,22,13056,0,0
13670,ACGTCGAATCTAGGGA,227,229,2,21,13058,0,0
13671,ACGTCGAATCTAGGGA,227,280,53,22,13176,16,0
13672,ACGTCGAATCTAGGGA,227,235,8,21,13215,1,0
13673,ACGTCGAATGTAGGGA,227,242,15,18,13217,3,0
13674,ACGTAGAATCTAGGGA,227,241,14,18,13218,3,0
13675,ACGTAGAATCTAGGGA,227,233,6,18,13219,0,0
13676,TCGTCGAATTTAGGGA,227,230,3,21,13222,0,0
13677,TCGTCGAATCTAGGGA,227,228,1,22,13229,0,0
13678,ACGTCGAATCTAGGGA,227,236,9,20,13231,1,0
13679,ACGTCGAATCTAGGGA,227,229,2,20,13232,0,0
13680,ACGTCGAATCTAGGGA,227,233,6,15,13234,0,0
13681,ACGTCGAATCTAGGGA,227,244,17,18,13236,4,0
13682,ACGTCGATTCTAGGGA,227,231,4,18,13237,0,0
13683,ACGTCGAATCTAGGGA,227,250,23,22,13241,6,0
13684,CCGTCGAATCCAGGGA,227,229,2,17,13243,0,0
13685,ACGTCGAATCTAGGGA,227,231,4,23,13247,0,0
13686,ACGTCGAATCTAGGGA,227,230,3,19,13248,0,0
13687,ACGTCGAATCTAGGGA,227,228,1,21,13249,0,0
13688,TCGTCGAATCTAGGGA,227,228,1,21,13250,0,0
13689,ACGTCGAATCTAGGGA,227,246,19,17,13251,4,0
13690,ACGTCGAATCTAGGGA,227,234,7,17,13253,0,0
13691,ACGTCGAATCTAGGGA,227,243,16,21,13254,3,0
13692,ACGTCGAATCTAGGGA,227,227,0,18,13256,0,0
13693,ACGTCGAATCTAGGGA,227,233,6,24,13257,0,0
13694,ACGTCGAATCTAGGGA,227,231,4,15,13259,0,0
13695,TCGTCGAATCTAGGGA,227,229,2,22,13261,0,0
13696,ACGTCGAATGTAGGGA,227,232,5,19,13263,0,0
13697,ACGTCGAATCTAGGGA,227,238,11,21,13266,1,0
13698,ACGTCGATTCTGGGGA,227,227,0,18,13267,0,0
13699,ACGTCGAATCTAGGGA,227,227,0,21,13268,0,0
13700,ACGTCGAATCTAGGGA,227,228,1,19,13269,0,0
13701,ACGTCGATTCTAGGGA,227,232,5,19,13270,0,0
13702,ACGTCGAATCTAGGGA,228,244,16,20,11028,3,0
13703,ACGTCGAATCTAGGGA,228,241,13,22,11187,2,0
13704,ACGTCGAATCTAGGGA,228,231,3,17,11548,0,0
13705,ACGTCGAATCTAGGGA,228,243,15,21,11740,3,0
13706,ACGTCGAATCTAGGGA,228,237,9,20,12155,1,0
13707,ACGTCGAATCTAGGGA,228,232,4,20,12232,0,0
13708,ACGTCGAATCTAGGGA,228,241,13,20,12254,2,0
13709,ACGTCGAATCTAGGGA,228,235,7,17,12415,0,0
13710,ACGTCGAATCTAGGGA,228,235,7,25,12525,0,0
13711,ACGTCGAATCTAGGGA,228,241,13,22,12527,2,0
13712,ACGTCGAATCTAGGGA,228,237,9,20,12530,1,0
13713,ACGTCGAATCTAGGGA,228,230,2,18,12538,0,0
13714,ACGTCGAATCTAGGGA,228,229,1,15,12541,0,0
13715,TCGTCGAATTTAGGGA,228,228,0,21,12547,0,0
13716,ACGTCGAATCTAGGGA,228,230,2,20,12591,0,0
13717,ACGTCGAATCTAGGGA,228,230,2,17,12623,0,0
13718,ACGTCGAATCTAGGGA,228,232,4,22,12626,0,0
13719,TCGTCGAATCTATTGA,228,271,43,21,12768,12,0
13720,TCGTCGAATCTAGGGA,228,231,3,20,12924,0,0
13721,ACGTCGAATCTAGGGA,228,235,7,16,12929,0,0
13722,ACGTCGAATCTAGGGA,228,234,6,22,12930,0,0
13723,ACGTCGAATCTAGGGA,228,236,8,20,12939,1,0
13724,ACGTCGAATCTAGGGA,228,239,11,22,12942,2,0
13725,ACGTCGAATCTAGGGA,228,230,2,23,12945,0,0
13726,ACGTCGAATCTAGGGA,228,237,9,18,13104,1,0
13727,ACGTCGAATCTAGGGA,228,229,1,16,13107,0,0
13728,ACGTCGAATCTAGGGA,228,252,24,20,13108,6,0
13729,ACGTCGAATCTAGGGA,228,231,3,15,13109,0,0
13730,ACGTCGAATCTAGGGA,228,231,3,22,13114,0,0
13731,ACGTCGAATCTAGGGA,228,231,3,22,13116,0,0
13732,ACGTTTAATCTAGGGA,228,231,3,22,13118,0,0
13733,ACGTCGAATCTAGGGA,228,231,3,20,13122,0,0
13734,ACGTCGAATCTAGGGA,228,229,1,26,13125,0,0
13735,ACGTCGAATCTAGGGA,228,231,3,17,13126,0,0
13736,ACGTCGAATCTAGGGA,228,230,2,24,13127,0,0
13737,ACGTCGAATCGAGGGA,228,231,3,21,13130,0,0
13738,ACGTCGAATCTAGGGA,228,231,3,21,13131,0,0
13739,ACGTAGCATCTAGGGA,228,231,3,22,13140,0,0
13740,ACGTCGAATCTAGGGA,228,231,3,21,13143,0,0
13741,ACGTAGAATCTAGGGA,228,231,3,19,13146,0,0
13742,ACGTCGAATCTAGGGA,228,231,3,19,13147,0,0
13743,ACGTCGAATCTAGGGA,228,231,3,16,13148,0,0
13744,ACGTCGAATCTAGGGA,228,228,0,20,13149,0,0
13745,ACGTCGAATCTAGGGA,228,231,3,23,13152,0,0
13746,ACGTCGAATCTAGGGA,228,231,3,22,13153,0,0
13747,ACCTCGAATCTAGGGA,228,231,3,15,13391,0,0
13748,ACGTAGAATCTAGGGA,228,230,2,18,13393,0,0
13749,ACGTAGAATCTAGGGA,228,231,3,18,13394,0,0
13750,ACGTCGAATCTAGGGA,229,242,13,14,9286,2,0
13751,ACGTCGAATGTAGGGA,229,232,3,17,11713,0,0
13752,ACGTAGAATCTAGGGA,229,229,0,17,11921,0,0
13753,TCGTCGAATTTAGGGA,229,234,5,20,12042,0,0
13754,ACGTCGAATCTAGGGA,229,230,1,21,12134,0,0
13755,ACGTAGCATCTAGGGA,229,235,6,20,12295,0,0
13756,TCGTCGAATCTAGGGA,229,241,12,21,12309,2,0
13757,ACGTCGAATCTAGGGA,229,244,15,14,12477,3,0
13758,ACGTCGAATCTAGGGA,229,240,11,20,12490,2,0
13759,ACGTCGAATCTAGGGA,229,236,7,18,12511,0,0
13760,ACGTCGAATCTAGGGA,229,231,2,21,12512,0,0
13761,ACGTCGAATCTAGGGA,229,236,7,21,12645,0,0
13762,ACGTCGAATCTAGGGA,229,239,10,22,12656,1,0
13763,ACGTCGAATCTAGGGA,229,232,3,18,12662,0,0
13764,ACGTCGAATCTAGGGA,229,250,21,20,12665,5,0
13765,ACGTCGAATCTAGGGA,229,230,1,16,12753,0,0
13766,ACGTCGAATCTAGGGA,229,238,9,23,12762,1,0
13767,ACGTCGAATCTATGGA,229,229,0,20,12763,0,0
13768,ACGTCGAATGTAGGGA,229,243,14,18,12819,3,0
13769,ACGTCGAATCTAGGGA,229,243,14,20,12824,3,0
13770,ACGTCGATTCTAGGGA,229,238,9,18,12833,1,0
13771,ACGTCGAATCTAGGGA,229,233,4,21,12834,0,0
13772,ACGTCGAATCTAGGGA,229,231,2,17,12839,0,0
13773,ACGTCGAATCTGGGGA,229,246,17,17,12840,4,0
13774,ACGTCGAATCTAGGGA,229,231,2,18,12853,0,0
13775,ACGTCGAATCTAGGGA,229,233,4,21,12857,0,0
13776,ACGTCGAATCTAGGGA,229,262,33,14,12977,9,0
13777,ACGTCGAATCTAGGGA,229,246,17,21,12981,4,0
13778,ACGTCGAATCTAGGGA,229,241,12,22,12989,2,0
13779,ACGTCGAATCTAGGGA,229,238,9,20,12990,1,0
13780,ACGTCGAATCTAGGGA,229,231,2,17,13001,0,0
13781,ACGTCGAATCTAGGGA,229,237,8,17,13002,0,0
13782,ACGTCGAATCTAGGGA,229,232,3,23,13005,0,0
13783,ACGTCGAATCTAGGGA,229,246,17,21,13009,3,0
13784,ACGTCGAATCTAGGGA,229,234,5,18,13010,0,0
13785,ACGTCGAATCTAGGGA,229,230,1,24,13011,0,0
13786,ACGTCGAATCTAGGGA,229,263,34,22,13012,9,0
13787,ACGTCGAATCTAGGGA,229,239,10,21,13013,1,0
13788,ACGTCGAATCTAGGGA,229,245,16,23,13016,3,0
13789,ACGTCGAATCTAGGGA,229,232,3,22,13018,0,0
13790,ACGTCGAATGTAGGGA,229,232,3,19,13019,0,0
13791,ACGTCGAATCTAGGGA,229,232,3,21,13168,0,0
13792,ACGTCGAATCTAGGGA,229,231,2,22,13174,0,0
13793,ACGTCGAATCTAGGGA,229,232,3,23,13278,0,0
13794,ACGTCGAATCTAGGGA,229,232,3,19,13281,0,0
13795,ACGTCGAATCTAGGGA,229,230,1,18,13284,0,0
13796,ACGTCGAATCTAGGGA,229,232,3,21,13338,0,0
13797,ACGTCGAATCTAGGGA,229,230,1,21,13340,0,0
13798,ACGTCGAATCTAGGGA,229,232,3,18,13343,0,0
13799,ACGTCGAATCTAGGGA,229,229,0,22,13345,0,0
13800,ACGTCGAATCTAGGGA,229,232,3,17,13351,0,0
13801,ACGTCGAATCTAGGGA,229,232,3,21,13355,0,0
13802,ACGTCGAATCTAGGGA,229,232,3,18,13356,0,0
13803,ACGTCGAATCTAGGGA,229,229,0,21,13359,0,0
13804,ACGTCGAATCTAGGGA,229,232,3,22,13360,0,0
13805,ACGTCGAATCTAGGGA,229,232,3,19,13362,0,0
13806,TCGTCGAATCTAGGGA,229,232,3,21,13365,0,0
13807,ACGTCGAATCTAGGGA,229,232,3,27,13371,0,0
13808,TCGTCGAATCTATGGA,229,232,3,22,13375,0,0
13809,ACGTCGAATCTAGGGA,229,229,0,20,13376,0,0
13810,TCGTCGAAGCTAGGGA,229,232,3,21,13377,0,0
13811,ACGTCGAATCTAGGGA,229,232,3,17,13378,0,0
13812,ACGTCGAATCTAGGGA,229,229,0,19,13379,0,0
13813,ACGTCGAATCTAGGGA,229,232,3,17,13382,0,0
13814,ACGTCGAATCTAGGGA,229,229,0,20,13384,0,0
13815,ACGTCGAATCTAGGGA,229,232,3,24,13385,0,0
13816,ACGTCGAATCTAGGGA,229,232,3,16,13387,0,0
13817,ACGTCGAATCTAGGGA,230,230,0,15,10570,0,0
13818,ACGTCGAATCTAGGGA,230,232,2,17,11273,0,0
13819,ACGTCGAATCTATGGA,230,238,8,19,11751,1,0
13820,ACGTCGAATCTAGGGA,230,241,11,19,11818,2,0
13821,ACGTCGAATCTAGGGA,230,235,5,15,11819,0,0
13822,ACGTCGAATCTAGGGA,230,231,1,21,11847,0,0
13823,ACGTCGAATCTAGGGA,230,231,1,25,12005,0,0
13824,ACGTCGAATCTAGGGA,230,244,14,20,12019,3,0
13825,ACGTCGAATCTAGGGA,230,231,1,25,12022,0,0
13826,ACGTCGAATCTAGGGA,230,231,1,16,12268,0,0
13827,ACGTCGAATCTAGGGA,230,232,2,15,12271,0,0
13828,ACGTTGAATCTAGGGA,230,231,1,22,12362,0,0
13829,ACGTCGAATCTAGGGA,230,267,37,20,12365,10,0
13830,ACGTCGAATCTAGGGA,230,238,8,20,12373,1,0
13831,ACGTCGAATCTAGGGA,230,230,0,21,12706,0,0
13832,ACGTCGAATCTAGGGA,230,237,7,21,12729,0,0
13833,ACGTCGAATCTAGGGA,230,244,14,16,12731,3,0
13834,ACGTCGAATCTAGGGA,230,242,12,18,12739,2,0
13835,ACGTCGAATCTAGGGA,230,249,19,20,12745,4,0
13836,ACGTCGAATCTAGGGA,230,238,8,21,12884,1,0
13837,ACGTCGAATGTAGGGA,230,230,0,18,12885,0,0
13838,ACGTCGAATCTAGGGA,230,245,15,16,12890,3,0
13839,ACGTCGAATCTAGGGA,230,233,3,22,12895,0,0
13840,ACGTCGAATCTAGGGA,230,246,16,22,12896,3,0
13841,ACGTCGAATCTAGGGA,230,238,8,21,12898,1,0
13842,ACGTCGAATCTAGGGA,230,231,1,15,13044,0,0
13843,ACGTCGAATCTAGGGA,230,250,20,21,13045,5,0
13844,ACGTCGAATGTAGGGA,230,242,12,18,13048,2,0
13845,ACGTCGAATCTAGGGA,230,242,12,22,13056,2,0
13846,ACGTCGAATCTAGGGA,230,247,17,22,13176,4,0
13847,ACGTCGAATCTAGGGA,230,234,4,21,13215,0,0
13848,ACGTCGAATGTAGGGA,230,230,0,18,13217,0,0
13849,ACGTAGAATCTAGGGA,230,235,5,18,13219,0,0
13850,TCGTCGAATTTAGGGA,230,230,0,21,13222,0,0
13851,TCGTCGAATCTAGGGA,230,252,22,22,13229,5,0
13852,ACGTCGAATCTAGGGA,230,242,12,20,13231,2,0
13853,ACGTCGAATCTAGGGA,230,231,1,15,13234,0,0
13854,ACGTCGAATCTAGGGA,230,235,5,18,13236,0,0
13855,ACGTCGATTCTAGGGA,230,233,3,18,13237,0,0
13856,ACGTCGAATCCAGGGA,230,233,3,17,13243,0,0
13857,ACGTCGAATCTAGGGA,230,233,3,19,13248,0,0
13858,ACGTCGAATCTAGGGA,230,232,2,21,13249,0,0
13859,TCGTCGAATCTAGGGA,230,233,3,21,13250,0,0
13860,ACGTCGAATCTAGGGA,230,233,3,17,13251,0,0
13861,ACGTCGAATCTAGGGA,230,233,3,17,13253,0,0
13862,ACGTCGAATCTAGGGA,230,233,3,21,13254,0,0
13863,ACGTCGAATCTAGGGA,230,233,3,18,13256,0,0
13864,ACGTCGAATCTAGGGA,230,233,3,24,13257,0,0
13865,TCGTCGAATCTAGGGA,230,232,2,22,13261,0,0
13866,ACGTCGAATGTAGGGA,230,232,2,19,13263,0,0
13867,ACGTCGATTCTGGGGA,230,232,2,18,13267,0,0
13868,ACGTCGAATCTAGGGA,230,232,2,19,13269,0,0
13869,TCGTCGAATTTAGGGA,230,232,2,21,13396,0,0
13870,ACGTCGAATCTAGGGA,230,233,3,22,13398,0,0
13871,ACGTCGAATCTAGGGA,230,233,3,15,13405,0,0
13872,ACGTCGAATCTAGGGA,230,233,3,18,13407,0,0
13873,ACGTCGAATCTAGGGA,230,232,2,19,13409,0,0
13874,ACGTCGAATCTAGGGA,230,233,3,21,13412,0,0
13875,ACGACGAATCTAGGGA,230,233,3,23,13413,0,0
13876,TCGTCGAATCTAGGGA,230,230,0,21,13416,0,0
13877,ACGTCGAATCTAGGGA,230,233,3,17,13419,0,0
13878,ACGTCGAATCTAGGGA,231,232,1,20,11028,0,0
13879,ACGTCGAATCTAGGGT,231,237,6,22,11187,0,0
13880,ACGTCGAATCTAGGGA,231,231,0,21,11740,0,0
13881,ACGTCGAATCTAGGGA,231,260,29,20,12232,8,0
13882,ACGTCGAATCTAGGGA,231,239,8,17,12415,1,0
13883,ACGTCGAATCTAGGGA,231,231,0,25,12525,0,0
13884,ACGTCGAATCTAGGGA,231,232,1,22,12527,0,0
13885,ACGTCGAATCTAGGGA,231,239,8,20,12530,1,0
13886,ACGTCGAATCTAGGGA,231,256,25,18,12538,6,0
13887,ACGTCGAATCTAGGGA,231,253,22,15,12541,5,0
13888,TCGTCGAATTTAGGGA,231,232,1,21,12547,0,0
13889,ACGTCGAATCTAGGGA,231,239,8,20,12591,1,0
13890,ACGTCGAATCTAGGGA,231,242,11,17,12623,2,0
13891,ACGTCGAATCTAGGGA,231,233,2,22,12626,0,0
13892,TCGTCGAATCTATGGA,231,239,8,21,12768,1,0
13893,TCGTCGAATCTAGGGA,231,233,2,20,12924,0,0
13894,ACGTCGAATCTAGGGA,231,245,14,16,12929,3,0
13895,ACGTCGAATCTAGGGA,231,238,7,22,12930,0,0
13896,ACGTCGAATCTAGGGA,231,245,14,22,12942,3,0
13897,ACGTCGAATCTAGGGA,231,248,17,23,12945,4,0
13898,ACGTCGAATCTAGGGA,231,232,1,16,13107,0,0
13899,ACGTCGAATCTAGGGA,231,238,7,20,13108,0,0
13900,ACGTCGAATCTAGGGA,231,232,1,15,13109,0,0
13901,ACGTCGAATCTAGGGA,231,246,15,22,13114,3,0
13902,ACGTCGAATCTAGGGA,231,237,6,22,13116,0,0
13903,ACGTCGAATCTAGGGA,231,261,30,26,13125,8,0
13904,ACGTCGAATCTAGGGA,231,242,11,17,13126,2,0
13905,ACGTCGAATCGAGGGA,231,240,9,21,13130,1,0
13906,ACGTCGAATCTAGGGA,231,232,1,21,13131,0,0
13907,ACGTAGCATCTAGGGA,231,239,8,22,13140,1,0
13908,ACGTCGAATCTAGGGA,231,250,19,21,13143,4,0
13909,ACGTAGAATCTAGGGA,231,243,12,19,13146,2,0
13910,ACGTCGAATCTAGGGA,231,237,6,19,13147,0,0
13911,ACGTCGAATCTAGGGA,231,234,3,20,13149,0,0
13912,ACGTCGAATCTAGGGA,231,234,3,23,13152,0,0
13913,ACATCGAATCTAGGGA,231,232,1,22,13153,0,0
13914,ACGTCGAATCTAGGGA,231,233,2,15,13391,0,0
13915,ACGTAGAATCTAGGGA,231,234,3,18,13394,0,0
13916,ACGTCGAATCTAGGGA,231,234,3,16,13461,0,0
13917,ACGTCGAATCTAGGGA,231,232,1,18,13462,0,0
13918,ACGTCGAATCTAGGGA,231,234,3,16,13464,0,0
13919,AAGTCGAATCTATGGA,231,234,3,20,13466,0,0
13920,ACGTCGAATCTAGGGA,231,233,2,20,13467,0,0
13921,ACGTCGAATCGAGGGA,231,231,0,16,13471,0,0
13922,ACGTCGAATCTAGGGA,231,234,3,26,13474,0,0
13923,ACGTAGAATCTAGGGA,232,234,2,17,11921,0,0
13924,ACGTCGAATCTAGGGA,232,249,17,21,12134,4,0
13925,ACGTAGCATCTAGGGA,232,238,6,20,12295,0,0
13926,TCGTCGAATCTAGGGC,232,240,8,21,12309,1,0
13927,ACGTCGAATCTAGGGA,232,232,0,14,12477,0,0
13928,ACGTCGAATCTAGGGA,232,259,27,20,12490,7,0
13929,ACGTCGAATCTAGGGA,232,237,5,18,12511,0,0
13930,ACGTCGAATCTAGGGA,232,260,28,21,12512,7,0
13931,ACGTCGAATCTAGGGA,232,232,0,21,12645,0,0
13932,ACGTCGAATCTAGGGA,232,235,3,22,12656,0,0
13933,ACGTCGAATCTAGGGA,232,238,6,18,12662,0,0
13934,ACGTCGAATCTAGGGA,232,233,1,20,12665,0,0
13935,ACGTCGAATCTAGGGA,232,233,1,20,12824,0,0
13936,ACGTCGAATCTAGGGA,232,258,26,21,12834,7,0
13937,ACGTCGAAACTAGGGA,232,233,1,18,12853,0,0
13938,ACGTCGAATCTAGGGA,232,234,2,21,12857,0,0
13939,ACGTCGAATCTAGGGA,232,246,14,14,12977,3,0
13940,ACGTCGAATCTAGGAA,232,236,4,21,12981,0,0
13941,ACGTCGAATCTAGGGA,232,232,0,22,12989,0,0
13942,ACGTCGAATCTAGGGA,232,235,3,20,12990,0,0
13943,ACGTCGAATCTAGGGA,232,234,2,17,13001,0,0
13944,ACGTCGAATCCAGGGA,232,232,0,17,13002,0,0
13945,ACGTCGAATCTAGGGA,232,233,1,23,13005,0,0
13946,ACGTCGAATCTAGGGA,232,232,0,21,13009,0,0
13947,ACGTCGAATCTAGGGA,232,237,5,18,13010,0,0
13948,ACGTCGAATCTAGGGA,232,233,1,24,13011,0,0
13949,ACGTCGAATCTAGGGA,232,247,15,21,13013,3,0
13950,ACGTCGAATCTAGGGA,232,235,3,23,13016,0,0
13951,ACGTCGAATCTAGGGA,232,235,3,22,13018,0,0
13952,ACGTCGAATGTAGGGA,232,235,3,19,13019,0,0
13953,ACGTCGAATCTAGGGA,232,235,3,21,13168,0,0
13954,ACGTCGAATCTAGGGA,232,235,3,22,13174,0,0
13955,ACGTCGAATCTAGGCA,232,235,3,23,13278,0,0
13956,ACGTCGAATCTAGGGA,232,232,0,19,13281,0,0
13957,ACGTCGAATCTAGGGA,232,235,3,18,13284,0,0
13958,ACGTCGAATCTAGGGA,232,235,3,21,13338,0,0
13959,ACGTCGAATCTAGGGA,232,235,3,21,13340,0,0
13960,ACGTCGAATCTAGGGA,232,235,3,18,13343,0,0
13961,ACGTCGAATCTAGGGA,232,235,3,22,13345,0,0
13962,ACGTCGAATCTAGGGA,232,235,3,17,13351,0,0
13963,ACGTCGAATCTAGGGA,232,235,3,21,13355,0,0
13964,ACGTCGAATCTAGGGA,232,235,3,18,13356,0,0
13965,ACGTCGAATCTAGGGA,232,235,3,21,13359,0,0
13966,ACGTCGAATCTAGGGA,232,235,3,19,13362,0,0
13967,ACGTCGAATCTAGGGA,232,233,1,20,13376,0,0
13968,TCGTCGAATCTAGGGA,232,235,3,21,13377,0,0
13969,ACGTCGAATCTAGGGA,232,234,2,17,13378,0,0
13970,ACGTCGAATCTAGGGA,232,235,3,19,13379,0,0
13971,ACGTCGAATCTAGGGA,232,233,1,17,13382,0,0
13972,ACGTCGAATCTAGGGA,232,235,3,20,13384,0,0
13973,ACGTCGAATCTAGGGA,232,235,3,24,13385,0,0
13974,ACGTCGAATCTAGGGA,232,235,3,16,13387,0,0
13975,ACGTCGAATCTAGGGA,232,233,1,22,13421,0,0
13976,ACGTCGAATCTATGGA,232,235,3,21,13423,0,0
13977,ACGTCGAATCTAGGGA,232,235,3,21,13427,0,0
13978,ACGTCGAATCTAGGGA,232,235,3,22,13431,0,0
13979,ACGTCGAATCTAGGGA,232,235,3,18,13433,0,0
13980,ACGTCGAATCTAGGGA,232,235,3,15,13439,0,0
13981,ACGTCGAATCTAGGGA,232,235,3,23,13444,0,0
13982,ACGTCGAATCTAGGGA,232,235,3,21,13513,0,0
13983,ACGTCGAATCTAGGGA,232,235,3,23,13514,0,0
13984,ACGTCGAATCTAGGGA,232,235,3,17,13515,0,0
13985,ACGTCGAATCTAGGGA,232,235,3,22,13519,0,0
13986,ACGTCGAATCTAGGGA,232,232,0,17,13522,0,0
13987,ACGTCGAATCTAGGGA,232,235,3,21,13523,0,0
13988,ACGTCGAATCTAGGGA,232,235,3,23,13524,0,0
13989,ACGTCGAATCTAGGGA,232,235,3,16,13531,0,0
13990,ACGTCGAATCTAGGGA,232,235,3,18,13534,0,0
13991,ACGTCGAATCTAGGGA,232,235,3,21,13535,0,0
13992,ACGTCGAATCTAGGGA,232,233,1,21,13536,0,0
13993,ACGTCGAATCTAGGGA,232,235,3,23,13538,0,0
13994,ACGTCGAATCTAGGGA,232,233,1,17,13542,0,0
13995,ACGTCGAATCTAGGGA,232,235,3,23,13543,0,0
13996,ACGTCGAATCTAGGGA,232,235,3,21,13545,0,0
13997,ACGTCGAATCTAGGGA,232,235,3,24,13548,0,0
13998,ACGTCGAATCTAGGGA,232,233,1,17,13553,0,0
13999,ACGTCGAATCTAGGGA,232,233,1,23,13554,0,0
14000,ACGTCGAATCTAGGGA,233,236,3,15,10570,0,0
14001,ACGTCGAATCTAGGGA,233,237,4,17,11273,0,0
14002,ACGTCGAATCTAGGGA,233,234,1,15,11819,0,0
14003,ACGTCGAATCTAGGGA,233,238,5,21,11847,0,0
14004,ACGTCGAATCTAGGGA,233,234,1,25,12005,0,0
14005,ACGTCGAATCTAGGGA,233,237,4,16,12268,0,0
14006,ACGTTGAATCTAGGGA,233,247,14,22,12362,3,0
14007,ACGTCGAATCTAGGGA,233,236,3,20,12373,0,0
14008,ACGTCGAATCTAGGGA,233,252,19,21,12706,4,0
14009,ACGTCGAATCTAGGGA,233,239,6,21,12729,0,0
14010,ACGTCGAATCTAGGGA,233,237,4,16,12731,0,0
14011,ACGTCGAATCTAGGGA,233,234,1,20,12745,0,0
14012,ACGTCGAATCTAGGGA,233,245,12,21,12884,2,0
14013,ACGTCGAATGTAGGGA,233,233,0,18,12885,0,0
14014,ACGTCGAATCTAGGGA,233,235,2,16,12890,0,0
14015,ACGTCGAATCTAGGGA,233,240,7,22,12895,0,0
14016,ACGTCGAATCTAGGGA,233,237,4,22,12896,0,0
14017,ACGTCGAATCTAGGGA,233,258,25,21,12898,6,0
14018,ACGTCGAATCTAGGGA,233,234,1,21,13045,0,0
14019,ACGTCGAATCTAGGGA,233,247,14,22,13056,3,0
14020,ACGTCGAATCTAGGGA,233,239,6,21,13215,0,0
14021,ACGTCGAATGTAGGGA,233,236,3,18,13217,0,0
14022,TCGTCGAATTTAGGGA,233,234,1,21,13222,0,0
14023,ACGTCGAATCTAGGGA,233,243,10,20,13231,1,0
14024,ACGTCGAATCTAGGGA,233,233,0,15,13234,0,0
14025,ACGTCGAATCTAGGGA,233,246,13,18,13236,2,0
14026,ACGTCGATTCTAGGGA,233,252,19,18,13237,4,0
14027,ACGTCGAATCCAGGGA,233,245,12,17,13243,2,0
14028,ACGTCGAATCTAGGGA,233,235,2,19,13248,0,0
14029,ACGTCGAATCTAGGGA,233,239,6,21,13249,0,0
14030,TCGTCGAATCTAGGGA,233,233,0,21,13250,0,0
14031,ACGTCGAATCTAGGGA,233,237,4,17,13253,0,0
14032,ACGTCGAATCTAGGGA,233,264,31,21,13254,8,0
14033,ACGTCGAATCTAGGGA,233,236,3,18,13256,0,0
14034,TCGTCGAATCTAGGGA,233,233,0,22,13261,0,0
14035,ACGTCGAATGTAGGGA,233,234,1,19,13263,0,0
14036,ACGTCGATTCTGGGGA,233,234,1,18,13267,0,0
14037,ACGTCGAATCTAGGGA,233,233,0,19,13269,0,0
14038,TCGTCGAATTTAGGGA,233,245,12,21,13396,2,0
14039,ACGTCGAATCTAGGGA,233,279,46,22,13398,13,0
14040,ACGTCGAATCTAGGGA,233,245,12,15,13405,2,0
14041,ACGTCGAATCTAGGGA,233,240,7,21,13412,0,0
14042,ACGTCGAATCTAGGGA,233,249,16,23,13413,3,0
14043,ACGTCGAATCTAGGGA,233,233,0,17,13419,0,0
14044,ACGTCGAATCTAGGGA,233,233,0,15,13573,0,0
14045,ACGTCGAATCTATGGA,233,235,2,21,13579,0,0
14046,ACGTCGAATCTAGGGA,234,236,2,17,12415,0,0
14047,ACGTCGAATCTAGGGA,234,249,15,18,12538,4,0
14048,ACGTCGAATCTAGGGA,234,248,14,15,12541,3,0
14049,TCGTCGAATTTAGGGA,234,252,18,21,12547,5,0
14050,ACGTCGAATCTAGGGA,234,243,9,20,12591,2,0
14051,ACGTCGAATCTAGGGA,234,238,4,17,12623,0,0
14052,TCGTCGAATCTAGGGA,234,256,22,20,12924,6,0
14053,ACGTCGAATCTAGGGA,234,247,13,16,12929,2,0
14054,ACGTCGAATCTAGGGA,234,249,15,22,12930,3,0
14055,ACGTCGAATCTAGGGA,234,236,2,22,12942,0,0
14056,ACGTCGAATCTAGGGA,234,243,9,23,12945,1,0
14057,ACGTCGAATCTAGGGA,234,240,6,16,13107,0,0
14058,ACGTCGAATCTAGGGA,234,245,11,20,13108,2,0
14059,ACGTCGAATCTAGGGA,234,249,15,15,13109,3,0
14060,ACGTCGAATCTAGGGA,234,234,0,22,13116,0,0
14061,ACGTCGAATCTAGGGA,234,237,3,26,13125,0,0
14062,ACGTCGAATCTAGGGA,234,234,0,17,13126,0,0
14063,ACGTCGAATCGAGGGA,234,236,2,21,13130,0,0
14064,ACGTCGAATCTAGGGA,234,234,0,21,13131,0,0
14065,ACGTAGCATCTAGGGA,234,244,10,22,13140,1,0
14066,ACGTAGAATCTAGGGA,234,252,18,19,13146,4,0
14067,ACGTCGAATCTAGGGA,234,255,21,19,13147,5,0
14068,ACGTCGAATCTAGGGA,234,270,36,20,13149,10,0
14069,ACGTCGAATCTAGGGA,234,235,1,23,13152,0,0
14070,ACGTCGAATCTAGGGA,234,246,12,22,13153,2,0
14071,ACGTCGAATCTAGGGA,234,243,9,15,13391,1,0
14072,ACGTAGAATCTAGGGA,234,250,16,18,13394,3,0
14073,ACGTCGAATCTAGGGA,234,256,22,16,13461,5,0
14074,ACGTCGAATCTAGGGA,234,241,7,18,13462,0,0
14075,ACGTCGAATCTAGGGA,234,238,4,16,13464,0,0
14076,AAGTCGAATCTATGGA,234,235,1,20,13466,0,0
14077,ACGTCGAATCTAGGGA,234,262,28,20,13467,7,0
14078,ACGTCGAATCGAGGGA,234,234,0,16,13471,0,0
14079,ACGTCGAATCTAGGGA,234,294,60,26,13474,18,0
14080,ACGTCGAATCTAGGGA,234,234,0,23,13556,0,0
14081,ACGTTTAATCTAGGGA,234,235,1,23,13557,0,0
14082,ACGTCGAATCTAGGGA,234,236,2,27,13559,0,0
14083,ACGTCGAATCGAGGGA,234,246,12,22,13562,2,0
14084,ACGTCGAATCTAGGGA,234,286,52,22,13563,15,0
14085,ACGTAGCATCTAGGGA,234,238,4,23,13564,0,0
14086,ACGTCGAATCTAGGGA,234,244,10,17,13569,1,0
14087,ACGTCGAATCTAGGGA,234,234,0,24,13571,0,0
14088,ACGTCGAATCTAGGGA,234,259,25,20,13640,6,0
14089,ACGTCGAATCTAGGGA,234,245,11,26,13641,2,0
14090,ACGTCGAATCTAGGGA,234,242,8,21,13642,1,0
14091,ACGTCGAATCTAGGGA,234,239,5,16,13646,0,0
14092,ACGTTGAATCTAGGGA,234,237,3,23,13647,0,0
14093,ACGTCGAATCTAGGGA,234,237,3,20,13656,0,0
14094,ACGTCGAATCTAGGGA,234,237,3,21,13658,0,0
14095,ACGTCGAATCGAGGGA,234,235,1,16,13659,0,0
14096,ACGTCGAATCTAGGGA,234,234,0,22,13660,0,0
14097,ACGTCGAATGTAGGGA,234,236,2,19,13661,0,0
14098,ACGTCGAATCTAGGGA,234,237,3,23,13671,0,0
14099,ACGTCGAATCTAGGGA,234,237,3,22,13672,0,0
14100,ACGTCGAATGTAGGGA,234,237,3,19,13673,0,0
14101,ACGTAGAATCTAGGGA,234,234,0,19,13674,0,0
14102,ACGTCGAATCTAGGGA,234,237,3,21,13678,0,0
14103,ACGTCGAATCTAGGGA,234,237,3,19,13681,0,0
14104,ACGTCGAATCTAGGGA,234,237,3,23,13683,0,0
14105,ACGTAGAATCTAGGGA,235,243,8,17,11921,1,0
14106,ACGTCGAATCTAGGGA,235,242,7,21,12134,0,0
14107,ACGTAGCATCTAGGGA,235,244,9,20,12295,1,0
14108,TCGTCGAATCTAGGGA,235,236,1,21,12309,0,0
14109,ACGTCGAATCTAGGGA,235,254,19,20,12490,4,0
14110,ACGTCGAATCTAGGGA,235,248,13,18,12511,2,0
14111,ACGTCGAATCTAGGGA,235,243,8,21,12512,1,0
14112,ACGTCGAATCTAGGGA,235,244,9,21,12645,1,0
14113,ACGTCGAATCTAGGGA,235,252,17,22,12656,4,0
14114,ACGTCGAATCTAGGGA,235,238,3,18,12662,0,0
14115,ACGTCGAATCTAGGGA,235,263,28,20,12665,7,0
14116,ACGTCGAATCTAGGGA,235,241,6,20,12824,0,0
14117,ACGTCGAATCTAGGGA,235,236,1,18,12853,0,0
14118,ACGTCGAATCTAGGGA,235,235,0,21,12857,0,0
14119,ACGTCGAATCTAGGGA,235,240,5,14,12977,0,0
14120,ACGTCGAATCTAGGGA,235,235,0,21,12981,0,0
14121,ACGTCGAATCTAGGGA,235,238,3,20,12990,0,0
14122,ACGTCGAATCTAGGGA,235,235,0,17,13001,0,0
14123,ACGTCGAATCTAGGGA,235,238,3,21,13009,0,0
14124,ACGTCGAATCTAGGGA,235,235,0,24,13011,0,0
14125,ACGTCGAATCTAGGGA,235,238,3,23,13016,0,0
14126,ACGTCGAATCTAGGGA,235,238,3,22,13018,0,0
14127,ACGTCGAATGTAGGGA,235,238,3,19,13019,0,0
14128,ACGTCGAATCTAGGGA,235,237,2,21,13168,0,0
14129,ACGTCGAATCTAGGGA,235,238,3,22,13174,0,0
14130,ACGTCGAATCTAGGGA,235,238,3,23,13278,0,0
14131,ACGTCGAATCTAGGGA,235,238,3,19,13281,0,0
14132,ACGTCGAATCTAGGGA,235,238,3,18,13284,0,0
14133,ACGTCGAATCTAGGGA,235,238,3,21,13340,0,0
14134,ACGTCGAATCTAGGGA,235,235,0,22,13345,0,0
14135,ACGTCGAATCTAGGGA,235,235,0,17,13351,0,0
14136,ACGTCGAATCTAGGGA,235,238,3,21,13355,0,0
14137,ACGACGAATCTAGGGA,235,238,3,18,13356,0,0
14138,ACGTCGAATCTAGGGA,235,237,2,21,13359,0,0
14139,ACGTCGAATCTAGGGA,235,238,3,19,13362,0,0
14140,ACGTCGAATCTAGGGA,235,238,3,20,13376,0,0
14141,ACGTCGAATCTAGGGA,235,238,3,19,13379,0,0
14142,ACGTCGAATCTAGGGA,235,238,3,17,13382,0,0
14143,ACGTCGAATCTAGGGG,235,238,3,20,13384,0,0
14144,ACGTCGAATCTAGGGA,235,238,3,24,13385,0,0
14145,ACGTCGAATCTAGGGA,235,238,3,16,13387,0,0
14146,ACGTCGAATCTAGGGA,235,238,3,22,13421,0,0
14147,ACGTCGAATCTATGGA,235,238,3,21,13423,0,0
14148,ACGTCGAATCTAGGGA,235,238,3,18,13433,0,0
14149,ACGTCGAATCTAGGGA,235,237,2,15,13439,0,0
14150,ACGTCGAATCTAGGGA,235,238,3,23,13514,0,0
14151,ACGTCGAATCTAGGGA,235,238,3,22,13519,0,0
14152,ACGTCGAATCTAGGGA,235,238,3,17,13522,0,0
14153,ACGTCGAATCTAGGGA,235,238,3,23,13524,0,0
14154,ACGTCGAATCTAGGGA,235,238,3,16,13531,0,0
14155,ACGTCGAATCTAGGGA,235,238,3,18,13534,0,0
14156,ACGTCGAATCTAGGGA,235,238,3,23,13538,0,0
14157,ACGTCGAATCTAGGGA,235,238,3,23,13543,0,0
14158,ACGTCGAATCTAGGGA,235,236,1,17,13553,0,0
14159,ACGTCGAATCTAGGGA,235,237,2,23,13554,0,0
14160,ACGTCGAATCTAGGGA,235,238,3,21,13702,0,0
14161,ACGTCGAATCTAGGGA,235,238,3,23,13703,0,0
14162,ACGTCGAATCTAGGGA,235,238,3,22,13705,0,0
14163,ACGTCGAATCTAGGGA,235,238,3,21,13706,0,0
14164,ACGTCGAATCTAGGGA,235,238,3,21,13708,0,0
14165,ACGTCGAATCTAGGGA,235,238,3,23,13711,0,0
14166,ACGTCGAATCTAGGGA,235,238,3,21,13712,0,0
14167,TCGTCGAATCTATTGA,235,238,3,22,13719,0,0
14168,ACGTCGAATCTAGGGA,235,238,3,21,13723,0,0
14169,ACGTCGAATCTAGGGA,235,238,3,23,13724,0,0
14170,ACGTCGAATCTAGGGA,235,238,3,19,13726,0,0
14171,ACGTCGAATCTAGGGA,235,235,0,21,13728,0,0
14172,ACGTCGAATCTAGGGA,236,236,0,15,10570,0,0
14173,ACGTCGAATCTAGGGA,236,240,4,17,11273,0,0
14174,ACGTCGAATCTAGGGA,236,246,10,15,11819,1,0
14175,ACGTCGAATCTAGGGA,236,238,2,21,11847,0,0
14176,ACGTCGAATCTAGGGA,236,236,0,16,12268,0,0
14177,ACGTTGAATCTAGGGA,236,256,20,22,12362,5,0
14178,ACGTCGAATCTAGGGA,236,239,3,20,12373,0,0
14179,ACGTCGAATCTAGGGA,236,262,26,21,12706,7,0
14180,GCGTCGAATCTAGGGA,236,239,3,16,12731,0,0
14181,ACGTCGAATCTAGGGA,236,244,8,20,12745,1,0
14182,ACGTCGAATCTAGGGA,236,239,3,21,12884,0,0
14183,ACGTCGAATCTAGGGA,236,250,14,16,12890,3,0
14184,ACGTCGAATCTAGGGA,236,240,4,21,12898,0,0
14185,ACGTCGAATCTAGGGA,236,238,2,21,13045,0,0
14186,ACGTCGAATGTAGGGA,236,249,13,18,13217,2,0
14187,TCGTCGAATTTAGGGA,236,241,5,21,13222,0,0
14188,ACGTCGAATCTAGGGA,236,238,2,15,13234,0,0
14189,ACGTCGAATCTAGGGA,236,239,3,18,13236,0,0
14190,ACGTCGATTCTAGGGA,236,253,17,18,13237,4,0
14191,ACGTCGAATCCAGGGA,236,237,1,17,13243,0,0
14192,ACGTCGAATCTAGGGA,236,238,2,19,13248,0,0
14193,ACGTCGAATCTAGGGA,236,244,8,21,13249,1,0
14194,TCGTCGAATCTAGGGA,236,239,3,21,13250,0,0
14195,ACGTCGAATCTAGGGA,236,237,1,17,13253,0,0
14196,ACGTCGAATCTAGGGA,236,252,16,18,13256,3,0
14197,ACGTCGAATGTAGGGA,236,242,6,19,13263,0,0
14198,ACGTCGATTCTGGGGA,236,236,0,18,13267,0,0
14199,ACGTCGAATCTAGGGA,236,238,2,19,13269,0,0
14200,TCGTCGAATTTAGGGA,236,244,8,21,13396,1,0
14201,ACGTCGAATCTAGGGA,236,244,8,21,13412,1,0
14202,ACGTCGAATCTAGGGA,236,239,3,23,13413,0,0
14203,ACGTCGAATCTAGGGA,236,245,9,17,13419,1,0
14204,ACGTCGAATCTAGGGA,236,239,3,15,13573,0,0
14205,ACGTCGAATCTAGGGA,236,252,16,18,13689,3,0
14206,ACGTCGAATCTAGGGA,236,239,3,22,13691,0,0
14207,ACGTCGAATCTAGGGA,236,253,17,22,13697,4,0
14208,ACGTCTAATCTAGGGA,236,245,9,15,13750,1,0
14209,TCGTCGAATCTAGGGA,236,267,31,22,13756,8,0
14210,ACGTCGAATCTAGGGA,236,247,11,15,13757,2,0
14211,ACGTCGAATCTAGGGA,236,248,12,21,13758,2,0
14212,ACGTCGAATCTAGGGA,236,259,23,23,13762,6,0
14213,ACGTCGAATCTAGGGA,236,244,8,21,13764,1,0
14214,ACGTCGAATCTAGGGA,236,251,15,24,13766,3,0
14215,ACGTCGAATGTAGGGA,236,236,0,19,13768,0,0
14216,ACGTCGAATCTAGGGA,236,238,2,21,13769,0,0
14217,ACGTCGATTCTAGGGA,236,240,4,19,13770,0,0
14218,ACGTCGAATCTGGGGA,236,238,2,18,13773,0,0
14219,ACGTCGAATCTAGGGA,236,247,11,15,13776,2,0
14220,ACGTCGAATCTAGGGA,236,250,14,22,13777,3,0
14221,ACGTCGAATCTAGGGA,236,240,4,23,13778,0,0
14222,ACGTCGAATCTAGGGA,236,236,0,21,13779,0,0
14223,ACGTCGAATCTAGGGA,237,240,3,17,12415,0,0
14224,ACGTCGAATCTAGGGA,237,239,2,18,12538,0,0
14225,ACGTCGAATCTAGGGA,237,288,51,15,12541,15,0
14226,TCGTCGAATTTAGGGA,237,241,4,21,12547,0,0
14227,ACGTCGAATCTAGGGA,237,244,7,20,12591,0,0
14228,ACGTCGAATCTAGGGA,237,247,10,17,12623,1,0
14229,TCGTCGAATCTAGGGA,237,237,0,20,12924,0,0
14230,ACGTCGAATCTAGGGA,237,245,8,16,12929,1,0
14231,ACGTCGAATCTAGGGA,237,245,8,22,12930,1,0
14232,ACGTCGAATCTAGGGA,237,242,5,22,12942,0,0
14233,ACGTCGAATCTAGGGA,237,243,6,20,13108,0,0
14234,ACGTCGAATCTAGGGA,237,249,12,15,13109,2,0
14235,ACGTCGAATCTAGGGA,237,249,12,22,13116,2,0
14236,ACGTCGAATCTAGGGA,237,245,8,26,13125,1,0
14237,ACGTCGAATCTAGGGA,237,237,0,17,13126,0,0
14238,ACGTCGAATCGAGGGA,237,259,22,21,13130,5,0
14239,ACGTCGAATCTAGGGA,237,251,14,21,13131,3,0
14240,ACGTAGCATCTAGGGA,237,239,2,22,13140,0,0
14241,ACGTAGAATCTAGGGA,237,253,16,19,13146,3,0
14242,ACGTCGAATCTAGGGA,237,255,18,19,13147,4,0
14243,ACGTCGAATCTAGGGA,237,261,24,20,13149,6,0
14244,ACGTCGAATCTAGGGA,237,243,6,22,13153,0,0
14245,ACGTCGAATCTAGGGA,237,247,10,15,13391,1,0
14246,ACGTAGAATCTAGGGA,237,249,12,18,13394,2,0
14247,ACGTCGAATCTAGGGA,237,259,22,18,13462,5,0
14248,ACGTCGAATCTAGGGA,237,237,0,16,13464,0,0
14249,AAGTCGAATCTATGGA,237,239,2,20,13466,0,0
14250,ACGTCGAATCTAGGGA,237,241,4,20,13467,0,0
14251,ACGTCGAATCGAGGGA,237,287,50,16,13471,14,0
14252,ACGTCGAATCTAGGGA,237,238,1,23,13556,0,0
14253,ACGTTTAATCTAGGGA,237,242,5,23,13557,0,0
14254,ACGTCGAATCGAGGGA,237,254,17,22,13562,3,0
14255,ACGTCGAATCTAGGGA,237,252,15,17,13569,2,0
14256,ACGTCGAATCTAGGGA,237,245,8,24,13571,0,0
14257,ACGTCGAATCTAGGGA,237,240,3,21,13642,0,0
14258,ACGTTGAATCTAGGGA,237,240,3,23,13647,0,0
14259,ACGTCGAATCTAGGGA,237,240,3,20,13656,0,0
14260,ACGTCGAATCTAGGGA,237,257,20,21,13658,4,0
14261,ACGTCGAATCGAGGGA,237,240,3,16,13659,0,0
14262,ACGTCGAATCTAGGGA,237,240,3,22,13660,0,0
14263,ACGTCGAATGTAGGGA,237,240,3,19,13661,0,0
14264,ACGTCGAATCTAGGGA,237,240,3,23,13671,0,0
14265,ACGTCGAATGTAGGGA,237,240,3,19,13673,0,0
14266,ACGTAGAATCTAGGGA,237,240,3,19,13674,0,0
14267,ACGTCGAATCTAGGGA,237,240,3,19,13681,0,0
14268,ACGTCGAATCTAGGGA,237,240,3,23,13683,0,0
14269,ACGTCGAATCTATGGA,237,240,3,20,13819,0,0
14270,ACGTCGAATCTAGGGA,237,240,3,20,13820,0,0
14271,ACGTCGAATCTAGGGA,237,240,3,21,13824,0,0
14272,ACGTCGAATCTAGGGA,237,240,3,21,13829,0,0
14273,ACGTCGAATCTAGGGA,237,240,3,21,13830,0,0
14274,ACGTCGAATCTAGGGA,237,240,3,17,13833,0,0
14275,ACGTCGAATCTAGGGA,237,240,3,19,13834,0,0
14276,ACGTCGAATCTAGGGA,237,239,2,21,13835,0,0
14277,ACGTCGAATCTAGGGA,237,240,3,22,13836,0,0
14278,ACGTCGAATCTAGGGA,237,240,3,17,13838,0,0
14279,ACGTCGAATCTAGGGA,237,240,3,23,13840,0,0
14280,ACGTCGAATCTAGGGA,237,239,2,22,13841,0,0
14281,ACGTCGAATCTAGGGA,237,240,3,22,13843,0,0
14282,ACGTCGAATGTAGGGA,237,240,3,19,13844,0,0
14283,ACGTCGAATCTAGGGA,237,239,2,23,13845,0,0
14284,ACGTCGAATCTAGGGA,237,239,2,23,13846,0,0
14285,TCGTCGAATCTAGGGA,237,240,3,23,13851,0,0
14286,ACGTCGAATCTAGGGA,237,240,3,21,13852,0,0
14287,ACGTAGAATCTAGGGA,238,239,1,17,11921,0,0
14288,ACGTAGCATCTAGGGA,238,242,4,20,12295,0,0
14289,TCGTCGAATCTAGGGA,238,246,8,21,12309,1,0
14290,ACGTCGAATCTAGGGA,238,248,10,18,12511,1,0
14291,ACGTCGAATCTAGGGA,238,245,7,21,12645,0,0
14292,ACGTCGAATCTAGGGA,238,253,15,18,12662,3,0
14293,ACGTCGAATCTAGGGA,238,254,16,20,12665,3,0
14294,ACGTCGAATCTAGGGA,238,260,22,20,12824,5,0
14295,ACGTCGAATCTAGGGA,238,268,30,18,12853,8,0
14296,ACGTCGAATTTAGGGA,238,238,0,14,12977,0,0
14297,ACGTCGAATCTAGGGA,238,258,20,21,13009,5,0
14298,ACGTCGAATCTAGGGA,238,247,9,24,13011,1,0
14299,ACGTCGAATCTAGGGA,238,240,2,22,13018,0,0
14300,ACGTCGAATGTAGGGA,238,246,8,19,13019,1,0
14301,ACGTCGAATCTAGGGA,238,248,10,21,13168,1,0
14302,ACGTCGAATCTAGGGA,238,246,8,22,13174,1,0
14303,ACGTCGAATCTAGGGA,238,251,13,23,13278,2,0
14304,ACGTCGAATCTAGGGA,238,239,1,18,13284,0,0
14305,ACGTCGAATCTAGGGA,238,263,25,21,13340,6,0
14306,ACGTCGAATCTAGGGA,238,248,10,22,13345,1,0
14307,ACGTCGAATCTAGGGA,238,249,11,17,13351,1,0
14308,ACGTCGAATCTAGGGA,238,244,6,21,13355,0,0
14309,ACGTCGAATCTAGGGA,238,254,16,18,13356,3,0
14310,ACGTCGAATCTAGGGA,238,251,13,21,13359,2,0
14311,ACGTCGAATCTAGGGA,238,246,8,19,13362,0,0
14312,ACGTCGAATCTAGGGA,238,244,6,20,13376,0,0
14313,ACGTCGAATCTAGGGA,238,242,4,19,13379,0,0
14314,ACGTCGAATCTAGGGA,238,241,3,17,13382,0,0
14315,ACGTCGAATCTAGGGA,238,241,3,20,13384,0,0
14316,ACGTCGAATCTAGGGA,238,239,1,24,13385,0,0
14317,ACGTCGAATCTAGGGA,238,238,0,16,13387,0,0
14318,ACGTCGAATCTATGGA,238,239,1,21,13423,0,0
14319,ACGTCGAATCTAGGGA,238,241,3,18,13433,0,0
14320,ACGTCGAATCTAGGGA,238,241,3,15,13439,0,0
14321,ACGTCGAATTTAGGGA,238,241,3,23,13514,0,0
14322,ACGTCGAATCTAGGGA,238,240,2,23,13524,0,0
14323,ACGTCGAATCTAGGGA,238,240,2,16,13531,0,0
14324,ACGTCGAATCTAGGGA,238,241,3,18,13534,0,0
14325,ACGTCGAATCTAGGGA,238,241,3,23,13538,0,0
14326,ACGTCGAATCTAGGGA,238,240,2,23,13543,0,0
14327,ACGTCGAATCTAGGGA,238,241,3,17,13553,0,0
14328,ACGTCGAATCTAGGGA,238,241,3,23,13554,0,0
14329,ACGTCGAATCTAGGGA,238,241,3,21,13702,0,0
14330,ACGTCGAATCTAGGGA,238,240,2,23,13703,0,0
14331,ACGTCGAATCTAGGGA,238,241,3,22,13705,0,0
14332,ACGTCGAATCTAGGGA,238,241,3,21,13708,0,0
14333,ACGTCGAATCTAGGGA,238,241,3,23,13711,0,0
14334,TCGTCGAATCTATTGA,238,241,3,22,13719,0,0
14335,ACGTCGAATCTAGGGA,238,238,0,23,13724,0,0
14336,ACGTCGAATCTAGGGA,238,241,3,21,13728,0,0
14337,ACGTCGAATCTAGGGA,238,241,3,22,13783,0,0
14338,ACGTCGAATCTAGGGA,238,241,3,23,13786,0,0
14339,ACGTCGAATCTAGGGA,238,241,3,22,13787,0,0
14340,ACGTCGAATCTAGGGA,238,240,2,24,13788,0,0
14341,ACGTCGAATCTAGGGA,238,241,3,21,13881,0,0
14342,ACGTCGAATCTAGGGA,238,241,3,18,13882,0,0
14343,ACGTCCAATCTAGGGA,238,238,0,21,13885,0,0
14344,ACGTCGAATCTAGGGA,238,240,2,19,13886,0,0
14345,ACGTCGAATCTAGGGA,238,241,3,16,13887,0,0
14346,ACGTCGAATCTAGGGA,238,241,3,21,13889,0,0
14347,ACGTCGAATCTAGGGA,238,240,2,18,13890,0,0
14348,TCGTCGAATCTATGGA,238,241,3,22,13892,0,0
14349,ACGTCGAATCTAGGGA,238,240,2,17,13894,0,0
14350,ACGTCGAATCAAGGGA,238,241,3,23,13896,0,0
14351,ACGTCGAATCTAGGGA,238,240,2,24,13897,0,0
14352,ACGTCGAATCTAGGGA,238,241,3,23,13901,0,0
14353,ACGTCGAATCTAGGGA,238,241,3,27,13903,0,0
14354,ACGTCGAATCTAGGGA,238,241,3,18,13904,0,0
14355,ACGTCGAATCGAGGGA,238,241,3,22,13905,0,0
14356,ACGTAGCATCTAGGGA,238,241,3,23,13907,0,0
14357,ACGTCGAATCTAGGGA,238,239,1,22,13908,0,0
14358,ACGTAGAATCTAGGGA,238,241,3,20,13909,0,0
14359,ACGTCGAATCTAGGGA,239,246,7,15,10570,0,0
14360,ACGTCGAATCTAGGGA,239,242,3,17,11273,0,0
14361,ACGTCGAATCTAGGGA,239,239,0,15,11819,0,0
14362,ACGTCGAATCTAGGGA,239,241,2,16,12268,0,0
14363,ACGTCGAATCTAGGGA,239,242,3,20,12373,0,0
14364,ACGTCGAATCTAGGGA,239,241,2,21,12706,0,0
14365,ACGTCGAATCTAGGGA,239,253,14,16,12731,3,0
14366,ACGTCGAATCTAGGGA,239,267,28,20,12745,7,0
14367,ACGTCGAATCTAGGGA,239,239,0,21,12884,0,0
14368,ACGTCGAATCTAGGGA,239,249,10,16,12890,1,0
14369,ACGTCGAATCTAGGGA,239,243,4,21,12898,0,0
14370,ACGTCGAATGTAGGGA,239,242,3,18,13217,0,0
14371,ACGTCGAATCTAGGGA,239,251,12,15,13234,2,0
14372,ACGTCGAATCTAGGGA,239,240,1,18,13236,0,0
14373,ACGTCGATTCTAGGGA,239,245,6,18,13237,0,0
14374,ACGTCGAATCCAGGGA,239,240,1,17,13243,0,0
14375,ACGTCGAATCTAGGGA,239,240,1,19,13248,0,0
14376,ACGTCGAATCTAGGGA,239,243,4,21,13249,0,0
14377,TCGTCGAATCTAGGGA,239,242,3,21,13250,0,0
14378,ACGTCGAATCTAGGGA,239,243,4,18,13256,0,0
14379,ACGTCGAATGTAGGGA,239,253,14,19,13263,3,0
14380,ACGTCGATTCTGGGGA,239,241,2,18,13267,0,0
14381,TCGTCGAATTTAGGGA,239,246,7,21,13396,0,0
14382,ACGTCGAATCTAGGGA,239,260,21,17,13419,5,0
14383,ACGTCGAATCTAGGGA,239,239,0,15,13573,0,0
14384,ACGTCGAATCTAGGGA,239,251,12,18,13689,2,0
14385,ACGTCGAATCTAGGGA,239,245,6,22,13691,0,0
14386,ACGTCGAATCTAGGGA,239,242,3,15,13750,0,0
14387,TCGTCGAATCTAGGGA,239,243,4,22,13756,0,0
14388,ACGTCGAATCTAGGGA,239,270,31,15,13757,8,0
14389,ACGTCGAATCTAGGGA,239,249,10,21,13758,1,0
14390,ACGTCGAATCTAGGGA,239,247,8,21,13764,1,0
14391,ACGTCGAATGTAGGGA,239,240,1,19,13768,0,0
14392,ACGTCGAATCTAGGGA,239,252,13,21,13769,2,0
14393,ACGTCGAATCTGGGGA,239,254,15,18,13773,3,0
14394,ACGTCGAATCTAGGGA,239,253,14,15,13776,3,0
14395,ACGTCGAATCTAGGGA,239,240,1,22,13777,0,0
14396,ACGTCGAATCTAGGGA,239,249,10,23,13778,1,0
14397,ACGTCGAATCTAGGGA,239,239,0,22,13924,0,0
14398,TCGTCGAATCTAGGGC,239,246,7,22,13926,0,0
14399,ACGTCGAATCTAGGGA,239,257,18,21,13928,3,0
14400,ACGTCGAATCTAGGGA,239,240,1,22,13930,0,0
14401,ACGTCGAATCTAGGGA,239,244,5,22,13936,0,0
14402,ACGTCGAATCTAGGGA,239,246,7,15,13939,0,0
14403,ACGTCGAATCTAGGGT,239,252,13,22,13949,2,0
14404,ACGTCGAATCTAGGGA,239,262,23,19,14047,5,0
14405,ACGTCGAATCTAGGGA,239,241,2,16,14048,0,0
14406,TCGTCGAATTTAGGGA,239,253,14,22,14049,2,0
14407,ACGTCGAATCTAGGGA,239,252,13,21,14050,2,0
14408,TCGTCGAATCTAGGGA,239,245,6,21,14052,0,0
14409,ACGTCGAATCTAGGGA,240,259,19,17,12415,4,0
14410,ACGTCGAATCTAGGGA,240,246,6,18,12538,0,0
14411,ACGTCGAATCTAGGGA,240,241,1,15,12541,0,0
14412,ACGTCGAATCTAGGGA,240,243,3,20,12591,0,0
14413,ACGTCGAATCTAGGGA,240,242,2,17,12623,0,0
14414,TCGTCGAATCTAGGGA,240,243,3,20,12924,0,0
14415,ACGTCGAATCTAGGGA,240,243,3,16,12929,0,0
14416,ACGTCGAATCTAGGGA,240,240,0,22,12942,0,0
14417,ACGTCGAATCTAGGGA,240,243,3,20,13108,0,0
14418,ACGTCGAATCTAGGGA,240,241,1,15,13109,0,0
14419,ACGTCGAATCTAGGGA,240,243,3,26,13125,0,0
14420,ACGTCGAATCTAGGGA,240,243,3,17,13126,0,0
14421,ACGTCGAATCGAGGGA,240,243,3,21,13130,0,0
14422,ACGTAGCATCTAGGGA,240,243,3,22,13140,0,0
14423,ACGTAGAATCTAGGGA,240,242,2,19,13146,0,0
14424,ACGTCGAATCTAGGGA,240,243,3,19,13147,0,0
14425,ACGTCGAATCTAGGGA,240,241,1,20,13149,0,0
14426,ACGTCGAATCTAGGGA,240,242,2,22,13153,0,0
14427,ACGTCGAATCTAGGGA,240,240,0,15,13391,0,0
14428,ACGTAGAATCTAGGGA,240,243,3,18,13394,0,0
14429,ACGTCGAATCTAGGGA,240,241,1,18,13462,0,0
14430,ACGTCGAATCTAGGGA,240,243,3,16,13464,0,0
14431,AAGTCGAATCTATGGA,240,243,3,20,13466,0,0
14432,ACGTCGAATCTAGGGA,240,243,3,20,13467,0,0
14433,ACGTCGAATCGAGGGA,240,243,3,16,13471,0,0
14434,ACGTCGAATCTAGGGA,240,242,2,23,13556,0,0
14435,ACGTTTAATCTAGGGA,240,243,3,23,13557,0,0
14436,ACGTCGAATCTAGGGA,240,240,0,17,13569,0,0
14437,ACGTCGAATCTAGGGA,240,243,3,21,13642,0,0
14438,ACGTTGAATCTAGGGA,240,243,3,23,13647,0,0
14439,ACGTCGAATCTAGGGA,240,243,3,20,13656,0,0
14440,ACGTCGAATCGAGGGA,240,242,2,16,13659,0,0
14441,ACGTCGAATCTAGGGA,240,243,3,22,13660,0,0
14442,ACGTCGAATGTAGGGA,240,243,3,19,13661,0,0
14443,ACGTCGAATCTAGGGA,240,243,3,23,13671,0,0
14444,ACGTCGAATGTAGGGA,240,243,3,19,13673,0,0
14445,ACGTAGAATCTAGGGA,240,243,3,19,13674,0,0
14446,ACGTCGAATCTAGGGA,240,243,3,19,13681,0,0
14447,ACGTCGAATCTAGGGA,240,243,3,23,13683,0,0
14448,ACGTCGAATCTAGGGA,240,243,3,20,13820,0,0
14449,ACGTCGAATCTAGGGA,240,243,3,21,13824,0,0
14450,ACGTCGAATCTAGGGA,240,243,3,21,13829,0,0
14451,ACGTCGAATCTAGGGA,240,241,1,17,13833,0,0
14452,ACGTCGAATCTAGGGA,240,243,3,19,13834,0,0
14453,ACGTCGAATCTAGGGA,240,243,3,21,13835,0,0
14454,ACGTCGAATCTAGGGA,240,243,3,17,13838,0,0
14455,ACGTCGAATCTAGGGA,240,243,3,23,13840,0,0
14456,ACGTCGAATCTAGGGA,240,243,3,22,13843,0,0
14457,ACGTCGAATGTAGGGA,240,243,3,19,13844,0,0
14458,ACGTCGAATCTAGGGA,240,243,3,23,13845,0,0
14459,ACGTCGAATCTAGGGA,240,243,3,23,13846,0,0
14460,TCGTCGAATCTAGGGA,240,243,3,23,13851,0,0
14461,ACGTCGAATCTAGGGA,240,243,3,21,13852,0,0
14462,ACGTTGAATCTAGGGA,240,240,0,23,14006,0,0
14463,ACGTCGAATCTAGGGA,240,243,3,22,14008,0,0
14464,ACGTCGAATCTAGGGA,240,240,0,22,14012,0,0
14465,ACGTCGAATCTAGGGA,240,243,3,22,14017,0,0
14466,ACGTCGAATCTAGGGA,240,243,3,23,14019,0,0
14467,ACGTCGAATCTAGGGA,240,243,3,21,14023,0,0
14468,ACGTCGAATCTAGGGA,240,240,0,19,14025,0,0
14469,ACGTCGATTCTAGGGA,240,243,3,19,14026,0,0
14470,ACGTCGAATCCAGGGA,240,243,3,18,14027,0,0
14471,ACGTCGAATCTAGGGA,240,243,3,22,14032,0,0
14472,TCGTCGAATTTAGGGA,240,243,3,22,14038,0,0
14473,ACGTCGAATCTAGGGA,240,242,2,23,14039,0,0
14474,ACGTCGAATCTAGGGA,240,243,3,16,14040,0,0
14475,ACGTCGAATCTAGGGA,240,243,3,24,14042,0,0
14476,ACGTAGAATCTAGGGA,241,245,4,17,11921,0,0
14477,TCGTCGAATCTAGGGA,241,249,8,21,12309,1,0
14478,ACGTCGAATCTAGGGA,241,242,1,18,12511,0,0
14479,ACGTCGAATCTAGGGA,241,246,5,21,12645,0,0
14480,ACGTCGAATCTAGGGA,241,252,11,18,12662,2,0
14481,ACGTCGAATCTACGGA,241,244,3,20,12665,0,0
14482,ACGTCGAATCTAGGGA,241,246,5,20,12824,0,0
14483,ACGTCGAATCTAGGGA,241,245,4,18,12853,0,0
14484,ACGTCGAATCTAGGGA,241,264,23,21,13009,6,0
14485,ACGTCGAATCTAGGGA,241,248,7,24,13011,0,0
14486,ACGTCGAATCTAGGGA,241,252,11,22,13018,2,0
14487,ACGTCGAATGTAGGGA,241,247,6,19,13019,0,0
14488,ACGTCGAATCTAGGGA,241,251,10,21,13168,1,0
14489,ACGTCGAATCTAGGGA,241,245,4,22,13174,0,0
14490,ACGTCGAATCTAGGGA,241,248,7,23,13278,0,0
14491,ACGTCGAATCTAGGGA,241,251,10,18,13284,1,0
14492,ACGTCGAATCTAGGGA,241,242,1,22,13345,0,0
14493,ACGTCGAATCTAGGGA,241,250,9,17,13351,1,0
14494,ACGTCGAATCTAGGGA,241,250,9,21,13355,1,0
14495,ACGTCGAATCTAGGGA,241,253,12,18,13356,2,0
14496,ACGTCGAATCTAGGGA,241,243,2,19,13362,0,0
14497,ACGTCGAATCTAGGGA,241,246,5,19,13379,0,0
14498,ACGTCGAATCTAGGGA,241,270,29,17,13382,8,0
14499,ACGTCGAATCTAGGGA,241,254,13,24,13385,2,0
14500,ACGTCGAATCTAGGGA,241,245,4,16,13387,0,0
14501,ACGTCGAATCTAGGGA,241,258,17,23,13514,4,0
14502,ACGTCGAATCTAGGGA,241,272,31,16,13531,8,0
14503,ACGTCGACTCTAGGGA,241,265,24,18,13534,6,0
14504,ACGTCGAATCTAGGGA,241,241,0,23,13538,0,0
14505,ACGTCGAATCTAGGGA,241,241,0,17,13553,0,0
14506,ACGTCGAATCTAGGGA,241,242,1,23,13554,0,0
14507,ACGTCGAATCTAGGGA,241,251,10,21,13702,1,0
14508,ACGTCGAATCTAGGGA,241,270,29,22,13705,8,0
14509,TCGTCGAATCTATTGA,241,242,1,22,13719,0,0
14510,ACGTCGAATCTAGGGA,241,254,13,21,13728,2,0
14511,ACGTCGAATCTAGGGA,241,245,4,22,13783,0,0
14512,ACGTCGAATCTAGGGA,241,270,29,23,13786,8,0
14513,ACGTCGAATCTAGGGA,241,241,0,24,13788,0,0
14514,ACGTCGAATCTAGGGA,241,245,4,21,13881,0,0
14515,ACGTCGAATCTAGGGA,241,249,8,19,13886,1,0
14516,ACGTCGAATCTAGGGA,241,246,5,16,13887,0,0
14517,ACGTCGAATCTAGGGA,241,255,14,18,13890,3,0
14518,ACGTCGAATCTAGGGA,241,249,8,17,13894,1,0
14519,ACGTCGAATCTAGGGA,241,249,8,23,13896,1,0
14520,ACGTCGAATCTAGGGA,241,265,24,24,13897,6,0
14521,ACGTCGAATCTAGGGA,241,257,16,23,13901,3,0
14522,ACGTCGAATCTAGGGA,241,247,6,27,13903,0,0
14523,ACGTCGAATCTAGGGA,241,248,7,18,13904,0,0
14524,ACGTCGAATCTAGGGA,241,245,4,22,13908,0,0
14525,ACGTAGAATCTAGGGA,241,241,0,20,13909,0,0
14526,ACGTCGAATCTAGGGA,241,243,2,17,14053,0,0
14527,ACGTCGAATCTAGGGA,241,256,15,23,14054,2,0
14528,ACGTCGAATCTAGGGA,241,254,13,24,14056,2,0
14529,ACGTCGAATCTAGGGA,241,276,35,21,14058,9,0
14530,ACGTCGAATCTAGGGA,241,249,8,16,14059,0,0
14531,ACGTAGCATCTAGGGA,241,244,3,23,14065,0,0
14532,ACGTAGAATCTAGGGA,241,243,2,20,14066,0,0
14533,ACGTCGAATCTAGGGA,241,251,10,20,14067,1,0
14534,ACGTCGAATCTAGGGA,241,254,13,21,14068,2,0
14535,ACGTCGAATCTAGGGA,241,263,22,23,14070,5,0
14536,ACGTCGAATCTAGGGA,241,261,20,16,14071,4,0
14537,ACGTAGAATCTAGGGA,241,242,1,19,14072,0,0
14538,ACGTCGAATCTAGGGA,241,252,11,17,14073,1,0
14539,ACGTCGAATCTAGGGA,241,245,4,21,14077,0,0
14540,ACGTCGAATCTAGGGA,241,250,9,27,14079,0,0
14541,ACGTCGAATCGAGGGA,241,241,0,23,14083,0,0
14542,ACGTCGAATCTAGGGA,241,262,21,23,14084,4,0
14543,ACGTCGAATCTAGGGA,241,243,2,18,14086,0,0
14544,ACGTCGAATCTAGGGA,241,252,11,21,14088,1,0
14545,ACGTCGAATCTAGGGA,241,244,3,27,14089,0,0
14546,ACGTCGAATCTAGGGA,241,246,5,22,14090,0,0
14547,ACGTCGAATCTAGGGA,242,244,2,15,11819,0,0
14548,ACGTCGAATCTAGGGA,242,242,0,16,12268,0,0
14549,ACGTCGAATCTAGGGA,242,243,1,20,12373,0,0
14550,ACGTCGAATCTAGGGA,242,242,0,16,12731,0,0
14551,ACGTCGAATCTAGGGA,242,243,1,21,12884,0,0
14552,ACGTCGAATCTAGGGA,242,248,6,16,12890,0,0
14553,ACGTCGAATGTAGGGA,242,254,12,18,13217,2,0
14554,ACGTCGAATCTAGGGA,242,248,6,15,13234,0,0
14555,ACGTCGAATCTAGGGA,242,246,4,18,13236,0,0
14556,ACGTCGAATCCAGGGA,242,260,18,17,13243,4,0
14557,ACGTCGAATCTAGGGA,242,261,19,19,13248,4,0
14558,ACGTCGAATCTAGGGA,242,243,1,21,13249,0,0
14559,ACGTCGAATGTAGGGA,242,245,3,19,13263,0,0
14560,ACGTCGATTCTGGGGA,242,254,12,18,13267,2,0
14561,ACGTCGAATCTAGGGA,242,243,1,17,13419,0,0
14562,ACGTCGAATCTAGGGA,242,245,3,18,13689,0,0
14563,ACGTCGAATCTAGGGA,242,245,3,22,13691,0,0
14564,ACGTCGAATCTAGGGA,242,242,0,15,13757,0,0
14565,ACGTCGAATCTAGGGA,242,245,3,21,13764,0,0
14566,ACGTCGAATGTAGGGA,242,245,3,19,13768,0,0
14567,ACGTCGAATCTAGGGA,242,245,3,21,13769,0,0
14568,ACGTCGAATCTGGGGA,242,245,3,18,13773,0,0
14569,ACGTCGAATCTAGGGA,242,245,3,15,13776,0,0
14570,ACGTCGAATCTAGGGA,242,242,0,22,13777,0,0
14571,ACGTCGAATCTAGGGA,242,244,2,22,13924,0,0
14572,ACGTCGAATCTAGGGA,242,242,0,21,13928,0,0
14573,ACGTCGAATCTAGGGA,242,243,1,22,13930,0,0
14574,ACGTCGAATCTAGGGA,242,243,1,22,13936,0,0
14575,ACGTCGAATCTAGGGA,242,242,0,15,13939,0,0
14576,ACGTCGAATCTAGGGA,242,243,1,22,13949,0,0
14577,ACGTCGAATCTAGGGA,242,243,1,19,14047,0,0
14578,ACGTCGAATCTAGGGA,242,245,3,16,14048,0,0
14579,TCGTCGAATTTAGGGA,242,244,2,22,14049,0,0
14580,ACGTCGAATCTAGGGA,242,245,3,21,14050,0,0
14581,TCGTCGAATCTAGGGA,242,245,3,21,14052,0,0
14582,ACGTAGAATCTAGGGA,242,245,3,18,14105,0,0
14583,ACGTAGCATCTAGGGA,242,245,3,21,14107,0,0
14584,ACGTCGAATCTAGGGA,242,245,3,21,14109,0,0
14585,ACGTCGAATCTAGGGA,242,243,1,19,14110,0,0
14586,ACGTCGAATCTAGGGA,242,245,3,22,14111,0,0
14587,ACGTCGAATCTAGGGA,242,242,0,22,14112,0,0
14588,ACGTCGAATCTAGGGA,242,245,3,23,14113,0,0
14589,ACGTCGAATCTAGGGA,242,245,3,21,14115,0,0
14590,ACGTCGAATCTAGGGA,243,248,5,17,12415,0,0
14591,ACGTCGAATCTAGGGA,243,257,14,18,12538,3,0
14592,ACGTCGAATCTAGGGA,243,244,1,15,12541,0,0
14593,ACGTCGAATCTAGGGA,243,252,9,17,12623,1,0
14594,ACGTCGAATCTAGGGA,243,251,8,16,12929,1,0
14595,ACGTCGAATCTAGGGA,243,265,22,20,13108,5,0
14596,ACGTCGAATCTAGGGA,243,266,23,15,13109,6,0
14597,ACGTCGAATCTAGGGA,243,251,8,17,13126,1,0
14598,ACGTCGAATCGAGGGA,243,253,10,21,13130,1,0
14599,ACGTAGCATCTAGGGA,243,255,12,22,13140,2,0
14600,ACGTCGAATCTAGGGA,243,261,18,19,13147,4,0
14601,ACGTCGAATCTAGGGA,243,244,1,20,13149,0,0
14602,ACGTCGAATCTAGGGA,243,247,4,15,13391,0,0
14603,ACGTAGAATCTAGGGA,243,248,5,18,13394,0,0
14604,ACGTCGAATCTAGGGA,243,273,30,18,13462,8,0
14605,ACGTCGAATCTAGGGA,243,245,2,16,13464,0,0
14606,AAGTCGAATCTATGGA,243,259,16,20,13466,3,0
14607,ACGACGAATCGAGGGA,243,253,10,16,13471,1,0
14608,ACGTTTAATCTAGGGA,243,246,3,23,13557,0,0
14609,ACGTCGAATCTAGGGA,243,244,1,17,13569,0,0
14610,ACGTCGAATCTAGGGA,243,244,1,21,13642,0,0
14611,ACGTCGAATCTAGGGA,243,243,0,20,13656,0,0
14612,ACGTCGAATCGAGGGA,243,252,9,16,13659,1,0
14613,ACGTCGAATGTAGGGA,243,250,7,19,13661,0,0
14614,ACGTCGAATCTAGGGA,243,247,4,23,13671,0,0
14615,ACGTCGAATCTAGGGA,243,248,5,19,13681,0,0
14616,ACGTCGAATCTAGGGA,243,246,3,23,13683,0,0
14617,ACGTCGAATCTAGGGA,243,245,2,21,13824,0,0
14618,ACGTCGAATCTAGGGA,243,246,3,21,13829,0,0
14619,ACGTCGAATCTAGGGA,243,253,10,17,13833,1,0
14620,ACGTCGAATCTAGGGA,243,246,3,21,13835,0,0
14621,ACGTCGAATCTAGGGA,243,249,6,17,13838,0,0
14622,ACGTCGAATCTAGGGA,243,261,18,23,13840,4,0
14623,ACGTCGAATCTAGGGA,243,255,12,22,13843,2,0
14624,ACGTCGAATCTAGGGA,243,245,2,23,13846,0,0
14625,TCGTCGAATCTAGGGA,243,245,2,23,13851,0,0
14626,ACGTTGAATCTAGGGA,243,285,42,23,14006,12,0
14627,ACGTCGAATCTAGGGA,243,246,3,22,14008,0,0
14628,ACGTCGAATCTAGGGA,243,244,1,22,14012,0,0
14629,ACGTCGAATCTAGGGA,243,249,6,22,14017,0,0
14630,ACGTCGAATCTAGGGA,243,243,0,23,14019,0,0
14631,ACGTCGAATCTAGGGA,243,255,12,19,14025,2,0
14632,ACGTCGATTCTAGGGA,243,252,9,19,14026,1,0
14633,ACGTCGAATCCAGGGA,243,247,4,18,14027,0,0
14634,ACGTCGAATCTAGGGA,243,244,1,22,14032,0,0
14635,TCGTCGAATTTAGGGA,243,246,3,22,14038,0,0
14636,ACGTCGAATCTAGGGA,243,246,3,23,14039,0,0
14637,ACGTCGAATCTAGGGA,243,246,3,16,14040,0,0
14638,ACGTCGAATCTAGGGA,243,243,0,24,14042,0,0
14639,ACGTCGAATCTAGGGA,243,246,3,16,14174,0,0
14640,ACGTTGAATCTAGGGA,243,246,3,23,14177,0,0
14641,ACGTCGAATCTAGGGA,243,243,0,22,14179,0,0
14642,ACGTCGAATCTAGGGA,243,246,3,21,14181,0,0
14643,ACGTCGAATCTAGGGA,243,246,3,17,14183,0,0
14644,ACGTCGAATGTAGGGA,243,246,3,19,14186,0,0
14645,ACGTCGATTCTAGGGA,243,246,3,19,14190,0,0
14646,ACGTCGAATCTAGGGA,243,246,3,22,14193,0,0
14647,ACGTCGAATCTAGGGA,243,246,3,19,14196,0,0
14648,TCGTCGAATTTAAGGA,243,246,3,22,14200,0,0
14649,ACGTCGAATCTAGGGA,243,246,3,22,14201,0,0
14650,ACGTCGAATCTAGGGA,243,246,3,18,14203,0,0
14651,ACGTCGAATCTAGGGA,243,246,3,19,14205,0,0
14652,ACGTCGAATCTAGGGA,243,246,3,23,14207,0,0
14653,ACGTCTAATCTAGGGA,243,246,3,16,14208,0,0
14654,TCGTCGAATCTAGGGA,243,246,3,23,14209,0,0
14655,ACGTCGAATCTAGGGA,243,246,3,16,14210,0,0
14656,ACGTCGAATCTAGGGA,243,246,3,22,14211,0,0
14657,ACGTCGAATCTAGGGA,243,246,3,24,14212,0,0
14658,ACGTCGAATCTAGGGA,243,244,1,22,14213,0,0
14659,ACGTCGAATCTAGGGA,243,246,3,25,14214,0,0
14660,ACGTCGAATCTAGGGA,243,246,3,16,14219,0,0
14661,ACGTCGAATCTGGGGA,243,246,3,23,14220,0,0
14662,ACGTAGAATCTAGGGA,244,261,17,17,11921,4,0
14663,TCGTCGAATCTAGGGA,244,278,34,21,12309,9,0
14664,ACGTCGAATCTAGGGA,244,252,8,18,12511,1,0
14665,ACGTCGAATCTAGGGA,244,258,14,21,12645,3,0
14666,ACGTCGAATCTAGGGA,244,252,8,20,12665,1,0
14667,ACGTCGAATCTAGGGA,244,266,22,20,12824,5,0
14668,ACGTCGAATCTAGGGA,244,260,16,18,12853,3,0
14669,ACGTCGAATCTAGGGA,244,251,7,21,13009,0,0
14670,ACGTCGAATCTAGGGA,244,253,9,24,13011,1,0
14671,ACGTCGAATGTAGGGA,244,252,8,19,13019,1,0
14672,ACGTCGAATCTAGGGA,244,254,10,21,13168,1,0
14673,ACGTCGAATCTAGGGA,244,256,12,22,13174,2,0
14674,ACGTCGAATCTAGGGA,244,274,30,23,13278,8,0
14675,ACGTCGAATCTAGGGA,244,249,5,22,13345,0,0
14676,ACGTCGAATCTAGGGA,244,256,12,17,13351,2,0
14677,ACGTCGAATCTAGGGA,244,250,6,21,13355,0,0
14678,ACGTCGAATCTAGGGA,244,265,21,18,13356,5,0
14679,ACGTCGAATCTAGGGA,244,249,5,17,13382,0,0
14680,ACGTCGAATCTAGGGA,244,259,15,24,13385,3,0
14681,ACGTCGAATCTAGGGA,244,245,1,16,13387,0,0
14682,ACGTCGAATCTAGGGA,244,251,7,23,13514,0,0
14683,ACGTCGAATCTAGGGA,244,247,3,18,13534,0,0
14684,ACGTCGAATCTAGGGA,244,250,6,23,13538,0,0
14685,ACGTCGAATCTAGGGA,244,258,14,17,13553,3,0
14686,ACGTCGAATCTAGGGA,244,246,2,23,13554,0,0
14687,TCGTCGAATCTATTGA,244,260,16,22,13719,3,0
14688,ACGTCGAATCTAGGGA,244,254,10,21,13728,1,0
14689,ACGTCGAATCTAGGGA,244,264,20,22,13783,5,0
14690,ACGTCGAATCTAGGGA,244,251,7,23,13786,0,0
14691,ACGTCGAATCTAGGGA,244,255,11,24,13788,2,0
14692,ACGTCGAATCTAGGGA,244,256,12,21,13881,2,0
14693,ACGTCGAATCTAGGGA,244,251,7,19,13886,0,0
14694,ACGTCGAATCTAGGGA,244,248,4,16,13887,0,0
14695,ACGTCGAATCTAGGGA,244,260,16,17,13894,3,0
14696,ACGTCGAATCTAGGGA,244,250,6,23,13896,0,0
14697,ACGTCGAATCTAGGGA,244,271,27,24,13897,7,0
14698,ACGTCGAATCTAGGGA,244,244,0,23,13901,0,0
14699,ACGTCGAATCTAGGGA,244,251,7,27,13903,0,0
14700,ACGTCGAATCTAGGGA,244,262,18,22,13908,4,0
14701,ACGTCGAATCTAGGGA,244,247,3,17,14053,0,0
14702,ACGTCGAATCTAGGGA,244,249,5,23,14054,0,0
14703,ACGTCGAATCTAGGGA,244,261,17,21,14058,3,0
14704,ACGTCGAATCTAGGGA,244,247,3,16,14059,0,0
14705,ACGTAGAATCTAGGGA,244,247,3,20,14066,0,0
14706,ACGTCGAATCTAGGGA,244,248,4,20,14067,0,0
14707,ACGTCGAATCTAGGGA,244,252,8,21,14068,0,0
14708,ACGTCGAATCTAGGGA,244,265,21,23,14070,4,0
14709,ACGTAGAATCTAGGGA,244,263,19,19,14072,4,0
14710,ACGTCGAATCTAGGGA,244,251,7,17,14073,0,0
14711,ACGTCGAATCTAGGGA,244,253,9,21,14077,0,0
14712,ACGTCGAATCTAGGGA,244,254,10,27,14079,1,0
14713,ACGTCGAATCGAGGGA,244,263,19,23,14083,4,0
14714,ACGTCGAATCTAGGGA,244,251,7,23,14084,0,0
14715,ACGTCGAATCTAGGGA,244,247,3,21,14088,0,0
14716,ACGTCGAATCTAGGGA,244,247,3,27,14089,0,0
14717,ACGTCGAATCTAGGGA,244,247,3,16,14225,0,0
14718,ACGTCGAATCTAGGGA,244,247,3,18,14228,0,0
14719,ACGTCGAATCTAGGGA,244,247,3,17,14230,0,0
14720,ACGTCGAATCTAGGGA,244,247,3,23,14231,0,0
14721,ACGTCGAATCTAGGGA,244,247,3,16,14234,0,0
14722,ACGTCGAATCTAGGGA,244,246,2,23,14235,0,0
14723,ACGTCGAATCTAGGGA,244,246,2,27,14236,0,0
14724,ACGTCGAATCGAGGGA,244,246,2,22,14238,0,0
14725,ACGTCGAATCTAGGGA,244,247,3,22,14239,0,0
14726,ACGTAGAATCTAGGGA,244,247,3,20,14241,0,0
14727,ACGTCGAATCTAGGGA,244,245,1,20,14242,0,0
14728,ACGTCGAATCTAGGGA,244,247,3,21,14243,0,0
14729,ACGTCGAATCTAGGGA,244,247,3,16,14245,0,0
14730,ACGTAGAATCTAGGGA,244,246,2,19,14246,0,0
14731,ACGTCGAATCTAGGGA,244,247,3,19,14247,0,0
14732,ACGTCGAATCTAGGGA,245,263,18,20,12373,4,0
14733,ACGTCGAATCTAGGGA,245,253,8,16,12731,1,0
14734,ACGTCGAATCTAGGGA,245,245,0,21,12884,0,0
14735,ACGTCGAATCTAGGGA,245,259,14,16,12890,3,0
14736,ACGTCGAATGTAGGGA,245,277,32,18,13217,9,0
14737,ACGTCGAATCTAGGGA,245,264,19,19,13248,4,0
14738,ACGTCGAATCTAGGGA,245,246,1,21,13249,0,0
14739,ACGTCGAATGTAGGGA,245,256,11,19,13263,2,0
14740,ACGTCGATTCTGGGGA,245,245,0,18,13267,0,0
14741,ACGTCGAATCTAGGGA,245,249,4,17,13419,0,0
14742,ACGTCGAATCTAGGGA,245,251,6,18,13689,0,0
14743,ACGTCGAATCTAGGGA,245,247,2,21,13764,0,0
14744,ACGTCGAATCTGGGGA,245,249,4,18,13773,0,0
14745,ACGTCGAATCTAGGGA,245,264,19,15,13776,4,0
14746,ACGTCGAATCTAGGGA,245,249,4,22,13777,0,0
14747,ACGTCGAATCTAGGGA,245,253,8,22,13924,0,0
14748,ACGTCGAATCTAGGGA,245,253,8,21,13928,0,0
14749,ACGTCGAATCTAGGGA,245,247,2,22,13930,0,0
14750,ACGTCGAATCTAGGGA,245,246,1,22,13936,0,0
14751,ACGTCGAATCTAGGGA,245,255,10,15,13939,1,0
14752,ACGTCGGATCTAGGGA,245,291,46,22,13949,13,0
14753,ACGTCGAATCTAGGGA,245,255,10,19,14047,1,0
14754,ACGTCGAATCTAGGGA,245,249,4,16,14048,0,0
14755,TCGTCGAATTTAGGGA,245,248,3,22,14049,0,0
14756,TCGTCGAATCTAGGGA,245,248,3,21,14052,0,0
14757,ACGTCGAATCTAGGGA,245,248,3,21,14109,0,0
14758,ACGTCGAATCTAGGGA,245,248,3,19,14110,0,0
14759,ACGTCGAATCTAGGGA,245,248,3,23,14113,0,0
14760,ACGTCGAATCTAGGGA,245,248,3,21,14115,0,0
14761,TCGTCGAATCTAGGGA,245,248,3,22,14289,0,0
14762,ACGTCGAATCTAGGGA,245,248,3,19,14290,0,0
14763,ACGTCGAATCTAGGGA,245,246,1,19,14292,0,0
14764,ACGTCGAATCTAGGGA,245,248,3,21,14293,0,0
14765,ACGTCGAATCTAGGGA,245,248,3,21,14294,0,0
14766,ACGTCGAATCTAGGGA,245,246,1,19,14295,0,0
14767,ACGTCGAATCTAGGGA,245,248,3,22,14297,0,0
14768,ACGTCGAATCTAGGGA,245,248,3,25,14298,0,0
14769,ACGTCGAATGTAGGGA,245,248,3,20,14300,0,0
14770,ACGTCGAATCTAGGGA,245,248,3,22,14301,0,0
14771,ACGTCGAATCTAGGGA,245,248,3,23,14302,0,0
14772,CCGTCGAATCTAGGGA,245,248,3,24,14303,0,0
14773,ACGTCGAATCTAGGGA,245,245,0,22,14305,0,0
14774,ACGTCGAATCTAGGGA,246,247,1,17,12415,0,0
14775,ACGTCGAATCTAGGGA,246,258,12,18,12538,2,0
14776,ACGTCGAATCTAGGGA,246,255,9,15,12541,1,0
14777,ACGTCGAATCTAGGGA,246,258,12,17,12623,2,0
14778,ACGTCGAATCTAGGGA,246,269,23,20,13108,6,0
14779,ACGTCGAATCTAGGGA,246,265,19,15,13109,4,0
14780,ACGTCGAATCGAGGGA,246,255,9,21,13130,1,0
14781,ACGTCGAATCTAGGGA,246,246,0,19,13147,0,0
14782,ACGTCGAATCTAGGGA,246,259,13,18,13462,2,0
14783,ACGTCGAATCTAGGGA,246,266,20,16,13464,5,0
14784,ACGTCGAATCGAGGGA,246,249,3,16,13471,0,0
14785,ACGTCGAATCTAGGGA,246,247,1,17,13569,0,0
14786,ACGTCGAATCTAGGGA,246,251,5,21,13642,0,0
14787,ACGTCGAATCTAGGGA,246,264,18,20,13656,4,0
14788,ACGTCGAATGTAGGGA,246,249,3,19,13661,0,0
14789,ACGTCGAATCTAGGGA,246,247,1,23,13671,0,0
14790,ACGTCGAATCTAGGGA,246,246,0,23,13683,0,0
14791,ACGTCGAATCTAGGGA,246,246,0,21,13829,0,0
14792,ACGTCGAATCTAGGGA,246,262,16,21,13835,3,0
14793,ACGTCGAATCTAGGGA,246,246,0,22,13843,0,0
14794,ACGTCGAATCTAGGGA,246,252,6,23,13846,0,0
14795,TCGTCGAATCTAGGGA,246,248,2,23,13851,0,0
14796,ACGTTGAATCTAGGGA,246,274,28,23,14006,7,0
14797,ACGTCGAATCTAGGGA,246,250,4,22,14008,0,0
14798,ACATCGAATCTAGGGA,246,266,20,22,14017,5,0
14799,ACGTCGAATCTAGGGA,246,249,3,23,14019,0,0
14800,ACGTCGATTCTAGGGA,246,259,13,19,14026,2,0
14801,ACGTCGAATCTAGGGA,246,251,5,22,14032,0,0
14802,ACGTCGAATCTAGGGA,246,246,0,23,14039,0,0
14803,ACGTCGAATCTAGGGA,246,248,2,24,14042,0,0
14804,ACGTTGAATCTAGGGA,246,248,2,23,14177,0,0
14805,ACGTCGAATCTAGGGA,246,247,1,22,14179,0,0
14806,ACGTCGAATCTAGGGA,246,246,0,17,14183,0,0
14807,CCGTCGAATGTAGGGA,246,261,15,19,14186,3,0
14808,ACGTCGATTCTAGGGA,246,248,2,19,14190,0,0
14809,ACGTCCAATCTAGGGA,246,249,3,19,14196,0,0
14810,ACGTCGAATCTAGGGA,246,249,3,19,14205,0,0
14811,ACGTCGAATCTAGGGA,246,249,3,23,14207,0,0
14812,TCGTCGAATCTAGGGA,246,249,3,23,14209,0,0
14813,ACGTCGAATCTAGGGA,246,249,3,16,14210,0,0
14814,ACGTCGAATCTAGGGA,246,247,1,22,14211,0,0
14815,ACGTCGAATCTAGGGA,246,249,3,24,14212,0,0
14816,ACGTCGAATCTAGGGA,246,249,3,25,14214,0,0
14817,ACGTCGAATCTAGGGA,246,249,3,16,14219,0,0
14818,ACGTCGAATCTAGGGA,246,249,3,23,14220,0,0
14819,ACGTCGAATCGAGGGA,246,249,3,17,14251,0,0
14820,ACGTCGAATCGAGGGA,246,246,0,23,14254,0,0
14821,ACGTCGAATCTAGGGA,246,249,3,18,14255,0,0
14822,ACGTCGAATCTAGGGA,246,247,1,22,14260,0,0
14823,ACGTCGAATCTAGGGA,246,249,3,17,14365,0,0
14824,ACGTCGAATCTAGGGA,246,249,3,21,14366,0,0
14825,ACGTCGAATCTAGGGA,246,249,3,17,14368,0,0
14826,ACGTCGAATCTAGGGA,246,248,2,16,14371,0,0
14827,ACGTCGAATGTAGGGA,246,249,3,20,14379,0,0
14828,ACGTCGAATCTAGGGA,246,249,3,18,14382,0,0
14829,ACGTCGCATCTAGGGA,246,246,0,19,14384,0,0
14830,ACGTCGAATCTAGGGA,246,249,3,16,14388,0,0
14831,ACGTCGAATCTAGGGA,246,249,3,22,14389,0,0
14832,ACGTCGAATCTAGGGA,246,249,3,22,14390,0,0
14833,ACGTCGAATCTAGGGA,246,248,2,22,14392,0,0
14834,ACGTCGAATCTGGGGA,246,249,3,19,14393,0,0
14835,ACGTCGAATCTAGGGA,246,249,3,16,14394,0,0
14836,ACGTCGAATCTAGGGA,246,249,3,24,14396,0,0
14837,ACGTAGAATCTAGGGA,247,261,14,17,11921,3,0
14838,TCGTCGAATCTAGGGA,247,284,37,21,12309,10,0
14839,ACGTCGAATCTAGGGA,247,256,9,18,12511,1,0
14840,ACGTCGAATCTAGGGA,247,258,11,20,12665,2,0
14841,ACGTCGAATCTAGGGA,247,253,6,20,12824,0,0
14842,ACGTCGAATCTAGGGA,247,250,3,18,12853,0,0
14843,ACGTCGAATCTAGGGA,247,249,2,24,13011,0,0
14844,ACGTCGAATGTAGGGA,247,253,6,19,13019,0,0
14845,ACGTCGAATCTAGGGA,247,290,43,21,13168,12,0
14846,ACGTCGAATCTAGGGA,247,286,39,22,13174,11,0
14847,ACGTCGAATCTAGGGA,247,248,1,22,13345,0,0
14848,ACGTCGAATCTAGGGA,247,252,5,17,13351,0,0
14849,ACGTCGAATCTAGGGA,247,249,2,18,13356,0,0
14850,ACGTCGAATCTAGGGA,247,247,0,17,13382,0,0
14851,ACGTCGAATCTAGGGA,247,249,2,24,13385,0,0
14852,ACGTCGAATCTAGGGA,247,260,13,16,13387,2,0
14853,ACGTCGAATCTAGGGA,247,259,12,23,13514,2,0
14854,ACGTCGAATCTAGGGA,247,250,3,18,13534,0,0
14855,ACGTCGAATCTAGGGA,247,252,5,23,13538,0,0
14856,ACGTCGAATCTAGGGA,247,265,18,17,13553,4,0
14857,ACGTCGAATCTAGGGA,247,268,21,23,13554,5,0
14858,TCGTCGAATCTATTGA,247,302,55,22,13719,16,0
14859,ACGTCGAATCTAGGGA,247,263,16,21,13728,3,0
14860,ACGTCGAATCTAGGGA,247,252,5,23,13786,0,0
14861,ACGTCGAATCTAGGGA,247,251,4,21,13881,0,0
14862,ACGTCGAATCTAGGGA,247,260,13,19,13886,2,0
14863,ACGTCGAATCTAGGGA,247,253,6,16,13887,0,0
14864,ACGTCGAATCTAGGGA,247,278,31,24,13897,8,0
14865,ACGTCGAATCTAGGGA,247,252,5,27,13903,0,0
14866,ACGTCGAATCTAGGGA,247,256,9,22,13908,0,0
14867,ACGTCGAATCTAGTGA,247,268,21,23,14054,4,0
14868,ACGTCGAATCTAGGGA,247,247,0,16,14059,0,0
14869,ACGTAGAATCTAGGGA,247,264,17,20,14066,3,0
14870,ACGTCGAATCTAGGGA,247,256,9,20,14067,0,0
14871,ACGTCGAATCTAGGGA,247,258,11,21,14068,1,0
14872,ACGTAGAATCTAGGGA,247,250,3,19,14072,0,0
14873,ACGTCGAATCTAGGGA,247,273,26,17,14073,6,0
14874,ACGTCGAATCTAGGGA,247,249,2,21,14077,0,0
14875,ACGTCGAATCTAGGGA,247,247,0,27,14079,0,0
14876,ACGTCGAATCTAGGGA,247,256,9,23,14084,0,0
14877,ACGTCGAATCTAGGGA,247,251,4,21,14088,0,0
14878,ACGTCGAATCTAGGGA,247,265,18,16,14225,3,0
14879,ACGTCGAATCTAGGGA,247,248,1,16,14234,0,0
14880,ACGTCGAATCTAGGGA,247,248,1,23,14235,0,0
14881,ACGTCGAATCGAGGGA,247,255,8,22,14238,0,0
14882,ACGTCGAATCTAGGGA,247,250,3,22,14239,0,0
14883,ACGTAGAATCTAGGGA,247,250,3,20,14241,0,0
14884,ACGTCGCATCTAGGGA,247,250,3,20,14242,0,0
14885,ACGTCGAATCTAGGGA,247,250,3,21,14243,0,0
14886,ACGTAGAATCTAGGGA,247,250,3,19,14246,0,0
14887,ACGTCGAATCTAGGGA,247,248,1,19,14247,0,0
14888,ACGTCGAATCTAGGGA,247,250,3,23,14306,0,0
14889,ACGTCGAATCTAGGGA,247,250,3,18,14307,0,0
14890,ACGTCGAATCTAGGGA,247,250,3,19,14309,0,0
14891,ACGTCGAATCTAGGGA,247,248,1,22,14310,0,0
14892,ACGTCGAATCTAGGGA,247,250,3,18,14409,0,0
14893,ACGTCGAATCTAGGGA,248,267,19,20,12373,4,0
14894,ACGTCGAATCTAGGGA,248,249,1,16,12890,0,0
14895,ACGTCGAATGTAGGGA,248,250,2,18,13217,0,0
14896,ACGTCGAATCTAGGGA,248,249,1,19,13248,0,0
14897,ACGTCGAATGTAGGAA,248,257,9,19,13263,1,0
14898,ACGTCGATTCTGGGGA,248,250,2,18,13267,0,0
14899,ACGTCGAATCTAGGGA,248,248,0,21,13764,0,0
14900,ACGTCGAATCTAGGGA,248,249,1,15,13776,0,0
14901,ACGTCGAATCTAGGGA,248,262,14,22,13924,3,0
14902,ACGTCGAATCTAGGGA,248,249,1,21,13928,0,0
14903,ACGTCGAATCTAGGGA,248,252,4,22,13930,0,0
14904,ACGTCGAATCTAGGGA,248,249,1,22,13936,0,0
14905,ACGTCGAATCTAGGGA,248,262,14,19,14047,3,0
14906,TCGTCGAATTTAGGGA,248,251,3,22,14049,0,0
14907,TCGTCGAATCTAGGGA,248,258,10,21,14052,1,0
14908,ACGTCGAATCTAGGGA,248,250,2,21,14109,0,0
14909,ACGTCGAATCTAGGGA,248,266,18,23,14113,4,0
14910,ACGTCGAATCTAGGGA,248,258,10,21,14115,1,0
14911,ACGTCGAATCTAGGGA,248,252,4,19,14292,0,0
14912,ACGTCGAATCTAGGGA,248,267,19,21,14293,4,0
14913,ACGTCGAATCTAGGGA,248,263,15,21,14294,3,0
14914,ACGTCGAATCTAGGGA,248,276,28,19,14295,7,0
14915,ACGTCGAATCTAGGGA,248,252,4,22,14297,0,0
14916,ACGTCGAATCTAGGGA,248,251,3,24,14303,0,0
14917,CCGTCGAATCTAGGGA,248,251,3,22,14305,0,0
14918,ACGTCGAATCTAGGGA,248,251,3,22,14399,0,0
14919,ACGTCGAATCTAGGGT,248,250,2,23,14403,0,0
14920,ACGTCGAATCTAGGGA,248,251,3,20,14404,0,0
14921,TCGTCGAATTTAGGGA,248,251,3,23,14406,0,0
14922,ACGTCGAATCTAGGGA,248,251,3,22,14407,0,0
14923,TCGTCGAATCTAGGGA,248,248,0,22,14477,0,0
14924,ACGTCGAATCTAGGGA,248,251,3,19,14480,0,0
14925,ACGTCGAATCTAGGGA,248,251,3,22,14484,0,0
14926,ACGTCGAATCTAGGGA,248,251,3,23,14486,0,0
14927,ACGTCGAATCTAGGGA,248,251,3,22,14488,0,0
14928,ACGTCGAATCTAGGGA,248,251,3,19,14491,0,0
14929,ACGTCGAATCTAGGGA,248,251,3,18,14493,0,0
14930,ACGTCGAATCTAGGGA,248,251,3,22,14494,0,0
14931,ACGTCGAATCTAGGGA,248,249,1,19,14495,0,0
14932,ACGTCGAATCTAGGGA,248,248,0,18,14498,0,0
14933,ACGTCGAATCTAGGGA,248,251,3,25,14499,0,0
14934,ACGTCGAATCTAGGGA,248,251,3,24,14501,0,0
14935,ACGTCGAATCTAGGGA,248,251,3,17,14502,0,0
14936,ACGTCGACTCTAGGGA,248,249,1,19,14503,0,0
14937,ACGTCGAATCTAGGGA,248,251,3,22,14507,0,0
14938,ACGTCGAATCTAGGGA,248,251,3,23,14508,0,0
14939,ACGTCGAATCTAGGGA,248,251,3,22,14510,0,0
14940,ACGTCGAATCTAGGGA,248,251,3,24,14512,0,0
14941,ACGTCGAATCTAGGGA,248,251,3,20,14515,0,0
14942,ACGTCGAATCTAGGGA,248,251,3,19,14517,0,0
14943,ACGTCGAATCTAGGGA,248,248,0,18,14518,0,0
14944,ACGTCGAATCTAGGGA,248,251,3,24,14519,0,0
14945,ACGTCGAATCTAGGGA,248,248,0,25,14520,0,0
14946,ACGTCGAATCTAGGGA,249,266,17,18,12538,4,0
14947,ACGTCGAATCTAGGGA,249,258,9,15,12541,1,0
14948,ACGTCGAATCTAGGGA,249,255,6,17,12623,0,0
14949,ACGTCGAATCTAGGGA,249,261,12,20,13108,2,0
14950,ACGTCGAATCTATGGA,249,261,12,15,13109,2,0
14951,ACGTCGAATCGAGGGA,249,265,16,21,13130,3,0
14952,ACGTCGAATCTAGGGA,249,250,1,19,13147,0,0
14953,ACGTCGAATCTAGGGA,249,253,4,16,13464,0,0
14954,ACGTCGAATCGAGGGA,249,255,6,16,13471,0,0
14955,ACGTCGAATCTAGGGA,249,253,4,17,13569,0,0
14956,ACGTCGAATCTAGGGA,249,251,2,21,13642,0,0
14957,ACGTCGAATCTAGGGA,249,249,0,20,13656,0,0
14958,ACGTCGAATGTAGGGA,249,251,2,19,13661,0,0
14959,ACGTCGAATCTAGGGA,249,264,15,23,13671,3,0
14960,ACGTCGAATCTAGGGA,249,254,5,23,13683,0,0
14961,ACGTCGAATCTAGGGA,249,273,24,21,13829,6,0
14962,ACGTCGAATCTAGGGA,249,254,5,22,13843,0,0
14963,TCGTCGAATCTAGGGA,249,250,1,23,13851,0,0
14964,ACGTCGAATCTAGGGA,249,256,7,22,14008,0,0
14965,ACGTCGAATCTAGGGA,249,286,37,22,14017,10,0
14966,ACGTCGATTCTAGGGA,249,255,6,19,14026,0,0
14967,ACGTCGAATCTAGGGA,249,253,4,22,14032,0,0
14968,ACGTCGAATCTAGGGA,249,255,6,23,14039,0,0
14969,ACGTTGAATCTAGGGA,249,257,8,23,14177,1,0
14970,ACGTCGAATCTAGGGA,249,252,3,22,14179,0,0
14971,ACGTCGAATCTAGGGA,249,249,0,17,14183,0,0
14972,ACGTCGATTCTAGGGA,249,258,9,19,14190,1,0
14973,ACGTCGAATCTAGGGA,249,252,3,19,14196,0,0
14974,ACGTCGAATCTAGGGA,249,252,3,19,14205,0,0
14975,ACGTCGAATCTAGGGA,249,250,1,23,14207,0,0
14976,TCGTCGAATCTAGGGA,249,263,14,23,14209,3,0
14977,ACGTCGAATCTAGGGA,249,251,2,24,14212,0,0
14978,ACGTCGAATCTAGGGA,249,285,36,25,14214,10,0
14979,ACGTCGAATCTAGGGA,249,276,27,23,14220,7,0
14980,ACTTCGAATCGAGGGA,249,251,2,17,14251,0,0
14981,ACGTCGAATCGAGGGA,249,258,9,23,14254,1,0
14982,ACGTCGAATCTAGGGA,249,254,5,18,14255,0,0
14983,ACGTCGAATCTAGGGA,249,270,21,22,14260,5,0
14984,ACGTCGAATCTAGGGA,249,264,15,17,14365,3,0
14985,ACGTCGAATCTAGGGA,249,258,9,21,14366,1,0
14986,ACGTCGAATCTAGGGA,249,259,10,16,14371,1,0
14987,ACGTCGAATGTAGGGA,249,269,20,20,14379,5,0
14988,ACGTCGAATCTAGGGA,249,252,3,18,14382,0,0
14989,ACGTCGAATCTAGGGA,249,252,3,19,14384,0,0
14990,ACGTCGAATCTAGGGA,249,252,3,16,14388,0,0
14991,ACGTCGAATCTAGGGA,249,252,3,22,14392,0,0
14992,ACGTCGAATCTGGGGA,249,251,2,19,14393,0,0
14993,ACGTCGAATCTAGGGA,249,252,3,16,14394,0,0
14994,ACGTCGAATGTAGGGA,249,252,3,19,14553,0,0
14995,ACGTCGAATCCAGGGA,249,252,3,18,14556,0,0
14996,ACGTCGAATCTAGGGA,249,250,1,20,14557,0,0
14997,ACGTCGATTCTGGGGA,249,252,3,19,14560,0,0
14998,TCGTCGAATCTAGGGA,250,252,2,21,12309,0,0
14999,ACGTCGAATCTAGGGA,250,268,18,18,12511,4,0
15000,ACGTCGAATCTAGGGA,250,254,4,20,12665,0,0
15001,ACGTCGAATCTAGGGA,250,278,28,20,12824,7,0
15002,ACGTCGAATCTAGGGA,250,254,4,18,12853,0,0
15003,ACGTCGAATCTAGGGA,250,257,7,21,13168,0,0
15004,ACGTCGAATCTAGGGA,250,255,5,22,13174,0,0
15005,ACGTCGAATCTAGGGA,250,259,9,22,13345,1,0
15006,ACGTCGAATCTAGGGA,250,254,4,17,13351,0,0
15007,ACGTCGAATCTAGGGA,250,253,3,18,13356,0,0
15008,ACGTCGAATCTAGGGA,250,262,12,17,13382,2,0
15009,ACGTCGAATCTAGGGA,250,262,12,24,13385,2,0
15010,ACGTCGAATCTAGGGA,250,251,1,23,13514,0,0
15011,ACGCCGAATCTAGGGA,250,251,1,18,13534,0,0
15012,ACGTCGAATCTAGGGA,250,257,7,23,13538,0,0
15013,ACGTCGAATCTAGGGA,250,258,8,17,13553,0,0
15014,ACGTCGAATCTAGGGA,250,250,0,23,13554,0,0
15015,TCGTCGAATCTATTGA,250,253,3,22,13719,0,0
15016,ACGTCGAATCTAGGGA,250,253,3,21,13728,0,0
15017,ACGTCGAATCTAGGGA,250,251,1,23,13786,0,0
15018,ACGTCGAATCTAGGGA,250,253,3,21,13881,0,0
15019,ACGTCGAATCTAGGGA,250,253,3,19,13886,0,0
15020,ACGTCGAATCTAGGGA,250,253,3,16,13887,0,0
15021,ACGTCGAATCTAGGGA,250,252,2,27,13903,0,0
15022,ACGTAGAATCTAGGGA,250,253,3,20,14066,0,0
15023,ACGTCGAATCTAGGGA,250,253,3,20,14067,0,0
15024,ACGTCGAATCTAGGGA,250,253,3,21,14068,0,0
15025,ACGTCGAATCTAGGGA,250,253,3,17,14073,0,0
15026,ACGTCGAATCTAGGGA,250,253,3,21,14077,0,0
15027,ACGTCGAATCTAGGGA,250,253,3,27,14079,0,0
15028,ACGTCGAATCTAGGGA,250,253,3,23,14084,0,0
15029,ACGTCGAATCTAGGGA,250,251,1,21,14088,0,0
15030,ACGTCGAATCTAGGGA,250,253,3,16,14225,0,0
15031,ACGTCGAATCGAGGGA,250,253,3,22,14238,0,0
15032,ACGTCGAATCTAGGGA,250,251,1,22,14239,0,0
15033,ACGTAGAATCTAGGGA,250,253,3,20,14241,0,0
15034,ACGTCGAATCTAGGGA,250,253,3,20,14242,0,0
15035,AGGTCGAATCTAGGGA,250,250,0,21,14243,0,0
15036,ACGTCGAATCTAGGGA,250,253,3,19,14247,0,0
15037,ACGTCGAATCTAGGGA,250,252,2,19,14309,0,0
15038,ACGTCGAATCTAGGGA,250,253,3,22,14310,0,0
15039,ACGTCGAATCTAGGGA,250,253,3,18,14409,0,0
15040,ACGTCGAATCTAGGGA,250,253,3,24,14521,0,0
15041,ACGTCGAATCTAGGGA,250,253,3,24,14527,0,0
15042,ACGTCGAATCTAGGGA,250,250,0,25,14528,0,0
15043,ACGTCGAATCTAGGGA,250,250,0,22,14529,0,0
15044,ACGTCGAATCTAGGGA,250,253,3,21,14533,0,0
15045,ACGTCGAATCTAGGGA,250,253,3,22,14534,0,0
15046,ACGTCGAATCTAGGGA,250,253,3,24,14535,0,0
15047,ACGTCGAATCTAGGGA,250,253,3,17,14536,0,0
15048,ACGTCGAATCTAGGGA,250,253,3,18,14538,0,0
15049,ACGTCGAATCTAGGGA,250,253,3,24,14542,0,0
15050,ACGTCGAATCTAGGGA,250,250,0,22,14544,0,0
15051,ACGTCGAATCTAGGGA,250,252,2,19,14591,0,0
15052,ACGTCGAATCTAGGGA,250,253,3,18,14593,0,0
15053,ACGTCGAATCTAGGGA,250,252,2,17,14594,0,0
15054,ACGTCGAATCTAGGGA,250,250,0,21,14595,0,0
15055,ACGTCGAATCTAGGGA,250,252,2,16,14596,0,0
15056,ACGTCGAATCTAGGGA,250,250,0,18,14597,0,0
15057,ACGTCGAATCGAGGGA,250,252,2,22,14598,0,0
15058,ACGTAGCATCTAGGGA,250,253,3,23,14599,0,0
15059,ACGTCGAATCTAGGGA,250,250,0,20,14600,0,0
15060,ACGTCGAATCTAGGGA,250,253,3,19,14604,0,0
15061,AAGTCGAATCTATGGA,250,253,3,21,14606,0,0
15062,ACGACGAATCGAGGGA,250,253,3,17,14607,0,0
15063,ACGTCGAATCGAGGGA,250,253,3,17,14612,0,0
15064,ACGTCGAATCTAGGGA,250,253,3,18,14619,0,0
15065,ACGTCGAATCTAGGGA,250,253,3,24,14622,0,0
15066,ACGTCGAATCTAGGGA,250,250,0,23,14623,0,0
15067,ACGTTGAATCTAGGGA,250,253,3,24,14626,0,0
15068,ACGTCGAATCTAGGGA,250,253,3,20,14631,0,0
15069,ACGTCGATTCTAGGGA,250,253,3,20,14632,0,0
15070,ACGTCGAATCTAGGGA,251,255,4,16,12890,0,0
15071,ACGTCGAATGTAGGGA,251,257,6,18,13217,0,0
15072,ACGTCGAATCTAGGGA,251,255,4,19,13248,0,0
15073,ACGTCGAATGTAGGGA,251,260,9,19,13263,1,0
15074,ACGTCGATTCTGGGGA,251,272,21,18,13267,5,0
15075,ACGTCGAATCTAGGGA,251,267,16,15,13776,3,0
15076,ACGTCGAATCTAGGGA,251,284,33,21,13928,9,0
15077,ACGTCGAATCTAGGGA,251,251,0,22,13930,0,0
15078,ACGTCGAATCTAGGGA,251,253,2,22,13936,0,0
15079,TCGTCGAATTTAGGGA,251,253,2,22,14049,0,0
15080,TCGTCGAATCTAGGGA,251,292,41,21,14052,12,0
15081,ACGTCGAATCTAGGGA,251,252,1,21,14109,0,0
15082,ACGTCGAATCTAGGGA,251,264,13,23,14113,2,0
15083,ACGTCGAATCTAGGGA,251,262,11,21,14115,2,0
15084,ACGTCGAATCTAGGGA,251,256,5,19,14292,0,0
15085,ACGTCGAATCTAGGGA,251,267,16,21,14293,3,0
15086,ACGTCGAATCTAGGGA,251,277,26,21,14294,7,0
15087,ACGTCGAATCTAGGGA,251,255,4,19,14295,0,0
15088,ACGTCGAATCTAGGGA,251,265,14,22,14297,3,0
15089,ACGTCGAATCTAGGGA,251,251,0,22,14305,0,0
15090,ACGTCGAATCTAGGGA,251,261,10,22,14399,1,0
15091,ACGTCGAATCTAGGGT,251,251,0,23,14403,0,0
15092,ACGTCGAATCTAGGGA,251,251,0,20,14404,0,0
15093,TCGTCGAATTTAGGGA,251,255,4,23,14406,0,0
15094,ACGTCGAATCTAGGGA,251,252,1,22,14407,0,0
15095,ACGTCGAATCTAGGGA,251,254,3,19,14480,0,0
15096,ACGTCGAATCTAGGGA,251,274,23,22,14484,6,0
15097,ACGTCGAATCTAGGGA,251,257,6,23,14486,0,0
15098,ACGTCGAATCTAGGGA,251,253,2,19,14495,0,0
15099,ACGTCGAATCTAGGGA,251,260,9,18,14498,1,0
15100,ACGTCGAATCTAGGGA,251,262,11,25,14499,2,0
15101,ACGTCGAATCTAGGGA,251,287,36,24,14501,10,0
15102,ACGTCGAATCTAGGGA,251,303,52,17,14502,15,0
15103,ACGTCGACTCTAGGGA,251,257,6,19,14503,0,0
15104,ACGTCGAATCTAGGGA,251,256,5,23,14508,0,0
15105,ACGTCGAATCTAGGGA,251,258,7,22,14510,0,0
15106,ACGTCGAATCTAGGGA,251,254,3,24,14512,0,0
15107,ACGTCGAATCTAGGGA,251,261,10,19,14517,1,0
15108,ACGTCGAATCTAGGGA,251,255,4,25,14520,0,0
15109,ACGTAGAATCTAGGGA,251,257,6,18,14662,0,0
15110,TCGTCGAATCTAGGGA,251,256,5,22,14663,0,0
15111,ACGTCGAATCTAGGGA,251,269,18,19,14664,4,0
15112,ACGTCGAATCTAGGGA,251,255,4,22,14665,0,0
15113,ACGTCGAATCTAGGGA,251,251,0,21,14666,0,0
15114,ACGTCGAATCTAGGGA,251,258,7,21,14667,0,0
15115,ACGTCGAATCTAGGGA,251,256,5,19,14668,0,0
15116,ACGTCGAATCTAGGGA,251,258,7,25,14670,0,0
15117,ACGTCGAATGTAGGGA,251,268,17,20,14671,4,0
15118,ACGTCGAATCTAGGGA,251,262,11,22,14672,2,0
15119,ACGTCGAATCTAGGGA,251,254,3,23,14673,0,0
15120,ACGTCGAATCTAGGGA,251,251,0,24,14674,0,0
15121,ACGTCGAATCTAGGGA,251,258,7,18,14676,0,0
15122,ACGTCGAATCTAGGGA,251,256,5,19,14678,0,0
15123,ACGTCGAATCTAGGGA,251,256,5,25,14680,0,0
15124,ACGTCGAATCTAGGGA,251,252,1,18,14685,0,0
15125,TCGTCGAATCTATTGA,251,255,4,23,14687,0,0
15126,ACGTCGAATCTAGGGA,251,252,1,22,14688,0,0
15127,ACGTCGAATCTAGGGA,251,263,12,23,14689,1,0
15128,ACGTCGAATCTAGGGA,251,261,10,25,14691,1,0
15129,ACGTCGAATCTAGGGA,251,258,7,22,14692,0,0
15130,ACGTCGAATCTAGGGA,251,265,14,18,14695,2,0
15131,ACGTCGAATCTAGGGA,251,260,9,25,14697,0,0
15132,ACGTCGAATCTAGGGA,251,251,0,23,14700,0,0
15133,ACGTCGAATCTAGGGA,252,264,12,18,12538,2,0
15134,ACGTCGAATCTAGGGA,252,264,12,15,12541,2,0
15135,ACGTCGAATCTAGGGA,252,256,4,17,12623,0,0
15136,ACGTCGAATCTAGGGA,252,252,0,20,13108,0,0
15137,ACGTCGAATCTAGGGA,252,254,2,15,13109,0,0
15138,ACGTCGAATCGAGGGA,252,252,0,21,13130,0,0
15139,ACGTCGAATCTAGGGA,252,265,13,19,13147,2,0
15140,ACGTCGAATCTAGGGA,252,253,1,16,13464,0,0
15141,ACGTCGAATCGAGGGA,252,252,0,16,13471,0,0
15142,ACGTCGAATCTAGGGA,252,262,10,17,13569,1,0
15143,ACGTCGTATCTAGGGA,252,253,1,21,13642,0,0
15144,ACGTCGAATCTAGGGA,252,258,6,20,13656,0,0
15145,ACGTCGAATGTAGGGA,252,262,10,19,13661,1,0
15146,ACGTCGAATCTAGGGA,252,259,7,23,13671,0,0
15147,ACGTCGAATCTAGGGA,252,268,16,21,13829,3,0
15148,ACGTCGAATCTAGGGA,252,260,8,22,14017,1,0
15149,ACGTCGAATCTAGGGA,252,258,6,22,14032,0,0
15150,ACGTCGAATCTAGGGA,252,261,9,23,14039,1,0
15151,ACGTTGAATCTAGGGA,252,254,2,23,14177,0,0
15152,ACGTCGAATCTAGGGA,252,267,15,22,14179,3,0
15153,ACGTCGATTCTAGGGA,252,265,13,19,14190,2,0
15154,ACGTCGAATCTAGGGA,252,258,6,23,14207,0,0
15155,TCGTCGAATCTAGGGA,252,259,7,23,14209,0,0
15156,ACGTCGAATCTAGGGA,252,255,3,24,14212,0,0
15157,ACGTCGAATCGAGGGA,252,254,2,17,14251,0,0
15158,ACGTCGAATCGAGGGA,252,255,3,23,14254,0,0
15159,ACGTCGAATCTAGGGA,252,255,3,22,14260,0,0
15160,ACGTCGAATCTAGGGA,252,255,3,17,14365,0,0
15161,ACGTCGAATCTAGGGA,252,255,3,21,14366,0,0
15162,ACGTCGAATGTAGGGA,252,255,3,20,14379,0,0
15163,ACGTCGAATCTAGGGA,252,253,1,18,14382,0,0
15164,ACGTCGAATCTAGGGA,252,255,3,16,14388,0,0
15165,ACGTCGAATCTGGGGA,252,255,3,19,14393,0,0
15166,ACGTCGAATCTAGGGA,252,255,3,16,14394,0,0
15167,ACGTCGAATGTAGGGA,252,255,3,19,14553,0,0
15168,ACGTCGAATCCAGGGA,252,255,3,18,14556,0,0
15169,ACGTCGAATCTAGGGA,252,255,3,20,14557,0,0
15170,ACGTCGATTCTGGGGA,252,255,3,19,14560,0,0
15171,ACGTCGAATCTAGGGA,252,255,3,21,14732,0,0
15172,ACGTCGAATCTAGGGA,252,255,3,17,14733,0,0
15173,ACGTCGAATCTAGGGA,252,255,3,17,14735,0,0
15174,ACGTCGAATGTAGGGA,252,252,0,19,14736,0,0
15175,ACGTCGAATCTAGGGA,252,255,3,20,14737,0,0
15176,ACGTCGAATGTAGGGA,252,255,3,20,14739,0,0
15177,TCGTCGAATCTAGGGA,253,255,2,21,12309,0,0
15178,ACGTCGAATCTAGGGT,253,277,24,18,12511,6,0
15179,ACGTCGAATCTAGGGA,253,260,7,20,12665,0,0
15180,ACGTCGAATCTAGGGA,253,258,5,18,12853,0,0
15181,ACGTCGAATCTAGGGA,253,253,0,21,13168,0,0
15182,ACGTCGAATCTAGGGA,253,260,7,22,13174,0,0
15183,ACGTCGAATCTAGGGA,253,263,10,22,13345,1,0
15184,ACGTCGAATCTAGGGA,253,308,55,18,13356,16,0
15185,ACGTCGAATCTAGGGA,253,255,2,17,13382,0,0
15186,ACGTCGAATCTAGGGA,253,287,34,24,13385,9,0
15187,ACGTCGAATCTAGGGA,253,258,5,18,13534,0,0
15188,ACGTCGAATCTAGGGA,253,254,1,23,13538,0,0
15189,ACGTCGAATCTAGGGA,253,259,6,17,13553,0,0
15190,ACGTCGAATCTAGGGA,253,268,15,23,13554,3,0
15191,TCGTCGAATCTATTGA,253,262,9,22,13719,1,0
15192,ACGTCGAATCTAGGGA,253,264,11,23,13786,2,0
15193,ACGTCGAATCTAGGGA,253,265,12,21,13881,2,0
15194,ACGTCGAATCTAGGGA,253,263,10,19,13886,1,0
15195,ACGTCGAATCTAGGGA,253,256,3,27,13903,0,0
15196,ACGTCGAATCTAGGGA,253,255,2,20,14067,0,0
15197,ACGTCGAATCTAGGGA,253,260,7,21,14068,0,0
15198,ACGTCGAATCTAGTGA,253,261,8,17,14073,1,0
15199,ACGTCGAATCTAGGGA,253,255,2,21,14077,0,0
15200,ACGTCGAATCTAGGGA,253,258,5,27,14079,0,0
15201,ACGTCGAATCTAGGGA,253,257,4,23,14084,0,0
15202,ACGTCGAATCTAGGGA,253,267,14,21,14088,3,0
15203,ACGTCGAATCTAGGGA,253,260,7,16,14225,0,0
15204,ACGTCGAATCGAGGGA,253,264,11,22,14238,2,0
15205,ACGTCGAATCTAGGGA,253,260,7,20,14242,0,0
15206,ACGTCGAATCTAGGGA,253,256,3,21,14243,0,0
15207,ACGTCGAATCTAGGGA,253,256,3,19,14247,0,0
15208,ACGTCGAATCTAGGGA,253,256,3,19,14309,0,0
15209,ACGTCGAATCTAGGGA,253,254,1,18,14409,0,0
15210,ACGTCGAATCTAGGGA,253,256,3,24,14521,0,0
15211,ACGTCGAATCTAGGGA,253,256,3,24,14527,0,0
15212,ACGTCGAATCTAGGGA,253,256,3,25,14528,0,0
15213,ACGTCGAATCTAGGGA,253,256,3,22,14529,0,0
15214,ACGTCGAATCTAGGGA,253,256,3,22,14534,0,0
15215,ACGTCGAATCTAGGGA,253,256,3,24,14535,0,0
15216,ACGTCGAATCTAGGGA,253,256,3,17,14536,0,0
15217,ACGTCGAATCTAGGGA,253,256,3,24,14542,0,0
15218,ACGTCGAATCTAGGGA,253,256,3,19,14591,0,0
15219,ACGTCGAATCTAGGGA,253,253,0,21,14595,0,0
15220,ACGTCGAATCTAGGGA,253,256,3,16,14596,0,0
15221,ACGTAGCATCTAGGGA,253,256,3,23,14599,0,0
15222,ACGTCGAATCTAGGGA,253,256,3,20,14600,0,0
15223,ACGTCGAATCTAGGGA,253,255,2,19,14604,0,0
15224,AAGTCGAATCTATGGA,253,256,3,21,14606,0,0
15225,ACGTCGAATCTAGGGA,253,256,3,24,14622,0,0
15226,ACGTCGAATCTAGGGA,253,254,1,23,14623,0,0
15227,ACGTTGAATCTAGGGA,253,256,3,24,14626,0,0
15228,ACGTCGAATCTAGGGA,253,253,0,20,14631,0,0
15229,ACGTCGAATCTAGGGA,253,256,3,22,14703,0,0
15230,ACGTCGAATCTAGGGA,253,256,3,24,14708,0,0
15231,ACGTAGAATCTAGGGA,253,256,3,20,14709,0,0
15232,ACGTCGAATCTAGGGA,253,256,3,28,14712,0,0
15233,ACGTCGAATCGAGGGA,253,256,3,24,14713,0,0
15234,ACGTCGAATCTAGGGA,253,254,1,19,14775,0,0
15235,ACGTCGAATCTAGGGA,253,255,2,16,14776,0,0
15236,ACGTCGAATCTAGGGA,253,255,2,18,14777,0,0
15237,ACGTCGAATCTAGGGA,253,256,3,21,14778,0,0
15238,ACGTCGAATCTAGGGA,253,256,3,16,14779,0,0
15239,ACGTCGAATCGAGGGA,253,256,3,22,14780,0,0
15240,ACGTCGAATCTAGGGA,253,256,3,19,14782,0,0
15241,ACGTCGAATCTAGGGA,253,256,3,17,14783,0,0
15242,ACGTCGAATCTAGGGA,253,253,0,21,14787,0,0
15243,ACGTCGAATCAAGGGA,253,256,3,22,14792,0,0
15244,ACGTTGAATCTAGGGA,253,256,3,24,14796,0,0
15245,ACATCGAATCTAGGGA,253,255,2,23,14798,0,0
15246,ACGTCGATTCTAGGGA,253,255,2,20,14800,0,0
15247,CCGTCGAATGTAGGGA,253,254,1,20,14807,0,0
15248,ACGTCGAATCTAGGGA,254,265,11,16,12890,2,0
15249,ACGTCGAATGTAGGGA,254,266,12,18,13217,2,0
15250,ACGTCGAATCTAGGGA,254,271,17,19,13248,4,0
15251,ACGTCGAAAGTAGGGA,254,305,51,19,13263,15,0
15252,ACGTCGATTCTGGGGA,254,264,10,18,13267,1,0
15253,ACGTCGAATCTAGGGA,254,273,19,15,13776,4,0
15254,ACGTCGAATCTAGGGA,254,255,1,21,13928,0,0
15255,ACGTCGAATCTAGGGA,254,254,0,22,13930,0,0
15256,ACGTCGAATCTAGGGA,254,264,10,22,13936,1,0
15257,TCGTCGAATCTAGGGA,254,255,1,21,14052,0,0
15258,ACGTCGAATCTAGGGA,254,263,9,21,14115,1,0
15259,ACGTCGAATCTAGGGA,254,264,10,21,14294,1,0
15260,ACGTCGAATCTAGGGA,254,258,4,19,14295,0,0
15261,ACGTCGAATCTAGGGA,254,254,0,22,14297,0,0
15262,ACGTCGAATCTAGGGA,254,255,1,22,14305,0,0
15263,ACGTCGAATCTAGGGA,254,266,12,22,14399,2,0
15264,ACGTCGAATCTAGGGA,254,265,11,20,14404,2,0
15265,ACGTCGAATCTAGGGA,254,309,55,22,14484,16,0
15266,ACGTCGAATCTAGGGA,254,260,6,18,14498,0,0
15267,ACGTCGAATCTAGGGA,254,262,8,24,14501,1,0
15268,ACGTCGAATCTAGGGA,254,270,16,17,14502,3,0
15269,ACGTCGACTCTAGGGA,254,287,33,19,14503,8,0
15270,ACGTCGAATCTAGGGA,254,257,3,23,14508,0,0
15271,ACGTCGAATCTAGGGA,254,256,2,24,14512,0,0
15272,ACGTCGAATCTAGGGA,254,295,41,19,14517,11,0
15273,ACGTCGAATCTAGGGA,254,278,24,25,14520,5,0
15274,ACGTAGAATCTAGGGA,254,258,4,18,14662,0,0
15275,TCGTCGAATCTAGGGA,254,266,12,22,14663,1,0
15276,ACGTCGAATCTAGGGA,254,257,3,22,14665,0,0
15277,ACGTCGAATCTAGGGA,254,254,0,21,14667,0,0
15278,ACGTCGAATCTAGGGA,254,268,14,19,14668,2,0
15279,ACGTCGAATCTAGGGA,254,257,3,23,14673,0,0
15280,ACGTCGAATCTAGGGA,254,254,0,24,14674,0,0
15281,ACGTCGAATCTAGGGA,254,261,7,18,14676,0,0
15282,ACGTCGAATCTAGGGA,254,266,12,19,14678,1,0
15283,ACGTCGAATCTAGGGA,254,273,19,25,14680,4,0
15284,ACGTCGAATCTAGGGA,254,254,0,18,14685,0,0
15285,TCGTCGAATCTATTGA,254,280,26,23,14687,6,0
15286,ACGTCGAATCTAGGGA,254,256,2,23,14689,0,0
15287,ACGTCGAATCTAGGGA,254,258,4,25,14691,0,0
15288,ACGTCGAATCTAGGGA,254,261,7,22,14692,0,0
15289,ACCTCGAATCTAGGGA,254,255,1,18,14695,0,0
15290,ACGTCGAATCTAGGGA,254,268,14,25,14697,2,0
15291,ACGTCGAATCTAGGGA,254,269,15,23,14700,2,0
15292,ACGTCGAATCTAGGGA,254,257,3,16,14745,0,0
15293,ACGTCGAATCTAGGGA,254,266,12,16,14751,1,0
15294,ACGTCGGATCTAGGGA,254,258,4,23,14752,0,0
15295,ACGTCGAATCTAGGGA,254,254,0,20,14753,0,0
15296,ACGTAGAATCTAGGGA,254,257,3,18,14837,0,0
15297,TCGTCGAATCTAGGGA,254,254,0,22,14838,0,0
15298,ACGTCGAATCTAGGGA,254,267,13,19,14839,2,0
15299,ACGTCGAATCTAGGGA,254,269,15,21,14840,2,0
15300,ACGTCGAATCTAGGGA,254,258,4,22,14845,0,0
15301,ACGTCGAATCTAGGGA,254,256,2,23,14846,0,0
15302,ACGTCGAATCTAGGGA,254,260,6,17,14852,0,0
15303,ACGTCGAATCTAGGGA,254,258,4,24,14853,0,0
15304,ACGTCGAATCTAGGGA,254,266,12,18,14856,1,0
15305,ACGTCGAATCTAGGGA,254,257,3,24,14857,0,0
15306,TCGTCGAATCTATTGA,254,257,3,23,14858,0,0
15307,ACGTCGAATCTAGGGA,254,257,3,22,14859,0,0
15308,ACGTCGAATCTAGGGA,254,257,3,20,14862,0,0
15309,ACGTCGAATCTAGGGA,255,266,11,15,12541,2,0
15310,ACGTCGAATCTAGGGA,255,267,12,17,12623,2,0
15311,ACGTCGAATCTAGGGA,255,267,12,20,13108,2,0
15312,ACGTCGAATCGAGGGA,255,275,20,21,13130,5,0
15313,ACGTCGAATCTAGGGA,255,255,0,19,13147,0,0
15314,ACGTCGAATCTAGGGA,255,256,1,16,13464,0,0
15315,ACGTCGAATCGAGGGA,255,255,0,16,13471,0,0
15316,ACGTCGAATCTAGGGA,255,261,6,17,13569,0,0
15317,ACGTCGAATCTAGGGA,255,258,3,21,13642,0,0
15318,ACGTCGAATCTAGGGA,255,258,3,20,13656,0,0
15319,ACGTCGAATGTAGGGA,255,258,3,19,13661,0,0
15320,ACGTCGAATCTAGGGA,255,255,0,23,13671,0,0
15321,ACGTCGAATCTAGGGA,255,258,3,21,13829,0,0
15322,ACGTCGAATCTAGGGA,255,258,3,22,14017,0,0
15323,ACGTCGAATCTAGGGA,255,258,3,22,14032,0,0
15324,ACGTCGAATCTAGGGA,255,258,3,23,14039,0,0
15325,ACGTTGAATCTAGGGA,255,258,3,23,14177,0,0
15326,ACGTCGAATCTAGGGA,255,258,3,22,14179,0,0
15327,TCGTCGAATCTAGGGA,255,258,3,23,14209,0,0
15328,ACGTCGAATCTAGGGA,255,258,3,24,14212,0,0
15329,ACGTCGAATCGAGGGA,255,258,3,17,14251,0,0
15330,ACGTCGAATCTAGGGA,255,258,3,22,14260,0,0
15331,ACGTCGAATCTAGGGA,255,258,3,21,14366,0,0
15332,ACGTCGAATCTAGGGA,255,258,3,18,14382,0,0
15333,ACGTCGAATCTAGGGA,255,258,3,16,14388,0,0
15334,ACGTCGAATCCAGGGA,255,258,3,18,14556,0,0
15335,ACGTCGAATCTAGGGA,255,258,3,20,14557,0,0
15336,TCGTCGAATCTAGGGA,255,258,3,21,14732,0,0
15337,ACGTCGAATCTAGGGA,255,258,3,17,14735,0,0
15338,ACGTCGAATGTAGGGA,255,258,3,19,14736,0,0
15339,ACGTCGAATCTAGGGA,255,258,3,20,14737,0,0
15340,ACGTCGAATGTAGGGA,255,258,3,20,14739,0,0
15341,ACGTCGAATCTAGGGA,255,258,3,21,14893,0,0
15342,ACGTCGAATGTAGGAA,255,255,0,20,14897,0,0
15343,ACGTCGACTCTAGGGA,255,258,3,23,14901,0,0
15344,ACGTCGAATCTAGGGA,255,258,3,20,14905,0,0
15345,TCGTCGAATCTAGCGA,255,258,3,22,14907,0,0
15346,ACGTCGAATCTAGGGA,255,258,3,24,14909,0,0
15347,ACGTCGAATCTAGGGA,255,258,3,22,14910,0,0
15348,ACGTCGAATCTAGGGA,255,258,3,22,14912,0,0
15349,ACGTCGAATCTAGGGA,255,257,2,22,14913,0,0
15350,TCGTCGAATCTAGGGA,256,259,3,21,12309,0,0
15351,ACGTCGAATCTAGGGA,256,275,19,20,12665,4,0
15352,ACGTCGAATCTAGGGA,256,261,5,18,12853,0,0
15353,ACGTCGAATCTAGGGA,256,259,3,21,13168,0,0
15354,ACGTCGAATCTAGGGA,256,257,1,22,13174,0,0
15355,ACGTCGAATCTAGGGA,256,267,11,22,13345,2,0
15356,ACGTCGAATCTAGGGA,256,258,2,18,13356,0,0
15357,ACGTCGAATCTAGGGA,256,264,8,24,13385,1,0
15358,ACGTCGAATCTAGGGA,256,269,13,18,13534,2,0
15359,ACGTCGAATCTAGGGA,256,267,11,23,13538,2,0
15360,ACGTCGAATCTAGGGA,256,264,8,17,13553,1,0
15361,ACGTCGAATCTAGGGA,256,273,17,23,13554,4,0
15362,TCGTCGAATCTATTGA,256,274,18,22,13719,4,0
15363,ACGTCGAATCTAGGGA,256,259,3,23,13786,0,0
15364,ACGTCGAATCTAGGGA,256,270,14,21,13881,3,0
15365,ACGTCGAATCTAGGGA,256,258,2,27,13903,0,0
15366,ACGTCGAATCTAGGGA,256,272,16,21,14068,3,0
15367,ACGTCGAATCTAGGGA,256,267,11,21,14077,2,0
15368,ACGTCGAATCTAGGGA,256,266,10,27,14079,1,0
15369,ACGTCGAATCTAGGGA,256,265,9,23,14084,1,0
15370,ACGTCGAATCTAGGGA,256,256,0,21,14088,0,0
15371,ACGTCGAATCTAGGGA,256,257,1,16,14225,0,0
15372,ACGTCGAATCGAGGGA,256,257,1,22,14238,0,0
15373,ACGTCGAATCTAGGGA,256,257,1,21,14243,0,0
15374,ACGTCGAATCTAGGGA,256,285,29,19,14247,8,0
15375,ACGTCGAATCTAGGGA,256,278,22,18,14409,5,0
15376,ACGTCGAATCTAGGGA,256,256,0,24,14521,0,0
15377,ACGTCGAATCTAGGGA,256,270,14,22,14529,3,0
15378,ACGTCGAATCTAGGGA,256,268,12,24,14535,2,0
15379,ACGTCGAATCTAGGGA,256,301,45,17,14536,13,0
15380,ACGTCGAATCTAGGGA,256,265,9,24,14542,1,0
15381,ACGTCGAATCTAGGGA,256,263,7,19,14591,0,0
15382,ACGTCGAATCTAGGGA,256,271,15,21,14595,3,0
15383,ACGTCGAATCTAGGGA,256,256,0,16,14596,0,0
15384,ACGTCGAATCTAGGGA,256,261,5,20,14600,0,0
15385,ACGTCGAATCTAGGGA,256,257,1,19,14604,0,0
15386,AAGTCGAATCTATGGA,256,262,6,21,14606,0,0
15387,ACGTCGAATCTAGGGA,256,257,1,24,14622,0,0
15388,ACGTTGAATCTAGGGA,256,259,3,24,14626,0,0
15389,ACGTCGAATCTAGGGA,256,258,2,22,14703,0,0
15390,ACGTCGAATCTAGGGA,256,261,5,24,14708,0,0
15391,ACGTAGAATCTAGGGA,256,259,3,20,14709,0,0
15392,ACGTCGAATCGAGGGA,256,270,14,24,14713,3,0
15393,ACGTCGAATCTAGGGA,256,256,0,19,14775,0,0
15394,ACGTCGAATCTAGGGA,256,260,4,18,14777,0,0
15395,ACGTCGAATCTAGGGA,256,267,11,21,14778,2,0
15396,ACGTCGAATCTAGGGA,256,259,3,16,14779,0,0
15397,ACGTCGAATCTAGGGA,256,260,4,19,14782,0,0
15398,ACGTCGAATCTAGGGA,256,282,26,17,14783,6,0
15399,ACGTCGAATCTAGGGA,256,277,21,21,14787,4,0
15400,ACGTCGAATCTAGGGA,256,258,2,22,14792,0,0
15401,ACGTTGAATCTAGGGA,256,256,0,24,14796,0,0
15402,ACATCGAATCTAGGGA,256,262,6,23,14798,0,0
15403,ACGTCGATTCTAGGGA,256,257,1,20,14800,0,0
15404,CCGTCGAATGTAGGGA,256,262,6,20,14807,0,0
15405,ACGTCGAATCTAGGGA,256,268,12,25,14864,1,0
15406,ACGTCGAATCTAGTGA,256,256,0,24,14867,0,0
15407,ACGTAGAATCTAGGGA,256,264,8,21,14869,0,0
15408,ACGTCGAATCTAGGGA,256,261,5,22,14871,0,0
15409,ACGTCGAATCTAGGGA,256,261,5,18,14873,0,0
15410,ACGTCGAATCTAGGGA,256,257,1,17,14878,0,0
15411,ACGTCGAAACTAGGGA,256,256,0,19,14946,0,0
15412,ACGTCGAATCTAGGGA,256,256,0,16,14947,0,0
15413,ACGTCGAATCTAGGGA,256,265,9,21,14949,0,0
15414,ACGTCGAATCTATGGA,256,257,1,16,14950,0,0
15415,ACGTCGAATCGAGGGA,256,262,6,22,14951,0,0
15416,ACGTCGAATCTAGGGA,256,262,6,24,14959,0,0
15417,ACGTCGAATCTAGGGA,256,272,16,22,14961,3,0
15418,ACGTCGAATCTAGGGA,256,265,9,23,14965,0,0
15419,ACGTTGAATCTAGGGA,256,266,10,24,14969,1,0
15420,ACGTCGATTCTAGGGA,256,263,7,20,14972,0,0
15421,TCGTCGAATCTAGGGA,256,256,0,24,14976,0,0
15422,GCGTCGAATCTAGGGA,256,258,2,26,14978,0,0
15423,ACGTCGAATCTAGGGA,256,259,3,24,14979,0,0
15424,ACGTCGAATCGAGGGA,256,259,3,24,14981,0,0
15425,ACGTCGAATCTAGGGA,256,259,3,23,14983,0,0
15426,ACGTCGAATCTAGGGA,256,257,1,18,14984,0,0
15427,ACGTCGAATCTAGGGA,256,259,3,22,14985,0,0
15428,ACGTCGAATCTAGGGA,256,259,3,17,14986,0,0
15429,ACGTCGAATGTAGGGA,256,259,3,21,14987,0,0
15430,ACGTCGAATCTAGGGA,257,271,14,16,12890,3,0
15431,ACGTCGAATGTAGGGA,257,287,30,18,13217,8,0
15432,ACGTCGAATCTAGGGA,257,266,9,19,13248,1,0
15433,ACGTCGATTCTGGGGA,257,263,6,18,13267,0,0
15434,ACGTCGAATCTAGGGA,257,265,8,15,13776,1,0
15435,ACGTCGAATCTAGGGA,257,260,3,21,13928,0,0
15436,ACGTCGAATCTAGGGA,257,259,2,22,13930,0,0
15437,ACGTCGAATCTAGGGA,257,257,0,22,13936,0,0
15438,ACGTCGAATCTAGGGA,257,260,3,21,14115,0,0
15439,ACGTCGAATCTAGGGA,257,258,1,21,14294,0,0
15440,ACGTCGAATCTAGGGA,257,262,5,19,14295,0,0
15441,ACGTCGAATCTAGGGA,257,260,3,22,14297,0,0
15442,ACGTCGAATCTAGGGA,257,259,2,22,14305,0,0
15443,ACGTCGAATCTAGGGA,257,258,1,20,14404,0,0
15444,ACGTCGAATCTAGGGA,257,260,3,22,14484,0,0
15445,ACGTCGAATCTAGGGA,257,260,3,18,14498,0,0
15446,ACGTCGAATCTAGGGA,257,260,3,24,14501,0,0
15447,ACGTCGAATCTAGGGA,257,260,3,17,14502,0,0
15448,ACGTCGACTCTAGGGA,257,260,3,19,14503,0,0
15449,ACGTCGAATCTAGGGA,257,260,3,23,14508,0,0
15450,ACGTCGAATCTAGGGA,257,259,2,24,14512,0,0
15451,ACGTCGAATCTAGGGA,257,258,1,25,14520,0,0
15452,ACGTAGAATCTAGGGA,257,260,3,18,14662,0,0
15453,TCGTCGAATCTAGGGA,257,260,3,22,14663,0,0
15454,ACGTCGAATCTAGGGA,257,260,3,22,14665,0,0
15455,ACGTCGAATCTAGGGA,257,259,2,21,14667,0,0
15456,ACGTCGAATCTAGGGA,257,257,0,19,14668,0,0
15457,ACGTCGAATCTAGGGA,257,258,1,24,14674,0,0
15458,ACGTCGAATCTAGGGA,257,258,1,19,14678,0,0
15459,ACGTCGAATCTAGGGA,257,260,3,25,14680,0,0
15460,ACGTCGAATCTAGGGA,257,260,3,18,14685,0,0
15461,TCGTCGAATCTATTGA,257,260,3,23,14687,0,0
15462,ACGTCGAATCTAGGGA,257,260,3,23,14689,0,0
15463,ACGTCGAATCTAGGGA,257,260,3,18,14695,0,0
15464,ACGTCGAATCTAGGGA,257,260,3,25,14697,0,0
15465,ACGTCGAATCTAGGGA,257,260,3,23,14700,0,0
15466,ACGTCGAATCTAGGGA,257,258,1,16,14745,0,0
15467,ACGTCGGATCTAGGGA,257,260,3,23,14752,0,0
15468,ACGTAGAATCTAGGGA,257,260,3,18,14837,0,0
15469,TCGTCGAATCTAGGGA,257,257,0,22,14838,0,0
15470,ACGTCGAATCTAGGGA,257,260,3,21,14840,0,0
15471,ACGTCGAATCTAGGGA,257,260,3,22,14845,0,0
15472,ACGTCGAATCTAGGGA,257,259,2,23,14846,0,0
15473,ACGTCGAATCTAGGGA,257,260,3,17,14852,0,0
15474,ACGTCGAATCTAGGGA,257,260,3,24,14853,0,0
15475,ACGTCGAATCTAGGGA,257,259,2,18,14856,0,0
15476,ACGTCGAATCTAGGGA,257,260,3,24,14857,0,0
15477,TCGTCGAATCTATTGA,257,260,3,23,14858,0,0
15478,ACGTCGAATCTAGGGA,257,260,3,22,14859,0,0
15479,ACGTCGAATCTAGGGA,257,260,3,20,14862,0,0
15480,ACGTCGAATCTAGGGA,257,258,1,20,14914,0,0
15481,ACGTCGAATCTAGGGA,257,260,3,19,14999,0,0
15482,ACGTCGAATCTAGGGA,257,260,3,21,15001,0,0
15483,ACGTCGAATCTAGGGA,257,260,3,23,15005,0,0
15484,ACGTCGAATCTAGGGA,257,260,3,18,15008,0,0
15485,ACGTCGAATCTAGGGA,257,260,3,25,15009,0,0
15486,ACGTCGAATCTAGGGA,258,276,18,15,12541,4,0
15487,ACGTCGAATCTAGGGA,258,262,4,20,13108,0,0
15488,ACGTCGAATCGAGGGA,258,261,3,21,13130,0,0
15489,ACGTCGAATCTAGGGA,258,274,16,19,13147,3,0
15490,ACGTCGAATCTAGGGA,258,272,14,16,13464,3,0
15491,ACGTCGAATCTAGGGA,258,263,5,17,13569,0,0
15492,ACGTCGAATCTAGGGA,258,270,12,21,13642,2,0
15493,ACGTCGAATCTAGGGA,258,266,8,20,13656,1,0
15494,ACGTCGAATGTAGGGA,258,264,6,19,13661,0,0
15495,ACGTCGAATCTAGGGA,258,262,4,23,13671,0,0
15496,ACGTCGAATCTAGGGA,258,272,14,21,13829,3,0
15497,ACGTCGAATCTAGGGA,258,283,25,22,14032,6,0
15498,ACGTCGAATCTAGGGA,258,259,1,23,14039,0,0
15499,ACGTCGAATCTAGGGA,258,258,0,22,14179,0,0
15500,TAGTCGAATCTAGGGA,258,260,2,23,14209,0,0
15501,ACGTCGAATCTAGGGA,258,273,15,24,14212,3,0
15502,ACGTCGAATCGAGGGA,258,292,34,17,14251,9,0
15503,ACGTCGAATCTAGGGA,258,288,30,21,14366,8,0
15504,ACGTCGAAGCTAGGGA,258,264,6,18,14382,0,0
15505,ACGTCGAATCTAGGGA,258,258,0,16,14388,0,0
15506,ACGTCGAATCCAGGGA,258,265,7,18,14556,0,0
15507,ACGTCGAATCTAGGGA,258,263,5,20,14557,0,0
15508,ACGTCGAATCTAGGGA,258,268,10,21,14732,1,0
15509,ACGTCGAATCTAGGGA,258,261,3,17,14735,0,0
15510,ACGTCGAATGTAGGGA,258,263,5,19,14736,0,0
15511,ACGTCGAATCTAGGGA,258,265,7,20,14737,0,0
15512,ACGTCGAATCTAGGGA,258,276,18,21,14893,4,0
15513,ACGTCGAATCTAGGGA,258,287,29,23,14901,8,0
15514,ACGTCGAATCTAGGGA,258,277,19,20,14905,4,0
15515,ACGTCGAATCTAGGGA,258,260,2,24,14909,0,0
15516,ACGTCGAATCTAGGGA,258,259,1,22,14912,0,0
15517,ACGTCGAATCTAGGGA,258,260,2,22,14913,0,0
15518,ACGTCGAATGTAGGGA,258,281,23,20,15073,6,0
15519,ACGTCGATTCTGGGGA,258,261,3,19,15074,0,0
15520,ACGTCGAATCTAGGGA,258,259,1,16,15075,0,0
15521,ACGTCGAATCTAGGGA,258,259,1,22,15076,0,0
15522,TCGTCGAATCTAGGGA,258,261,3,22,15080,0,0
15523,ACGTCGAATCTAGGGA,258,265,7,24,15082,0,0
15524,ACGTCGAATCTAGGGA,258,265,7,22,15083,0,0
15525,ACGTCGAATCTAGGGA,258,263,5,22,15085,0,0
15526,ACGTCGAATCTAGGGA,258,262,4,22,15086,0,0
15527,ACGTCGAATCTAGGGA,258,269,11,23,15088,2,0
15528,ACGTCGAATCTAGGGA,258,275,17,23,15090,3,0
15529,ACGTCGAATCTAGGGA,258,258,0,23,15096,0,0
15530,ACGTCGAATCTAGGGA,258,263,5,19,15099,0,0
15531,ACGTCGAATCTAGGGA,258,263,5,26,15100,0,0
15532,ACGTCGAATCTAGGGA,258,271,13,25,15101,2,0
15533,ACGTCGAATCTAGGGA,258,260,2,18,15102,0,0
15534,ACGTCGAATCTAGGGA,258,271,13,20,15107,2,0
15535,ACGTCGAATCTAGGGA,258,259,1,20,15111,0,0
15536,ACGTCGAATGTAGGGA,258,266,8,21,15117,0,0
15537,ACGTCGAATCTAGGGA,258,261,3,23,15118,0,0
15538,TCGTCGAATCTAGGGA,259,286,27,21,12309,7,0
15539,ACGTCGAATCTAGGGA,259,262,3,20,12665,0,0
15540,ACGTCGAATCTAGGGA,259,266,7,18,12853,0,0
15541,ACGTCGAATCTAGGGA,259,263,4,21,13168,0,0
15542,ACGTCGAATCTAGGGA,259,293,34,22,13174,9,0
15543,ACGTCGAATCTAGGGA,259,261,2,22,13345,0,0
15544,ACGTCGAATCTAGGGA,259,262,3,18,13356,0,0
15545,ACGTCGAATCTAGGGA,259,260,1,24,13385,0,0
15546,ACGTCGAATCTAGGGA,259,262,3,18,13534,0,0
15547,ACGTCGAATCTAGGGA,259,262,3,23,13538,0,0
15548,ACGTCGAATCTAGGGA,259,262,3,17,13553,0,0
15549,TCGTCGAATCTATTGA,259,260,1,22,13719,0,0
15550,ACGTCGAATCTAGGGA,259,262,3,23,13786,0,0
15551,ACGTCGAATCTAGGGA,259,261,2,21,13881,0,0
15552,ACGTCGAATCTAGGGA,259,262,3,27,13903,0,0
15553,ACGTCGAATCTAGGGA,259,262,3,21,14068,0,0
15554,ACGTCGAATCTAGGGA,259,259,0,21,14077,0,0
15555,ACGTCGAATCTAGGGA,259,262,3,27,14079,0,0
15556,ACGTAGAATCTAGGGA,259,259,0,23,14084,0,0
15557,ACATCGAATCTAGGGA,259,262,3,16,14225,0,0
15558,ACGTAGAATCTAGGGA,259,262,3,21,14243,0,0
15559,ACGTCGAATCTAGGGA,259,260,1,22,14529,0,0
15560,ACGTCGAATCTAGGGA,259,262,3,24,14535,0,0
15561,ACGTCGAATCTAGGGA,259,262,3,17,14536,0,0
15562,ACGTCGAATCTAGGGA,259,262,3,24,14542,0,0
15563,ACGTCGAATCTAGGGA,259,262,3,21,14595,0,0
15564,ACGTCGAATCTAGGGA,259,262,3,16,14596,0,0
15565,ACGTCGAATCTAGGGA,259,262,3,20,14600,0,0
15566,ACGTCGAATCTAGGGA,259,262,3,19,14604,0,0
15567,ACGTCGAATCTAGGGA,259,262,3,24,14622,0,0
15568,ACGTTGAATCTAGGGA,259,262,3,24,14626,0,0
15569,ACGTCGAATCTAGGGA,259,262,3,22,14703,0,0
15570,ACGTCGAATCTAGGGA,259,259,0,24,14708,0,0
15571,ACGTAGAATCTAGGGA,259,261,2,20,14709,0,0
15572,ACGTCGAATCGAGGGA,259,262,3,24,14713,0,0
15573,ACGTCGAATCTAGGGA,259,261,2,21,14778,0,0
15574,ACGTCGAAACTAGGGA,259,262,3,16,14779,0,0
15575,ACGTCGAATCTAGGGA,259,262,3,17,14783,0,0
15576,ACGTCGAATCTAGGGA,259,259,0,21,14787,0,0
15577,ACGTCGAATCTAGGGA,259,262,3,22,14792,0,0
15578,ACGTTGAATCTAGGGA,259,262,3,24,14796,0,0
15579,ACATCGAATCTAGGGA,259,262,3,23,14798,0,0
15580,CCGTCGAATGTAGGGA,259,260,1,20,14807,0,0
15581,ACGTCGAATCTAGGGA,259,262,3,25,14864,0,0
15582,ACGTCGAATCTAGTGA,259,262,3,24,14867,0,0
15583,ACGTAGAATCTAGGGA,259,262,3,21,14869,0,0
15584,ACGTCGAATCTAGGGA,259,262,3,18,14873,0,0
15585,ACGTCGAATCTAGGGA,259,262,3,17,14878,0,0
15586,ACGTCGAATCTAGGGA,259,262,3,19,14946,0,0
15587,ACGTCGAATCTAGGGA,259,262,3,21,14949,0,0
15588,ACGTCGAATCTATGGA,259,259,0,16,14950,0,0
15589,ACGTCGAATCGAGGGA,259,262,3,22,14951,0,0
15590,ACGTCGAATCTAGGGA,259,262,3,24,14959,0,0
15591,ACGTCGAATCTAGGGA,259,262,3,22,14961,0,0
15592,ACGTCGAATCTAGGGA,259,261,2,23,14965,0,0
15593,TCGTCGAATCTAGGGA,259,259,0,24,14976,0,0
15594,ACGGCGAATCTAGGGA,259,262,3,26,14978,0,0
15595,ACGTCGAATCTAGGGA,259,262,3,24,14979,0,0
15596,ACGTCGAATCTAGGGA,259,262,3,23,14983,0,0
15597,ACGTCGAATCTAGGGA,259,262,3,18,14984,0,0
15598,ACGTCGAATGTAGGGA,259,260,1,21,14987,0,0
15599,ACGTCGAATCTAGGGA,259,262,3,19,15133,0,0
15600,ACGTCGAATCTAGGGA,259,262,3,16,15134,0,0
15601,ACGTCGAATCTAGGGA,259,259,0,20,15139,0,0
15602,ACGTCGAATCTAGGGA,259,262,3,18,15142,0,0
15603,ACGTCGAATGTAGGGA,259,262,3,20,15145,0,0
15604,ACGTCGAATCTAGGGA,259,262,3,22,15147,0,0
15605,ACGTCGAATCTAGGGA,259,262,3,23,15148,0,0
15606,ACGTCGAATCTAGGGA,259,262,3,24,15150,0,0
15607,ACGTCGAATCTAGGGA,259,262,3,23,15152,0,0
15608,ACGTCGATTCTAGGGA,259,261,2,20,15153,0,0
15609,ACGTCGAATCTAGGGA,260,264,4,16,12890,0,0
15610,ACGTCGAATCTAGGGA,260,262,2,19,13248,0,0
15611,ACGTCGATTCTGGGGA,260,266,6,18,13267,0,0
15612,ACGTCGAATCTAGGGA,260,268,8,15,13776,1,0
15613,ACGTCGAATCTAGGGA,260,285,25,21,14115,6,0
15614,ACGTCGAATCTAGGGA,260,261,1,19,14295,0,0
15615,ACGTCGAATCTAGGGA,260,266,6,22,14305,0,0
15616,ACGTCGAATCTAGGGA,260,271,11,20,14404,2,0
15617,ACGTCGAATCTAGGGA,260,277,17,22,14484,4,0
15618,ACGTCGAATCTAGGGA,260,267,7,18,14498,0,0
15619,ACGTCGAATCTAGGGA,260,274,14,17,14502,3,0
15620,ACGTCGACTCTAGGGA,260,266,6,19,14503,0,0
15621,ACGTCGAATCTAGGGA,260,281,21,23,14508,5,0
15622,ACGTCGAATCTAGGGA,260,260,0,24,14512,0,0
15623,ACGTCGAATCTAGGGA,260,265,5,25,14520,0,0
15624,ACGTAGAATCTAGGGA,260,266,6,18,14662,0,0
15625,TCGTCGAATCTAGGGA,260,262,2,22,14663,0,0
15626,ACGTCGAATCTAGGGA,260,283,23,21,14667,6,0
15627,ACGTCGAATCTAGGGA,260,274,14,24,14674,3,0
15628,ACGTCGAATCTAGGGA,260,261,1,19,14678,0,0
15629,ACGTCGAATCTAGGGA,260,264,4,23,14689,0,0
15630,ACGTCGAATCTAGGGA,260,270,10,25,14697,1,0
15631,ACGTCGAATCTAGGGA,260,272,12,23,14700,2,0
15632,ACGTCGAATCTAGGGA,260,275,15,16,14745,3,0
15633,ACGTCGGATCTAGGGA,260,282,22,23,14752,5,0
15634,ACGTAGAATCTAGGGA,260,266,6,18,14837,0,0
15635,TCGTCGAATCTAGGGA,260,266,6,22,14838,0,0
15636,ACGTCCAATCTAGGGA,260,275,15,22,14845,3,0
15637,ACGTCGAATCTAGGGA,260,264,4,23,14846,0,0
15638,ACGTCGAATCTAGGGA,260,260,0,18,14856,0,0
15639,ACGTCGAATCTAGGGA,260,264,4,24,14857,0,0
15640,TCGTCGAATCTATTGA,260,274,14,23,14858,3,0
15641,ACGTCGAATCTAGGGA,260,271,11,22,14859,2,0
15642,ACATCGAATCTAGGGA,260,260,0,20,14914,0,0
15643,ACGTCGAATCTAGGGA,260,266,6,19,14999,0,0
15644,ACGTCGAATCTAGGGA,260,267,7,21,15001,0,0
15645,ACGTCGAATCTAGGGA,260,274,14,18,15008,3,0
15646,ACGTCGAATCTAGGGA,260,260,0,25,15009,0,0
15647,ACGTCGAATCTAGGGA,260,261,1,24,15127,0,0
15648,ACGTCGAATCTAGGGA,260,292,32,26,15128,9,0
15649,ACGTCGAATCTAGGGA,260,261,1,19,15130,0,0
15650,ACGTCGAATCTAGGGT,260,264,4,19,15178,0,0
15651,ACGTCGAATCTAGGGA,260,261,1,23,15183,0,0
15652,ACGTCGAATCTAGGGA,260,261,1,19,15184,0,0
15653,ACGTCGAATCTAGGGA,260,261,1,25,15186,0,0
15654,ACGTCGAATCTAGGGA,260,278,18,24,15190,4,0
15655,TCGTCGAATCTATTGA,260,264,4,23,15191,0,0
15656,ACGTCGAATCTAGGGA,260,293,33,24,15192,9,0
15657,ACGTCGAATCTAGGGA,260,261,1,22,15193,0,0
15658,ACGTCGAATCTAGGGA,260,287,27,20,15194,7,0
15659,ACGTCGAATCTAGTGA,260,262,2,18,15198,0,0
15660,ACGTCGAATCTAGGGA,260,264,4,22,15202,0,0
15661,ACGTCGAATCGAGGGA,260,273,13,23,15204,2,0
15662,ACGTCGAATCTAGGGA,261,289,28,15,12541,8,0
15663,ACGTCGAATCGAGGGA,261,267,6,21,13130,1,0
15664,ACGTCGAATCTAGGGA,261,261,0,16,13464,0,0
15665,ACGTCGAATCTAGGGA,261,270,9,17,13569,2,0
15666,ACGTCGAATCTAGGGA,261,271,10,21,13642,2,0
15667,ACGTCGAATCTAGGGA,261,275,14,20,13656,3,0
15668,ACGTCGCATGTAGGGA,261,273,12,19,13661,3,0
15669,ACGTCGAATCTAGGGA,261,268,7,23,13671,1,0
15670,ACGTCGAATCTAGGGA,261,268,7,21,13829,1,0
15671,ACGTCGAATCTAGGGA,261,268,7,22,14032,1,0
15672,ACGTCGAATCTAGGGA,261,274,13,23,14039,3,0
15673,ACGTCGAATCTAGGGA,261,269,8,22,14179,1,0
15674,TCGTCGAATCTAGGGA,261,270,9,23,14209,1,0
15675,ACGTCGAATCGAGGGA,261,271,10,17,14251,1,0
15676,ACGTCGAATCTAGGGA,261,261,0,21,14366,0,0
15677,ACGTCGAATCTAGGGA,261,282,21,16,14388,5,0
15678,ACGTAGAATCTAGGGA,261,262,1,21,14732,0,0
15679,ACGTCGAATGTAGGGA,261,261,0,19,14736,0,0
15680,ACGTCGAATCTAGGGA,261,266,5,20,14737,0,0
15681,ACGTCGAATCTAGGGA,261,262,1,21,14893,0,0
15682,ACGTCGAATCTAGGGA,261,291,30,23,14901,8,0
15683,ACGTCGAATCTAGGGA,261,278,17,20,14905,4,0
15684,ACGTCGAATCTAGGGA,261,261,0,24,14909,0,0
15685,ACGTCGAATCTAGGGA,261,268,7,22,14912,0,0
15686,ACGTCGAATCTAGGGA,261,265,4,22,14913,0,0
15687,ACGTCGATTCTGGGGA,261,277,16,19,15074,3,0
15688,ACGTCGAATCTAGGGA,261,274,13,16,15075,2,0
15689,ACGTCGAATCTAGGGA,261,261,0,22,15076,0,0
15690,TCGTCGAATCTAGGGA,261,280,19,22,15080,4,0
15691,ACGTCGAATCTAGGGA,261,276,15,24,15082,3,0
15692,ACGTCGAATCTAGGGA,261,266,5,22,15083,0,0
15693,ACGTCGAATCTAGGGA,261,279,18,22,15085,4,0
15694,ACGTCGAATCTAGGGA,261,271,10,22,15086,1,0
15695,ACGTCGAATCTAGGGA,261,264,3,23,15088,0,0
15696,ACGTCGAATCTAGGGG,261,266,5,23,15096,0,0
15697,ACGTCGAATCTAGGGA,261,269,8,26,15100,1,0
15698,ACGTCGAATCTAGGGA,261,263,2,25,15101,0,0
15699,ACGTCGAATCTAGGGA,261,267,6,18,15102,0,0
15700,ACGTCGAATCTAGGGA,261,267,6,20,15111,0,0
15701,ACGTCGAATGTAGGGA,261,266,5,21,15117,0,0
15702,ACGTCGAATCTAGGGA,261,280,19,23,15118,4,0
15703,ACGTCGAATCTAGGGA,261,267,6,17,15248,0,0
15704,ACGTCGAATGTAGGGA,261,269,8,19,15249,1,0
15705,ACGTCGAATCTAGGGA,261,281,20,20,15250,5,0
15706,ACGTCGAAAGTAGGGA,261,261,0,20,15251,0,0
15707,ACGTCGATTCTGGGGA,261,262,1,19,15252,0,0
15708,ACGTCGAATCTAGGGA,261,280,19,16,15253,4,0
15709,ACGTCGAATCTAGGGA,261,262,1,23,15256,0,0
15710,ACGTCGAATCTAGGGA,261,271,10,22,15258,1,0
15711,ACGTCGAATCTAGGGA,261,268,7,22,15259,0,0
15712,ACGTCGAATCTAGGGA,261,263,2,23,15263,0,0
15713,ACGTCGAATCTAGGGA,261,270,9,21,15264,1,0
15714,ACGTCGAATCTAGGGA,261,262,1,23,15265,0,0
15715,ACGTCGAATCTAGGGA,261,277,16,25,15267,3,0
15716,ACGTCGAATCTAGGGA,262,264,2,21,13168,0,0
15717,ACGTCGAATCTAGGGA,262,284,22,22,13174,5,0
15718,ACGTCGAATCTAGGGA,262,267,5,18,13356,0,0
15719,ACGTCGAATCTAGGGA,262,304,42,24,13385,12,0
15720,ACGTCGAATCTAGGGA,262,265,3,18,13534,0,0
15721,TCGTCGAATCTATTGA,262,265,3,22,13719,0,0
15722,ACGTCGAATCTAGGGA,262,265,3,23,13786,0,0
15723,ACGTCGAATCTAGGGA,262,265,3,21,14068,0,0
15724,ACGTCGAATCTAGGGA,262,265,3,27,14079,0,0
15725,ACGTCGAATCTAGGGA,262,265,3,23,14084,0,0
15726,ACGTCGAATCTAGGGA,262,265,3,16,14225,0,0
15727,ACGTCGAATCTAGGGA,262,265,3,22,14529,0,0
15728,ACGTCGAATCTAGGGA,262,262,0,24,14535,0,0
15729,ACGTCGAATCTAGGGA,262,264,2,21,14595,0,0
15730,ACGTCGAATCTAGGGA,262,265,3,16,14596,0,0
15731,ACGTCGAATCTAGGGA,262,265,3,19,14604,0,0
15732,ACGTTGAATCTAGGGA,262,265,3,24,14626,0,0
15733,ACGTCGATTCTAGGGA,262,265,3,24,14708,0,0
15734,ACGTAGAATCTAGGGA,262,265,3,20,14709,0,0
15735,ACGTCGAATCGAGGGA,262,262,0,24,14713,0,0
15736,ACGTCGAATCTAGGGA,262,265,3,21,14778,0,0
15737,ACGTCGAATCTAGGGT,262,265,3,16,14779,0,0
15738,ACGTCGAATCTAGGGA,262,265,3,17,14783,0,0
15739,ACGTCGAATCTAGGGA,262,265,3,21,14787,0,0
15740,ACGTTGAATCTAGGGA,262,265,3,24,14796,0,0
15741,ACATCGAATCTAGGGA,262,265,3,23,14798,0,0
15742,ACGTCGAATCTAGGGA,262,264,2,25,14864,0,0
15743,ACGTCGAATCTAGTGA,262,263,1,24,14867,0,0
15744,ACGTAGAATCTAGGGA,262,263,1,21,14869,0,0
15745,ACGTCGAATCCAGGGA,262,265,3,18,14873,0,0
15746,ACGTCGAATCTAGGGA,262,263,1,17,14878,0,0
15747,ACGTCGAATCTAGGGA,262,265,3,19,14946,0,0
15748,ACGTCGAATCGAGGGA,262,265,3,22,14951,0,0
15749,ACGTCGAATCTAGGGA,262,265,3,24,14959,0,0
15750,ACGTCGAATCTAGGGA,262,265,3,22,14961,0,0
15751,ACGTCGAATCTAGGGA,262,265,3,23,14965,0,0
15752,TCGTCGAATCTAGGGA,262,264,2,24,14976,0,0
15753,ACGTCGAATCTAGGGA,262,265,3,26,14978,0,0
15754,ACGTCGAATCTAGGGA,262,265,3,24,14979,0,0
15755,ACGTCGAATCTAGGGA,262,263,1,23,14983,0,0
15756,ACGTCGAATCTAGGGA,262,263,1,18,14984,0,0
15757,ACGTCGAATGTAGGGA,262,262,0,21,14987,0,0
15758,ACGTCGAATCTAGGGA,262,265,3,19,15133,0,0
15759,ACGTCGAATCTAGCGA,262,263,1,16,15134,0,0
15760,ACGTCGAATCTAGGGA,262,265,3,20,15139,0,0
15761,ACGTCGAATCTAGGGA,262,265,3,22,15147,0,0
15762,ACGTCGAATCTAGGGA,262,265,3,23,15152,0,0
15763,ACGTCGATTCTAGGGA,262,263,1,20,15153,0,0
15764,ACGTCGAATCTAGGGA,262,262,0,16,15309,0,0
15765,ACGTCGAATCTAGGGA,262,262,0,18,15310,0,0
15766,ACGTCGAATCTAGGGA,262,265,3,21,15311,0,0
15767,ACGTCGAATCGAGGGA,262,265,3,22,15312,0,0
15768,ACGTCGAATCTAGGGA,263,286,23,19,13248,6,0
15769,ACGTCGATTCTGGGGA,263,278,15,18,13267,3,0
15770,ACGTCGAATCTAGGGA,263,265,2,19,14295,0,0
15771,ACGTCGAATCTAGGGA,263,273,10,22,14484,1,0
15772,ACGTCGAATCTAGGGA,263,263,0,18,14498,0,0
15773,ACGTCGAATCTAGGGA,263,265,2,17,14502,0,0
15774,ACGTCGACTTTAGGGA,263,265,2,19,14503,0,0
15775,ACGTCGAATCTAGGGA,263,265,2,23,14508,0,0
15776,ACGTCGAATCTAGGGA,263,265,2,24,14512,0,0
15777,ACGTCGAATCTAGGGA,263,275,12,25,14520,2,0
15778,TCGTCGAATCTAGGGA,263,267,4,22,14663,0,0
15779,ACGTCGAATCTAGGGA,263,276,13,21,14667,2,0
15780,ACGTCGAATCTAGGGA,263,270,7,24,14674,0,0
15781,ACGTCGAATCTAGGGA,263,270,7,19,14678,0,0
15782,ACGTCGAATCTAGGGA,263,273,10,23,14689,1,0
15783,ACGTCGAATCTAGGGA,263,274,11,25,14697,2,0
15784,ACGTCGAATCTAGGGA,263,273,10,16,14745,1,0
15785,ACGTCGGATCTAGGGA,263,268,5,23,14752,0,0
15786,TCGTCGAATCTAGGGA,263,303,40,22,14838,11,0
15787,ACGTCGAATCTAGGGA,263,273,10,22,14845,1,0
15788,ACGTCGAATCTAGGGA,263,277,14,23,14846,3,0
15789,ACGTCGAATCTAGGGA,263,280,17,18,14856,4,0
15790,ACGTCGAATCTAGGGA,263,267,4,24,14857,0,0
15791,TCGTCGAATCTATTGA,263,263,0,23,14858,0,0
15792,ACGTCGAATCTAGGGA,263,264,1,20,14914,0,0
15793,ACGTCGAATCTAGGGA,263,267,4,19,14999,0,0
15794,ACGTCGAATCTAGGGA,263,284,21,21,15001,5,0
15795,ACGTCGAATCTAGGGA,263,267,4,19,15130,0,0
15796,ACGTCGAATCTAGGGT,263,266,3,19,15178,0,0
15797,ACGTCGAATCTAGGGA,263,282,19,19,15184,4,0
15798,ACGTCGAATCTAGGGA,263,299,36,25,15186,10,0
15799,AAGTCGAATCTAGGGA,263,278,15,24,15190,3,0
15800,ACGTCGAATCTAGGGA,263,263,0,24,15192,0,0
15801,ACGTCGAATCTAGGGA,263,268,5,22,15193,0,0
15802,ACGTCGAATCTAGGGA,263,291,28,22,15202,7,0
15803,ACGTCGAATCGAGGGA,263,281,18,23,15204,4,0
15804,ACGTCGAATCTAGGGA,263,280,17,18,15268,4,0
15805,ACGTCGACTCTAGGGA,263,293,30,20,15269,8,0
15806,ACGTCGAATCTAGGGA,263,279,16,20,15272,3,0
15807,ACGTCGAATCTAGGGA,263,271,8,26,15273,1,0
15808,TCGTCGAATCTAGGGA,263,263,0,23,15275,0,0
15809,ACGTCGAATCTAGGGA,263,290,27,20,15278,7,0
15810,ACGTCGAATCTAGGGA,263,268,5,20,15282,0,0
15811,ACGTCGAATCTAGGGA,263,278,15,26,15283,3,0
15812,TCGTCGAATCTATTGA,263,265,2,24,15285,0,0
15813,ACGTCGAATCTAGGGA,263,267,4,26,15290,0,0
15814,ACGTCGAATCTAGGGA,263,265,2,24,15291,0,0
15815,ACGTCGAATCTAGGGA,263,275,12,17,15293,2,0
15816,ACGTCGAATCTAGGGA,263,270,7,20,15298,0,0
15817,ACGTCGAATCTAGGGA,263,264,1,22,15299,0,0
15818,ACGTCGACTCTAGGGA,263,266,3,19,15304,0,0
15819,ACGCCGAATCTAGGGA,263,279,16,21,15351,3,0
15820,ACGTCGAATCTAGGGA,263,265,2,23,15355,0,0
15821,ACGTCGAATCTAGGGA,263,288,25,25,15357,6,0
15822,ACGTCGAATCTAGGGA,263,266,3,19,15358,0,0
15823,ACGTCGAATCTAGGGA,263,263,0,24,15359,0,0
15824,ACGTCGAATCTAGGGA,263,264,1,18,15360,0,0
15825,ACGTCGAATCTAGGGA,263,272,9,24,15361,1,0
15826,TCGTCGAATCTATTGA,263,273,10,23,15362,1,0
15827,ACGTCGAATCTAGGGA,263,263,0,22,15364,0,0
15828,ACGTCGAATCTAGGGA,263,271,8,22,15366,1,0
15829,ACGTCGAATCTAGGGA,263,264,1,22,15367,0,0
15830,ACGTCGAATCTAGGGA,263,272,9,28,15368,1,0
15831,ACGTCGAATCTAGGGA,263,263,0,24,15369,0,0
15832,ACGTCGAATCTAGGGA,263,267,4,20,15374,0,0
15833,ACGTCGAATCTAGGGA,263,268,5,19,15375,0,0
15834,ACGTCGAATCTAGGGA,263,263,0,23,15377,0,0
15835,ACGTCGAATCTAGGGA,263,263,0,25,15378,0,0
15836,ACGTCGAATCTAGGGA,263,263,0,18,15379,0,0
15837,ACGTCGAATCTAGGGA,263,277,14,25,15380,3,0
15838,ACGTCGAATCTAGGGA,263,263,0,22,15382,0,0
15839,ACGTCGAATCGAGGGA,263,263,0,25,15392,0,0
15840,ACGTCGAATCTAGGGA,263,263,0,22,15395,0,0
15841,ACGTCGAATCTAGGGA,264,269,5,15,12541,0,0
15842,ACGTCGAATCGAGGGA,264,264,0,21,13130,0,0
15843,ACGTCGAATCTAGGGA,264,271,7,16,13464,1,0
15844,ACGTCGAATCTAGGGA,264,269,5,21,13642,0,0
15845,ACGTCGAATCTAGGGA,264,282,18,20,13656,5,0
15846,ACGTCGAATGTAGGGA,264,264,0,19,13661,0,0
15847,ATGTCGAATCTAGGGA,264,277,13,23,13671,3,0
15848,ACGTCGAATCTAGGGA,264,271,7,21,13829,1,0
15849,ACGTCGAATCTAGGGA,264,265,1,23,14039,0,0
15850,TCGTCGAATCTAGGGA,264,278,14,23,14209,3,0
15851,ACGTCGAATCGAGGGA,264,275,11,17,14251,2,0
15852,ACGTCGAATCTAGGGA,264,279,15,21,14366,4,0
15853,ACGTCGAATCTAGGGA,264,279,15,16,14388,4,0
15854,ACGTCGAATGTAGGGA,264,269,5,19,14736,0,0
15855,ACGTCGAATCTAGGGA,264,267,3,21,14893,0,0
15856,ACGTCGAATCTAGGGA,264,269,5,24,14909,0,0
15857,ACGTCGAATCTAGGGA,264,281,17,22,14912,4,0
15858,ACGTCGATTCTGGGGA,264,266,2,19,15074,0,0
15859,ACGTCGAATCTAGGGA,264,267,3,16,15075,0,0
15860,ACGTCGAATCTAGGGA,264,267,3,22,15076,0,0
15861,TCGTCGAATCTAGGGA,264,264,0,22,15080,0,0
15862,ACGTCGAATCTAGGGA,264,265,1,22,15085,0,0
15863,ACGTCGAATCTAGGGA,264,266,2,22,15086,0,0
15864,ACGTCGAATCTAGGGA,264,267,3,23,15088,0,0
15865,ACGTCGAATCTAGGGA,264,267,3,23,15096,0,0
15866,ACGTCGAATCTAGGGA,264,265,1,25,15101,0,0
15867,ACGTCGAATCTAGGGA,264,267,3,18,15102,0,0
15868,ACGTCGAATCTAGGGA,264,267,3,20,15111,0,0
15869,ACGTCGAATGTAGGGA,264,267,3,21,15117,0,0
15870,ACGTCGAATCTAGGGA,264,267,3,17,15248,0,0
15871,ACGTCGAATGTAGGGA,264,267,3,19,15249,0,0
15872,ACGTCGAATCTAGGGA,264,267,3,20,15250,0,0
15873,ACGTCGAAAGTAGGGA,264,267,3,20,15251,0,0
15874,ACGTCGAATCTAGGGA,264,265,1,16,15253,0,0
15875,ACGTCGAATCTAGGGA,264,267,3,23,15263,0,0
15876,ACTTCGAATCTAGGGA,264,265,1,21,15264,0,0
15877,ACGTCGAATCTAGGGA,264,267,3,23,15265,0,0
15878,ACGTCGAATCTAGGGA,264,267,3,17,15430,0,0
15879,ACGTCGAATGTAGGGA,264,267,3,19,15431,0,0
15880,ACGTCGAATCTAGGGA,264,265,1,20,15432,0,0
15881,ACGTCGAATCTAGGGA,264,264,0,16,15434,0,0
15882,ACGTCGAATCTAGGGA,265,270,5,22,13174,0,0
15883,ACGTCGAATCTAGGGA,265,274,9,18,13356,1,0
15884,ACGTCGAATCTAGGGA,265,269,4,18,13534,0,0
15885,TCGTCGAATCTATTGA,265,277,12,22,13719,2,0
15886,ACGTCGAATCTAGGGA,265,276,11,21,14068,2,0
15887,ACGTCGAATCCAGGGA,265,282,17,27,14079,4,0
15888,ACGTCGAATCTAGGGA,265,271,6,23,14084,0,0
15889,ACGTCGAATCTAGGGA,265,270,5,16,14225,0,0
15890,ACGTCGAATCTAGGGA,265,270,5,22,14529,0,0
15891,ACGTCGAATCTAGGGA,265,278,13,16,14596,2,0
15892,ACGTCGAATCTAGGGA,265,266,1,19,14604,0,0
15893,ACGTTGAATCTAGGGA,265,271,6,24,14626,0,0
15894,ACGTCGAATCTAGGGA,265,276,11,21,14778,2,0
15895,ACGTCGAATCTAGGGA,265,276,11,17,14783,2,0
15896,ACGTTGAATCTAGGGA,265,269,4,24,14796,0,0
15897,ACATCGAATCTAGGGA,265,283,18,23,14798,4,0
15898,ACGTCGAATCTAGGGA,265,271,6,25,14864,0,0
15899,ACGTCGAATCTAGTGA,265,266,1,24,14867,0,0
15900,ACGTCGAATCTAGGGA,265,266,1,18,14873,0,0
15901,ACGTCGAATCTAGGGA,265,271,6,19,14946,0,0
15902,ACGTCGAATCTAGGGA,265,265,0,22,14961,0,0
15903,ACGTCGAATCTAGGGA,265,267,2,23,14965,0,0
15904,ACGTCGAATCTAGGGA,265,272,7,26,14978,0,0
15905,ACGTCGAATCTAGGGA,265,269,4,24,14979,0,0
15906,ACGTCGAATCTAGGGA,265,265,0,23,14983,0,0
15907,ACGTCGAATGTAGGGA,265,278,13,21,14987,2,0
15908,ACGTCGAATCTAGGGA,265,269,4,22,15147,0,0
15909,ACGTCGAATCTAGGGA,265,276,11,23,15152,2,0
15910,ACGTCGAATCTAGGGA,265,269,4,16,15309,0,0
15911,ACGTCGAATCTAGGGA,265,287,22,18,15310,5,0
15912,ACGTCGAATCTAGGGA,265,283,18,21,15311,4,0
15913,ACGTCGAATCGAGGGA,265,273,8,22,15312,1,0
15914,ACGTCGAATCTAGGGA,265,273,8,18,15398,1,0
15915,ACGTCGAATCTAGGGA,265,276,11,22,15399,2,0
15916,ACGTCGAATCTAGGGA,265,268,3,26,15405,0,0
15917,ACGTCGAATCTAGGGA,265,277,12,23,15417,2,0
15918,ACGTTGAATCTAGGGA,265,276,11,25,15419,2,0
15919,ACGTCGAATCTAGGGA,265,272,7,16,15486,0,0
15920,ACGTCGAATCTAGGGA,265,273,8,20,15489,1,0
15921,ACGTCGAATCTAGGGA,265,268,3,17,15490,0,0
15922,ACGTCGAATCTAGGGA,265,278,13,22,15492,2,0
15923,ACGTCGAATCTAGGGA,265,269,4,21,15493,0,0
15924,ACGTCGAATCTAGGGA,265,277,12,22,15496,2,0
15925,ACGTCGAGTCTAGGGA,265,266,1,23,15497,0,0
15926,ACGTCGAATCTAGGGA,265,268,3,25,15501,0,0
15927,ACGTCGAATCGAGGGA,265,269,4,18,15502,0,0
15928,ACGTCGAATCTAGGGA,265,287,22,22,15503,5,0
15929,ACGTCGAATCTAGGGA,265,268,3,22,15508,0,0
15930,ACGTCGAATCTAGGGA,265,268,3,22,15512,0,0
15931,ACGTCGAATCTAGGGA,265,265,0,24,15513,0,0
15932,ACGTCGAATCTAGGGA,265,268,3,21,15514,0,0
15933,ACGTCGAATGTAGGGA,265,281,16,21,15518,3,0
15934,ACGTCGAATCTAGGGA,265,280,15,24,15527,3,0
15935,ACGTCGAATCTAGGGA,266,273,7,19,13248,1,0
15936,ACGTCGATTCTGGGGA,266,270,4,18,13267,0,0
15937,ACGTCGAATCTAGGGA,266,267,1,19,14295,0,0
15938,ACGTCGAATCTAGGGA,266,273,7,18,14498,0,0
15939,ACGTCGAATCTAGGGA,266,274,8,17,14502,1,0
15940,ACGTCGAATCTAGGGA,266,270,4,23,14508,0,0
15941,ACGTCGAATCTAGGGA,266,288,22,24,14512,5,0
15942,TCGTCGAATCTAGGGA,266,271,5,22,14663,0,0
15943,ACGTCGAATCTAGGGA,266,266,0,24,14674,0,0
15944,ACGTCGAATCTAGGGA,266,275,9,25,14697,1,0
15945,ACGTCGGATCTAGGGA,266,274,8,23,14752,1,0
15946,TCGTCGAATCTAGGGA,266,276,10,22,14838,1,0
15947,ACGTCGAATCTAGGGA,266,267,1,22,14845,0,0
15948,ACGTCGAATCTAGGGA,266,280,14,23,14846,3,0
15949,ACGTCGAATCTAGGGA,266,269,3,24,14857,0,0
15950,TCGTCGAATCTATTGA,266,269,3,23,14858,0,0
15951,ACGTCGAATCTAGGGA,266,269,3,20,14914,0,0
15952,ACGTCGAATCTAGGGA,266,269,3,19,14999,0,0
15953,ACGTCGAATCTAGGGA,266,267,1,21,15001,0,0
15954,ACGTCGAATCTAGGGT,266,269,3,19,15178,0,0
15955,ACGTCGAATCTAGGGA,266,269,3,19,15184,0,0
15956,ACGTCGAATCTAGGGA,266,266,0,25,15186,0,0
15957,ACGTCGAATCTAGGGA,266,269,3,24,15190,0,0
15958,ACGTCGAATCTAGGGA,266,269,3,22,15202,0,0
15959,ACGTCGAATCTAGGGA,266,266,0,18,15268,0,0
15960,ACGTCGACTCTAGGGA,266,269,3,20,15269,0,0
15961,ACGTCGAATCTAGGGA,266,267,1,20,15272,0,0
15962,ACGTCGAATCTAGGGA,266,269,3,26,15273,0,0
15963,ACGTCGAATCTAGGGA,266,268,2,20,15278,0,0
15964,ACGTCGAATCTAGGGA,266,269,3,26,15283,0,0
15965,TCGTCGAATCTATTGA,266,268,2,24,15285,0,0
15966,ACGTCGAATCTAGGGA,266,269,3,26,15290,0,0
15967,ACGTCGAATCTAGGGA,266,268,2,24,15291,0,0
15968,ACGTCGAATCTAGGGA,266,269,3,20,15298,0,0
15969,ACGTCGAATCTAGGGA,266,269,3,22,15299,0,0
15970,ACGTCGAATCTAGGGA,266,266,0,21,15351,0,0
15971,ACGTCGAATCTAGGGA,266,269,3,23,15355,0,0
15972,ACGTCGAATCTAGGGA,266,269,3,19,15358,0,0
15973,ACGTCGAATCTAGGGA,266,269,3,24,15359,0,0
15974,ACGTCGAATCTAGGGA,266,269,3,24,15361,0,0
15975,TCGTCGAATCTATTGA,266,268,2,23,15362,0,0
15976,ACGTCGAATCTAGGGA,266,268,2,22,15364,0,0
15977,ACGTCGAATCTAGGGA,266,269,3,22,15366,0,0
15978,ACGTCGAATCTAGGGA,266,269,3,22,15367,0,0
15979,ACGTCGAATCTAGGGA,266,268,2,20,15374,0,0
15980,ACGTCGAATCTAGGGA,266,269,3,19,15375,0,0
15981,ACGTCGAATCTAGGGA,266,269,3,23,15377,0,0
15982,ACGTCGAATCTAGGGA,266,269,3,25,15378,0,0
15983,ACGTCGAATCTAGGGA,266,269,3,18,15379,0,0
15984,ACGTCGAATCTAGGGA,266,269,3,22,15382,0,0
15985,ACGTCGAATCGAGGGA,266,269,3,25,15392,0,0
15986,ACGTCGAATCTAGGGA,266,269,3,22,15395,0,0
15987,TCGTCGAATCTAGGGA,266,269,3,22,15538,0,0
15988,ACGTCGAATCTAGGGA,266,269,3,23,15542,0,0
15989,ACGTCGAATCTAGGGA,266,269,3,16,15662,0,0
15990,ACGTCGAATCGAGGGA,266,269,3,22,15663,0,0
15991,ACGTCGAATCTAGGGA,266,267,1,18,15665,0,0
15992,ACGTCGAATCTAGGGA,266,269,3,22,15666,0,0
15993,ACGTCGAATCTAGGGA,266,267,1,21,15667,0,0
15994,ACGTCGCATGTAGGGA,266,266,0,20,15668,0,0
15995,ACGTCGAATCTAGGGA,266,269,3,24,15669,0,0
15996,ACGTCGAATCTAGGGA,266,269,3,22,15670,0,0
15997,ACGTCGAATCTAGGGA,266,268,2,23,15671,0,0
15998,ACGTCGAATCTAGGGA,266,269,3,24,15672,0,0
15999,ACGTCGAATCGAGGGA,267,296,29,21,13130,8,0
16000,ACGTCGAATCTAGGGA,267,273,6,21,13642,0,0
16001,ACGTCGAATCTAGGGA,267,271,4,20,13656,0,0
16002,ACGTCGAATGTAGGGA,267,269,2,19,13661,0,0
16003,ACGTCGAATCTAGGGA,267,289,22,23,13671,5,0
16004,ACGTCGAATCTAGGGA,267,313,46,23,14039,13,0
16005,ACGTCGAATCGAGGGA,267,269,2,17,14251,0,0
16006,ACGTCGAATCTAGGGA,267,274,7,16,14388,0,0
16007,ACGTCGAATGTAGGGA,267,268,1,19,14736,0,0
16008,ACGTCGATTCTGGGGA,267,292,25,19,15074,6,0
16009,ACGTCGAATCTAGGGA,267,272,5,22,15076,0,0
16010,TCGTCGAATCTAGGGA,267,286,19,22,15080,4,0
16011,ACGTCGAATCTAGGGA,267,290,23,22,15086,6,0
16012,ACGTCGAATCTACGGA,267,268,1,23,15096,0,0
16013,ACGTCGAATCTAGGGA,267,268,1,25,15101,0,0
16014,ACGTCGAATCTAGGGA,267,283,16,18,15102,3,0
16015,ACGTCGAATCTAGGGA,267,275,8,20,15111,1,0
16016,ACGTCGAATGTAGGGA,267,273,6,21,15117,0,0
16017,ACGTCGAATCTAGGGA,267,280,13,20,15250,2,0
16018,ACGTCGAAAGTAGGGA,267,268,1,20,15251,0,0
16019,ACGTCGAATCTAGGGA,267,270,3,16,15253,0,0
16020,ACGTCGAATCTAGGGA,267,269,2,23,15265,0,0
16021,ACGTCGAATCTAGGGA,267,267,0,17,15430,0,0
16022,ACGTCGAATGTAGGGA,267,268,1,19,15431,0,0
16023,ACGTCCAATCTAGGGA,267,268,1,24,15528,0,0
16024,ACGTCGAATCTAGGGA,267,267,0,26,15532,0,0
16025,ACGTCGAATCTAGGGA,267,279,12,21,15534,2,0
16026,ACGTCGAATCTAGGGA,267,310,43,16,15612,12,0
16027,ACGTCGAATCTAGGGA,267,273,6,22,15613,0,0
16028,ACGTCGAATCTAGGGA,267,279,12,21,15616,2,0
16029,ACGTCGAATCTAGGGA,267,272,5,23,15617,0,0
16030,ACGTCGAATCTAGGGA,267,275,8,18,15619,1,0
16031,ACGTCGAATCTAGGGA,267,276,9,24,15621,1,0
16032,ACGTCGAATCTAGGGA,267,271,4,22,15626,0,0
16033,ACGTCGAATCTAGGGA,267,268,1,25,15627,0,0
16034,ACGTCGAATCTAGGGA,267,295,28,26,15630,7,0
16035,ACGTCGAATCTAGGGA,267,290,23,24,15631,6,0
16036,ACGTCGAATCTAGGGA,267,269,2,17,15632,0,0
16037,ACGTCGGATCTAGGGA,267,267,0,24,15633,0,0
16038,ACGTCCAATCTAGGGA,267,267,0,23,15636,0,0
16039,TCGTCGAATCTATTGA,267,279,12,24,15640,2,0
16040,ACGTCGAATCTAGGGA,267,268,1,23,15641,0,0
16041,ACGTCGAATCTAGGGA,267,312,45,19,15645,13,0
16042,ACGTCGAATCTAGGGA,267,269,2,27,15648,0,0
16043,ACGTCGAATCTAGGGA,267,293,26,25,15654,7,0
16044,ACGTCGAATCTAGGGA,267,274,7,25,15656,0,0
16045,ACGTCGAATCTAGGGA,267,270,3,21,15658,0,0
16046,ACGTCGAATCGAGGGA,267,267,0,24,15661,0,0
16047,ACGTCGAATCTAGGGA,268,276,8,18,13356,1,0
16048,TCGTCGAATCTATTGA,268,298,30,22,13719,9,0
16049,ACGTCGAATCTAGGGA,268,270,2,21,14068,0,0
16050,ACGTCGAATCTAGGGA,268,276,8,27,14079,1,0
16051,ACGTCGAATCTAGGGA,268,271,3,23,14084,0,0
16052,ACGTCGAATCTAGGGA,268,275,7,16,14225,1,0
16053,ACGTCGAATCTAGGGA,268,278,10,22,14529,2,0
16054,ACGTCGAATCTAGGGA,268,297,29,19,14604,8,0
16055,ACGTTGAATCTAGGGA,268,287,19,24,14626,5,0
16056,ACGTCGAATCTAGGGA,268,271,3,21,14778,0,0
16057,ACGTTGAATCTAGGGA,268,276,8,24,14796,1,0
16058,ACGTCGAATCTAGGGA,268,299,31,25,14864,9,0
16059,ACGTCGAATCTAGGGA,268,283,15,18,14873,4,0
16060,ACGTCGAATCTAGGGA,268,273,5,22,14961,0,0
16061,ACGTCGAATCTAGGGA,268,287,19,23,14965,5,0
16062,ACGTCGAATCTAGGGA,268,291,23,26,14978,6,0
16063,ACGTCGAATCTAGGGA,268,288,20,24,14979,5,0
16064,ACGTCGAATCTAGGGA,268,291,23,23,14983,6,0
16065,ACGTCGAATGTAGGGA,268,293,25,21,14987,7,0
16066,ACGTCGAATCGAGGGA,268,269,1,22,15312,0,0
16067,ACGTCGAATCTAGGGA,268,274,6,18,15398,0,0
16068,ACGTCGAATCTAGGGA,268,288,20,22,15399,5,0
16069,ACGTCGAATCTAGGGA,268,273,5,23,15417,0,0
16070,ACGTCGAATCTAGGGA,268,279,11,16,15486,2,0
16071,ACGTCGAATCTAGGGA,268,288,20,20,15489,5,0
16072,ACGTCGAATCTAGGGA,268,275,7,17,15490,0,0
16073,ACGTCGAATCTAGGGA,268,308,40,22,15492,11,0
16074,ACGTCGAATCTAGGGA,268,286,18,22,15496,4,0
16075,ACGTCGAATCTAGGGA,268,282,14,23,15497,3,0
16076,ACGTCGAATCTAGGGA,268,270,2,25,15501,0,0
16077,ACGTCGAATCGAGGGA,268,291,23,18,15502,6,0
16078,ACGTCGAATCTAGGGA,268,278,10,22,15503,1,0
16079,ACGTCGAATCTAGGGA,268,282,14,22,15512,3,0
16080,ACGTCGAATCTAGGGA,268,272,4,24,15513,0,0
16081,ACGTCGCATCTAGGGA,268,282,14,21,15514,3,0
16082,ACGTCGAATGTAGGGA,268,272,4,21,15518,0,0
16083,ACGTCGAATCTAGGGA,268,278,10,24,15527,1,0
16084,ACGTCGAATCTAGGGA,268,287,19,23,15673,4,0
16085,TCGTCGAATCTAGGGA,268,284,16,24,15674,3,0
16086,ACGTCGAATCGAGGGA,268,269,1,18,15675,0,0
16087,ACGTCGAATCTAGGGA,268,292,24,17,15677,6,0
16088,ACGTCGAATCTAGGGA,268,269,1,24,15682,0,0
16089,ACGTCGAATCTAGGGA,268,269,1,21,15683,0,0
16090,ACGTCGATTCTGGGGA,268,270,2,20,15687,0,0
16091,ACGTCGAATCTAGGGA,268,271,3,17,15688,0,0
16092,TCGTCGAATCTAGGGA,268,269,1,23,15690,0,0
16093,ACGTCGAATCTAGGGA,268,271,3,25,15691,0,0
16094,ACGTCGAATCTAGGGA,268,271,3,23,15693,0,0
16095,ACGTCGAATCTAGGGA,268,271,3,23,15694,0,0
16096,ACGTCGAATCTAGGGA,268,270,2,27,15697,0,0
16097,ACGTCGAATCTAGGGA,268,271,3,24,15702,0,0
16098,ACGTCGAATGTAGGGA,268,270,2,20,15704,0,0
16099,ACGTGGAATCTAGGGA,268,271,3,21,15705,0,0
16100,ACGTCGAATCTAGGGA,268,271,3,17,15708,0,0
16101,ACGTCGAATCTAGGGA,268,271,3,23,15710,0,0
16102,ACGTCGAATCTAGGGA,268,271,3,22,15713,0,0
16103,ACGTCGAATCTAGGGA,269,276,7,19,13248,0,0
16104,ACGTCGATTCTGGGGA,269,272,3,18,13267,0,0
16105,ACGTCGAATCTAGGGA,269,278,9,18,14498,1,0
16106,ACGTCGAATCTAGGGA,269,291,22,17,14502,5,0
16107,ACGTCGAATCTAGGGA,269,293,24,23,14508,6,0
16108,ACGTCGAATCTAGGGA,269,280,11,24,14512,2,0
16109,TCGTCGAATCTAGGGA,269,292,23,22,14663,6,0
16110,ACGTCGAATCTAGGGA,269,269,0,24,14674,0,0
16111,ACGTCGAATCTAGGGA,269,281,12,25,14697,2,0
16112,ACGTCGGATCTAGGGA,269,283,14,23,14752,3,0
16113,TCGTCGAATCTAGGGA,269,269,0,22,14838,0,0
16114,ACGTCGAATCTAGGGA,269,277,8,22,14845,1,0
16115,ACGTCGAATCTAGGGA,269,278,9,23,14846,1,0
16116,TCGTCGAATCTATTGA,269,271,2,23,14858,0,0
16117,ACGTCGAATCTAGGGA,269,278,9,20,14914,1,0
16118,ACGTCGAATCTAGGGA,269,282,13,21,15001,2,0
16119,ACGTCGAATCTAGGGT,269,283,14,19,15178,3,0
16120,ACGTCGAATCTAGGGA,269,272,3,19,15184,0,0
16121,ACGTCGAATCTAGGGA,269,271,2,25,15186,0,0
16122,ACGTCGAATCTAGGGA,269,274,5,18,15268,0,0
16123,ACGTCGACTCTAGGGA,269,280,11,20,15269,2,0
16124,ACGTCGAATCTAGGGA,269,269,0,20,15272,0,0
16125,ACGTCGAATCTAGGGA,269,270,1,26,15273,0,0
16126,ACGTCGAATCTAGGGA,269,271,2,26,15283,0,0
16127,TCGTCGAATCTATTGA,269,279,10,24,15285,1,0
16128,ACGTCGAATCTAGGGA,269,272,3,21,15351,0,0
16129,ACGTCGAATCTAGGGA,269,272,3,24,15361,0,0
16130,TCGTCGAATCTATTGA,269,272,3,23,15362,0,0
16131,ACGTCGAATCTAGGGA,269,269,0,22,15364,0,0
16132,ACGTCGAATCTAGGGA,269,272,3,22,15366,0,0
16133,ACGTCGAATCTAGGGA,269,271,2,20,15374,0,0
16134,ACGTCGAATCTAGGGA,269,272,3,19,15375,0,0
16135,ACGTCGAATCTAGGGA,269,269,0,23,15377,0,0
16136,ACGTCGAATCTAGGGA,269,272,3,18,15379,0,0
16137,ACGTCGAATCTAGGGA,269,272,3,22,15382,0,0
16138,ACGTCGAATCGAGGGA,269,272,3,25,15392,0,0
16139,TCGTCGAATCTAGGGA,269,272,3,22,15538,0,0
16140,ACGTCGAATCTAGGGA,269,272,3,23,15542,0,0
16141,ACGTCGAATCTAGGGA,269,272,3,16,15662,0,0
16142,ACGTCGAATCTAGGGA,269,271,2,18,15665,0,0
16143,ACGTCGAATCTAGGGA,269,269,0,22,15666,0,0
16144,ACGTCGAATCTAGGGA,269,272,3,21,15667,0,0
16145,ACGTCGCATGTAGGGA,269,272,3,20,15668,0,0
16146,ACCTCGAATCTAGGGA,269,272,3,24,15672,0,0
16147,ACGTCGAATCTAGGGA,269,270,1,23,15717,0,0
16148,ACGTCGAATCTAGGGA,269,272,3,25,15719,0,0
16149,ACGTCGAATCTAGGGA,269,272,3,17,15843,0,0
16150,ACGTCGAATCTAGGGA,269,272,3,21,15845,0,0
16151,ATGTCGAATCTAGGGA,269,272,3,24,15847,0,0
16152,ACGTCGAATCTAGGGA,269,272,3,22,15848,0,0
16153,TCGTCGAATCTAGGGA,269,271,2,24,15850,0,0
16154,ACGTCGAATCGAGGGA,269,272,3,18,15851,0,0
16155,ACGTCGAATCTAGGGA,269,272,3,22,15852,0,0
16156,ACGTCGAATCTAGGGA,269,272,3,17,15853,0,0
16157,ACGTCGAATCGAGGGA,270,281,11,21,13130,2,0
16158,ACGTCGAATCTAGGGA,270,277,7,21,13642,0,0
16159,ACGTCGAATCTAGGGA,270,302,32,20,13656,9,0
16160,ACGTCGAATCTAGGGA,270,270,0,23,13671,0,0
16161,ACGTCGACTCTAGGGA,270,271,1,23,14039,0,0
16162,ACGTCGAATCGAGGGA,270,276,6,17,14251,0,0
16163,ACGTCGAATGTAGGGA,270,270,0,19,14736,0,0
16164,ACGTCGATTCTGGGGA,270,280,10,19,15074,1,0
16165,ACGTCGAATCTAGGGA,270,274,4,22,15076,0,0
16166,TCGTCGAATCTAGGGA,270,291,21,22,15080,5,0
16167,ACGTCGAATCTAGGGA,270,284,14,22,15086,3,0
16168,ACGTCGAATCTAGGGA,270,287,17,23,15096,4,0
16169,ACGTCGAATCTAGGGA,270,277,7,25,15101,0,0
16170,ACGTCGAATCTAGGGA,270,300,30,18,15102,8,0
16171,ACGTCGAATCTAGGGA,270,274,4,20,15250,0,0
16172,ACGTCGAAAGTAGGGA,270,272,2,20,15251,0,0
16173,ACGTCGAATCTAGGGA,270,282,12,16,15253,2,0
16174,ACGTCGAATCTAGGGA,270,275,5,23,15265,0,0
16175,ACGTCGAATCTAGGGA,270,280,10,17,15430,1,0
16176,ACGTCGAATGTAGGGA,270,272,2,19,15431,0,0
16177,ACGTCGAATCTAGGGA,270,275,5,24,15528,0,0
16178,ACGTCGAATCTAGGGA,270,274,4,26,15532,0,0
16179,ACGTCGAATCTAGGGA,270,284,14,21,15534,3,0
16180,ACGTCGAATCTAGGGA,270,294,24,22,15613,6,0
16181,ACGTCGAATCTAGGGA,270,288,18,21,15616,4,0
16182,ACGTCGAATCTAGGGA,270,272,2,23,15617,0,0
16183,ACGTCGAATCTAGGGA,270,279,9,18,15619,1,0
16184,ACGTCGAATCTAGGGA,270,288,18,24,15621,4,0
16185,ACGTCGAATCTAGGGA,270,271,1,22,15626,0,0
16186,ACGTCGAATCTAGGGA,270,282,12,25,15627,2,0
16187,ACGTCGAATCTAGGGA,270,285,15,24,15631,3,0
16188,ACGTCGAATCTAGGGA,270,283,13,17,15632,2,0
16189,ACGTCGGATCTAGGGA,270,272,2,24,15633,0,0
16190,ACGTCCAATCTAGGGA,270,276,6,23,15636,0,0
16191,TCGTCGAATCTATTGA,270,272,2,24,15640,0,0
16192,ACGTCGAATCTAGGGA,270,271,1,23,15641,0,0
16193,ACGTCGAATCTAGGGA,270,273,3,19,15645,0,0
16194,ACGTCGAATCTAGGGA,270,277,7,27,15648,0,0
16195,ACGTCGAATCTAGGGA,270,272,2,25,15654,0,0
16196,ACGTCGAATCTAGGGA,270,272,2,25,15656,0,0
16197,ACGTCGAATCTAGGGA,270,283,13,21,15658,2,0
16198,ACGTCGAATCGAGGGA,270,277,7,24,15661,0,0
16199,ACGTCGAATCTAGGGA,270,280,10,26,15715,1,0
16200,ACGTCGAATCTAGGGA,270,272,2,20,15768,0,0
16201,ACGTCGATTCTGGGGA,270,286,16,19,15769,3,0
16202,ACGTCGAATCTAGGGA,270,273,3,23,15771,0,0
16203,ACGTCGAATCTAGGGA,270,271,1,26,15777,0,0
16204,ACGTCGAATCTAGGGA,270,279,9,22,15779,0,0
16205,ACGTCGAATCTAGGGA,270,279,9,24,15782,0,0
16206,ACGTCGAATCTAGGGA,270,271,1,26,15783,0,0
16207,ACGTCGAATCTAGGGA,270,271,1,17,15784,0,0
16208,TCGTCGAATCTAGGGA,270,273,3,23,15786,0,0
16209,ACGTCGAATCTAGGGA,270,273,3,23,15787,0,0
16210,ACGTCGAATCTAGGGA,270,273,3,24,15788,0,0
16211,ACGTCGAATCTAGGGA,270,273,3,19,15789,0,0
16212,ACGTCGAATCTAGGCA,270,272,2,22,15794,0,0
16213,ACGTCGAATCTAGGGA,270,272,2,20,15797,0,0
16214,ACGTCGAATCTAGGGA,270,272,2,26,15798,0,0
16215,AAGTCGAATCTAGGGA,270,273,3,25,15799,0,0
16216,ACGTCGAATCTAGGGA,270,273,3,23,15802,0,0
16217,ACGTCGAATCGAGGGA,270,271,1,24,15803,0,0
16218,ACGTCGAATCTAGGGA,270,270,0,19,15804,0,0
16219,ACGTCGACTCTAGGGA,270,271,1,21,15805,0,0
16220,ACGTCGAATCTAGGGA,270,270,0,21,15806,0,0
16221,ACGTCGAATCTAGGGA,270,273,3,27,15807,0,0
16222,ACGTCGAATCTAGGGA,270,271,1,21,15809,0,0
16223,ACGTCGAATCTAGGGA,270,273,3,27,15811,0,0
16224,ACGTCGAATCTAGGGA,270,272,2,18,15815,0,0
16225,ACGCCGAATCTAGGGA,270,273,3,22,15819,0,0
16226,ACGTCGAATCTAGGGA,270,273,3,26,15821,0,0
16227,ACGTCGAATCTAGGGA,270,273,3,25,15825,0,0
16228,TCGTCGAATCTATTGA,270,273,3,24,15826,0,0
16229,ACGTCGAATCTAGGGA,270,273,3,23,15828,0,0
16230,ACGTCGAATCTAGGGA,270,273,3,29,15830,0,0
16231,ACGTCGAATCTAGGGA,270,271,1,26,15837,0,0
16232,ACGTCGAATCTAGGGA,271,286,15,27,14079,3,0
16233,ACGTCGAATCTAGGGA,271,276,5,23,14084,0,0
16234,ACGTCGAATCTAGGGA,271,275,4,16,14225,0,0
16235,ACGTCGAATCTAGGGA,271,290,19,22,14529,4,0
16236,ACGTCGAATCTAGGGA,271,283,12,19,14604,2,0
16237,ACGTTGAATCTAGGGA,271,271,0,24,14626,0,0
16238,ACGTTGAATCTAGGGA,271,284,13,24,14796,2,0
16239,ACGTCGAATCTAGGGA,271,273,2,25,14864,0,0
16240,ACGTCGAATCTAGGGA,271,280,9,18,14873,1,0
16241,ACGTCGAATCTAGGGA,271,276,5,22,14961,0,0
16242,ACGTCGAATCTAGGGA,271,282,11,23,14965,2,0
16243,ACGTCGAATCTAGGGA,271,273,2,26,14978,0,0
16244,ACGTCGAATCTAGGGA,271,273,2,24,14979,0,0
16245,ACGTCGAATCGAGGGA,271,277,6,22,15312,0,0
16246,ACGTCGAATCTAGGGA,271,279,8,18,15398,1,0
16247,ACGTCGAATCTAGGGA,271,275,4,22,15399,0,0
16248,ACGTCGAATCTAGGGA,271,286,15,23,15417,3,0
16249,ACGTCGAATCTAGGGA,271,305,34,16,15486,9,0
16250,ACGTCGAATCTAGGGA,271,285,14,20,15489,3,0
16251,ACGTCGAATCTAGGGA,271,276,5,17,15490,0,0
16252,ACGTCGAATCTAGGGA,271,272,1,22,15496,0,0
16253,ACGTCGAATCTAGGGA,271,295,24,23,15497,6,0
16254,ACGTCGAATCTAGGGA,271,292,21,25,15501,5,0
16255,ACGTCGAATCGAGGGA,271,274,3,18,15502,0,0
16256,ACGTCGAATCTAGGGA,271,274,3,22,15503,0,0
16257,ACGTCGAATCTAGGGA,271,274,3,22,15512,0,0
16258,ACGTCGAATCTAGGGA,271,272,1,24,15513,0,0
16259,ACGTCGAATCTAGGGA,271,274,3,21,15514,0,0
16260,ACGTCGAATGTAGGGA,271,272,1,21,15518,0,0
16261,ACGTCGAATCTAGGGA,271,273,2,17,15677,0,0
16262,ACGTCGAATCTAGGGA,271,274,3,24,15682,0,0
16263,ACGTCGAATCTAGGGA,271,274,3,21,15683,0,0
16264,ACGTCGATTCTGGGGA,271,274,3,20,15687,0,0
16265,ACGTCGAATCTAGGGA,271,273,2,17,15688,0,0
16266,TCGTCGAATCTAGGGA,271,274,3,23,15690,0,0
16267,ACGTCGAATCTAGGGA,271,272,1,25,15691,0,0
16268,ACGTCGAATCTAGGGA,271,274,3,23,15693,0,0
16269,ACGTCGAATCTAGGGA,271,274,3,24,15702,0,0
16270,ACGTCGAATCTAGGGA,271,274,3,21,15705,0,0
16271,ACGTCGAATCTAGGGA,271,274,3,17,15708,0,0
16272,ACGTCGAATCTAGGGA,271,274,3,23,15857,0,0
16273,ACGTCGAATCTAGGGA,272,280,8,19,13248,1,0
16274,ACGTCGATTCTGGGGA,272,278,6,18,13267,0,0
16275,TCGTCGAATCTAGGGA,272,288,16,22,14663,3,0
16276,ACGTCGAATCTAGGGA,272,281,9,24,14674,1,0
16277,ACGTCGGATCTAGGGA,272,273,1,23,14752,0,0
16278,TCGTCGAATCTAGGGA,272,273,1,22,14838,0,0
16279,ACGTCGAATCTAGGGA,272,273,1,22,14845,0,0
16280,ACGTCGAATCTAGGGA,272,279,7,23,14846,0,0
16281,TCGTCGAATCTATTGA,272,276,4,23,14858,0,0
16282,ACGTCGAATCTAGGGA,272,281,9,20,14914,1,0
16283,ACGTCGAATCTAGGGA,272,285,13,21,15001,2,0
16284,ACGTCGAATCTAGGGT,272,272,0,19,15178,0,0
16285,ACGTCGAATCTAGGGA,272,273,1,19,15184,0,0
16286,ACGTCGAATCTAGGGA,272,273,1,25,15186,0,0
16287,ACGTCGACTCTAGGGA,272,300,28,20,15269,7,0
16288,ACGTCGAATCTAGGGA,272,284,12,20,15272,2,0
16289,ACGTCGAATCTAGGGA,272,277,5,26,15273,0,0
16290,ACGTCGAATCTAGGGA,272,289,17,26,15283,4,0
16291,TCGTCGAATCTATTGA,272,272,0,24,15285,0,0
16292,ACGTCGAATCTAGGGA,272,306,34,21,15351,9,0
16293,ACGTCGAATCTAGGGA,272,276,4,24,15361,0,0
16294,TCGTCGAATCTATTGA,272,273,1,23,15362,0,0
16295,ACGTCGAATCTAGGGA,272,277,5,20,15374,0,0
16296,ACGTCGAATCTAGGGA,272,276,4,19,15375,0,0
16297,ACGTCGAATCTAGGGA,272,275,3,18,15379,0,0
16298,TCGTCGAATCTAGGGA,272,281,9,22,15538,1,0
16299,ACGTCGAATCTAGGGA,272,275,3,23,15542,0,0
16300,ACGTCGAATCTAGGGA,272,275,3,16,15662,0,0
16301,ACGTCGAATCTAGGGA,272,275,3,21,15667,0,0
16302,ACGTCGCAGGTAGGGA,272,275,3,20,15668,0,0
16303,ACGTCGAATCTAGGGA,272,275,3,24,15672,0,0
16304,ACGTCGAATCTAGGGA,272,275,3,23,15717,0,0
16305,ACGTCGAATCTAGGGA,272,274,2,25,15719,0,0
16306,ACATCGAATCTAGGGA,272,275,3,21,15845,0,0
16307,ATGTCGAATCTAGGGA,272,275,3,24,15847,0,0
16308,TCGTCGAATCTAGGGA,272,275,3,24,15850,0,0
16309,ACGTCGAATCGAGGGA,272,275,3,18,15851,0,0
16310,ACGTCGAATCTAGGGA,272,275,3,22,15852,0,0
16311,ACGTCGAATCTAGGGA,272,273,1,17,15853,0,0
16312,ACTTCGAATCTAGGGA,272,273,1,19,15883,0,0
16313,TCGTCGAATCTATTGA,272,275,3,23,15885,0,0
16314,ACGTCGAATCTAGGGA,272,275,3,22,15886,0,0
16315,ACGTCGAATCCAGGGA,272,275,3,28,15887,0,0
16316,ACGTCGAATCTAGGGA,272,275,3,17,15891,0,0
16317,ACGTCGAATCTAGGGA,272,275,3,22,15894,0,0
16318,ACGTCGAATCTAGGGA,272,274,2,18,15895,0,0
16319,ACATCGAATCTAGGGA,272,275,3,24,15897,0,0
16320,ACGTCGAATGTAGGGA,272,275,3,22,15907,0,0
16321,ACGTCGAATCTAGGGA,272,275,3,24,15909,0,0
16322,ACGTCGAATCTAGGGA,272,275,3,19,15911,0,0
16323,ACGTCGAATCTAGGGA,272,274,2,22,15912,0,0
16324,ACGTCGAATCGAGGGA,272,275,3,23,15913,0,0
16325,ACGTCGAATCTAGGGA,272,275,3,19,15914,0,0
16326,ACGTCGAATCTAGGGA,272,275,3,23,15915,0,0
16327,ACGTCGAATCTAGGGA,272,275,3,24,15917,0,0
16328,ACGTTGAATCTAGGGA,272,274,2,26,15918,0,0
16329,ACGTCGAATCTAGGGA,272,272,0,21,15920,0,0
16330,ACGTCGAATCTAGGGA,272,273,1,23,15922,0,0
16331,ACGTCGAATCTAGGGA,272,275,3,23,15924,0,0
16332,ACGTCGAATCTAGGGA,272,275,3,23,15928,0,0
16333,ACGTCGAATGTAGGGA,272,275,3,22,15933,0,0
16334,ACGTCGAATCTAGGGA,272,275,3,25,15934,0,0
16335,ACGTCGAATCTAGGGA,272,275,3,20,15935,0,0
16336,ACGTCGAATCGAGGGA,273,293,20,21,13130,5,0
16337,ACGTCGAATCTAGGGA,273,275,2,21,13642,0,0
16338,ACGTCGAATCTAGGGA,273,280,7,20,13656,0,0
16339,ACGTCGAATCTAGGGA,273,285,12,23,13671,2,0
16340,ACGTCGAATCTAGGGA,273,289,16,23,14039,3,0
16341,ACGTCGAATCGAGGGA,273,283,10,17,14251,1,0
16342,ACGTCGAATGTAGGGA,273,284,11,19,14736,2,0
16343,ACGTCGAATCTAGGGA,273,277,4,22,15076,0,0
16344,TCGTCGAATCTAGGGA,273,281,8,22,15080,1,0
16345,ACGTCGAATCTAGGGA,273,277,4,22,15086,0,0
16346,ACGTCGAATCTAGGGA,273,280,7,23,15096,0,0
16347,ACGTCGAATCTAGGGA,273,274,1,25,15101,0,0
16348,ACGTCGAATCTAGGGA,273,283,10,18,15102,1,0
16349,ACGTCGAAAGTAGGGA,273,288,15,20,15251,3,0
16350,ACGTCGAATCTAGGGA,273,283,10,23,15265,1,0
16351,ACGTCGAATGTAGGGA,273,278,5,19,15431,0,0
16352,ACGTCGAATCTAGGGA,273,283,10,24,15528,1,0
16353,ACGTCGAATCTAGGGA,273,277,4,22,15613,0,0
16354,ACGTCGAATCTAGGGA,273,278,5,23,15617,0,0
16355,ACGTCGAATCTAGGGA,273,280,7,18,15619,0,0
16356,ACGTCGAATCTAGGGA,273,274,1,24,15621,0,0
16357,ACGTCGAATCTAGGGA,273,286,13,22,15626,2,0
16358,ACGTCGAATCTAGGGA,273,282,9,25,15627,1,0
16359,ACGTCGAATCTAGGGA,273,283,10,17,15632,1,0
16360,ACGTCGGATCTAGGGA,273,283,10,24,15633,1,0
16361,ACGTCCAATCTAGGGA,273,275,2,23,15636,0,0
16362,TCGTCGAATCTATTGA,273,281,8,24,15640,1,0
16363,ACGTCGAATCTAGGGA,273,276,3,19,15645,0,0
16364,ACGTCGAATCTAGGGA,273,277,4,27,15648,0,0
16365,ACGTCGAATCTAGGGA,273,281,8,25,15654,1,0
16366,ACGTCGAATCTAGGGA,273,277,4,25,15656,0,0
16367,ACGTCGAATCTAGGGA,273,273,0,21,15658,0,0
16368,ACGTCGAATCTAGGGA,273,285,12,26,15715,2,0
16369,ACGTCGAATCTAGGGA,273,275,2,20,15768,0,0
16370,ACGTCGATTCTGGGGA,273,274,1,19,15769,0,0
16371,ACGTCGAATCTAGGGA,273,279,6,26,15777,0,0
16372,ACGTCGAATCTAGGGA,273,281,8,22,15779,1,0
16373,ACGTCGAATCTAGGGA,273,274,1,26,15783,0,0
16374,TCGTCGAATCTAGGGA,273,273,0,23,15786,0,0
16375,ACGTCGAATCTAGGGA,273,275,2,24,15788,0,0
16376,ACGTCGAATCTAGGGA,273,275,2,19,15789,0,0
16377,ACGTCGAATCTAGGGA,273,284,11,22,15794,2,0
16378,ACGTCGAATCTAGGGA,273,287,14,20,15797,2,0
16379,ACGTCGAATCTAGGGA,273,280,7,26,15798,0,0
16380,AAGTCGAATCTAGGGA,273,279,6,25,15799,0,0
16381,ACGTCGAATCTAGGGA,273,285,12,23,15802,1,0
16382,ACGTCGAATCGAGGGA,273,283,10,24,15803,1,0
16383,ACGTCGAATCTAGGGA,273,276,3,19,15804,0,0
16384,ACGTCGACTCTAGGGA,273,276,3,21,15805,0,0
16385,ACGTCGAATCTAGGGA,273,276,3,21,15806,0,0
16386,ACGTCGAATCTAGGGA,273,276,3,21,15809,0,0
16387,ACGTCGAATCTAGGGA,273,276,3,27,15811,0,0
16388,ACGTCGAATCTAGGGA,273,276,3,18,15815,0,0
16389,ACGCCGAATCTAGGGA,273,276,3,22,15819,0,0
16390,ACGTCGCATCTAGGGA,273,276,3,26,15821,0,0
16391,ACGTCGAATCTAGGGA,273,276,3,26,15837,0,0
16392,ACGTCGAATCTAGGGA,273,276,3,18,15939,0,0
16393,ACGTCGAATCTAGGGA,273,276,3,25,15941,0,0
16394,ACGTCGAATCTAGGGA,273,273,0,26,15944,0,0
16395,ACGTCGGATCTAGGGA,273,276,3,24,15945,0,0
16396,TCGTCGAATCTAGGGA,273,276,3,23,15946,0,0
16397,ACGTCGAATCTAGGGA,273,273,0,24,15948,0,0
16398,ACGTCGAATCTAGGGA,273,276,3,19,16047,0,0
16399,TCGTCGAATCTATTGA,273,274,1,23,16048,0,0
16400,ACGTCGAATCTAGGGA,273,276,3,28,16050,0,0
16401,ACGTCGAATCTAGGGA,273,276,3,17,16052,0,0
16402,ACGTCGAATCTAGGGA,273,276,3,23,16053,0,0
16403,ACGTCGAATCTAGGGA,273,274,1,20,16054,0,0
16404,ACGTTGAATCTAGGGA,273,275,2,25,16055,0,0
16405,ACGTTGAATCTAGGGA,273,276,3,25,16057,0,0
16406,ACGTCGAATCTAGGGA,273,273,0,26,16058,0,0
16407,ACGTCGAATCTAGGGA,273,275,2,19,16059,0,0
16408,ACGTCGAATCTAGGGA,273,274,1,24,16061,0,0
16409,ACGTCGAATCTAGGGA,273,276,3,27,16062,0,0
16410,ACGTCGAATCTAGGGA,273,276,3,25,16063,0,0
16411,ACGTCGAATCTAGGGA,273,276,3,24,16064,0,0
16412,ACGTCGAATGTAGGGA,273,276,3,22,16065,0,0
16413,ACGTCGAATCTAGGGA,274,278,4,27,14079,0,0
16414,ACGTCGAATCTAGGGA,274,280,6,23,14084,0,0
16415,ACGTCGAATCTAGGGA,274,275,1,16,14225,0,0
16416,ACGTCGAATCTAGGGA,274,277,3,22,14529,0,0
16417,ACGTTGAATCTAGGGA,274,278,4,24,14626,0,0
16418,ACGTCGAATCTAGGGA,274,278,4,25,14864,0,0
16419,ACGTCGAATCTAGGGA,274,280,6,23,14965,0,0
16420,ACGTCGAATCTAGGGA,274,282,8,26,14978,1,0
16421,ACGTCGAATCTAGGGA,274,286,12,24,14979,2,0
16422,ACGTCGAATCGAGGGA,274,297,23,22,15312,6,0
16423,ACGTCGAATCTAGGGA,274,281,7,18,15398,0,0
16424,ACGTCGAATCTAGGGA,274,281,7,22,15399,0,0
16425,ACGTCGAATCTAGGGA,274,276,2,16,15486,0,0
16426,ACGTCGAATCTAGGGA,274,314,40,23,15497,11,0
16427,ACGTCGAATCGAGGGA,274,275,1,18,15502,0,0
16428,ACGTCGAATCTAGGGA,274,293,19,22,15503,4,0
16429,ACGTCGAATCTAGGGA,274,274,0,22,15512,0,0
16430,ACGTCGAATCTAGGGA,274,306,32,24,15513,9,0
16431,ACGTCGAATCTAGGGA,274,292,18,21,15514,4,0
16432,ACGTCGAATGTAGGGA,274,322,48,21,15518,14,0
16433,ACGTCGAATCTAGGGA,274,297,23,17,15677,6,0
16434,ACGTCGAATCTAGGGA,274,275,1,24,15682,0,0
16435,ACGTCGAATCTAGGGA,274,274,0,21,15683,0,0
16436,ACGTCGATTCTGGGGA,274,275,1,20,15687,0,0
16437,TCGTCGAATCTAGGGA,274,282,8,23,15690,1,0
16438,ACGTCGAATCTAGGGA,274,278,4,25,15691,0,0
16439,ACGTCGAATCTAGGGA,274,275,1,23,15693,0,0
16440,ACGTCGAATTTAGGGA,274,278,4,24,15702,0,0
16441,ACGTCAAATCTAGGGA,274,280,6,21,15705,0,0
16442,ACGTCGAATCTAGGGA,274,277,3,17,15708,0,0
16443,ACGTCGAATCTAGGGA,274,280,6,23,15857,0,0
16444,ACGTCGAATCGAGGGA,274,300,26,22,15999,7,0
16445,ACGTCGAATCTAGGGA,274,275,1,24,16003,0,0
16446,ACGTCGAATCTAGGGA,274,277,3,24,16004,0,0
16447,ACGTCGATTCTGGGGA,274,274,0,20,16008,0,0
16448,TCGTCGAATCTAGGGA,274,279,5,23,16010,0,0
16449,ACGTCGAATCTAGGGA,274,290,16,23,16011,3,0
16450,ACGTCGAATCTAGGGA,274,275,1,19,16014,0,0
16451,ACGTCGAATCTAGGGA,274,282,8,21,16015,0,0
16452,ACGTCGAATCTAGGGA,274,294,20,21,16017,4,0
16453,ACGTCGAATCTAGGGA,274,278,4,22,16025,0,0
16454,ACGTCGAATCTAGGGA,274,277,3,17,16026,0,0
16455,ACGTCGAATCTAGGGA,274,277,3,22,16028,0,0
16456,ACGTCGAATCTAGGGA,274,277,3,19,16030,0,0
16457,ACGTCGAATCTAGGGA,274,277,3,25,16031,0,0
16458,ACGTCGAATCTAGGGA,274,277,3,27,16034,0,0
16459,ACGTCGAATCTAGGGA,274,277,3,25,16035,0,0
16460,TCGTCGAATCTATTGA,274,276,2,25,16039,0,0
16461,ACGTCGAATCTAGGGA,274,274,0,20,16041,0,0
16462,ACGTCGAATCTTGGGA,274,277,3,26,16043,0,0
16463,ACGTCGAATCTAGGGA,275,290,15,19,13248,3,0
16464,ACGTCGATTCTGGGGA,275,283,8,18,13267,1,0
16465,TCGTCGAATCTAGGGA,275,275,0,22,14663,0,0
16466,ACGTCGGATCTAGGGA,275,280,5,23,14752,0,0
16467,TCGTCGAATCTAGGGA,275,277,2,22,14838,0,0
16468,ACGTCGAATCTAGGGA,275,304,29,22,14845,8,0
16469,ACGTCGAATCTAGGGA,275,286,11,23,14846,2,0
16470,TCGTCGAATCTATTGA,275,277,2,23,14858,0,0
16471,ACGTCGAATCTAGGGA,275,287,12,20,14914,2,0
16472,ACGTCGAATCTAGGGA,275,305,30,21,15001,8,0
16473,ACGTCGAATCTAGGGT,275,304,29,19,15178,8,0
16474,ACGTCGAATCTAGGGA,275,335,60,19,15184,18,0
16475,ACGTCGAATCTAGGGA,275,290,15,25,15186,3,0
16476,ACGTCGACTCTAGGGA,275,287,12,20,15269,2,0
16477,ACGTCGAATCTAGGGA,275,276,1,20,15272,0,0
16478,ACGTCGAATCTAGGGA,275,278,3,26,15273,0,0
16479,TCGTCGAATCTATTGA,275,277,2,24,15285,0,0
16480,ACGTCGAATCTAGGGA,275,275,0,20,15374,0,0
16481,ACGTCGAATCTAGGGA,275,276,1,19,15375,0,0
16482,ACGTCGAATCTAGGGA,275,278,3,18,15379,0,0
16483,TCGTCGAATCTAGGTA,275,278,3,22,15538,0,0
16484,ACGTCGAATCTAGGGA,275,278,3,23,15542,0,0
16485,ACGTCGAATCTAGGGA,275,278,3,16,15662,0,0
16486,ACGTCGAATCTAGGGA,275,278,3,23,15717,0,0
16487,ACGTCGAATCTAGGGA,275,275,0,25,15719,0,0
16488,ACGTCGAATCTAGGGA,275,278,3,21,15845,0,0
16489,ATGTCGAATCTAGGGA,275,278,3,24,15847,0,0
16490,TCGTCGAATCTAGGGA,275,278,3,24,15850,0,0
16491,ACGTCGAATCTAGGGA,275,278,3,22,15852,0,0
16492,ACGTCGAATCTAGGGA,275,278,3,17,15853,0,0
16493,TCGTCGAATCTATTGA,275,276,1,23,15885,0,0
16494,ACGTCGAATCTAGGGA,275,278,3,22,15886,0,0
16495,ACGTCGAATCCAGGGA,275,275,0,28,15887,0,0
16496,ACGTCGAATCTAGGGA,275,278,3,17,15891,0,0
16497,ACGTCGAATCTAGGGA,275,275,0,22,15894,0,0
16498,ACGTCGAATCTAGGGA,275,278,3,18,15895,0,0
16499,ACATCGAATCTAGGGA,275,278,3,24,15897,0,0
16500,ACGTCGAATGTAGGGA,275,278,3,22,15907,0,0
16501,ACGTCGAATCAAGGGA,275,278,3,24,15909,0,0
16502,ACGTCGAATCTAGGGA,275,278,3,19,15911,0,0
16503,ACGTCGAATCTAGGGA,275,278,3,22,15912,0,0
16504,ACGTCGAATCTAGGGA,275,278,3,23,15915,0,0
16505,ACGTCGAATCGAGGGA,275,276,1,24,15917,0,0
16506,ACGTTGAATCTAGGGA,275,278,3,26,15918,0,0
16507,ACGTCGAATCTAGGGA,275,278,3,23,15922,0,0
16508,ACGTCGAATCTAGGGA,275,278,3,23,15924,0,0
16509,ACGTCGAATCTAGGGA,275,278,3,23,15928,0,0
16510,ACGTCGAATGTAGGGA,275,278,3,22,15933,0,0
16511,ACGTCGAATCTAGGGA,275,278,3,25,15934,0,0
16512,ACGTCGAATCTAGGGA,275,278,3,23,16068,0,0
16513,ACGTCGAATCTAGGGA,275,278,3,17,16070,0,0
16514,ACGTCGAATCTAGGGA,275,276,1,21,16071,0,0
16515,ACGTCGAATCTAGGGA,275,278,3,23,16073,0,0
16516,ACGTCGAATCTAGGGA,275,278,3,23,16074,0,0
16517,ACGTCGAATCTAGGGT,275,276,1,24,16075,0,0
16518,ACGTCGAATCGAGGGA,275,278,3,19,16077,0,0
16519,ACCTCGAATCTAGGGA,275,276,1,23,16078,0,0
16520,ACGTCGAATCTAGGGA,275,278,3,23,16079,0,0
16521,ACGTCGCATCTAGGGA,275,278,3,22,16081,0,0
16522,ACGTCGAATCTAGGGA,275,278,3,25,16083,0,0
16523,ACGTCGAATCTAGGGA,275,278,3,24,16084,0,0
16524,TCGTCGAATCTAGGGA,275,278,3,25,16085,0,0
16525,ACGTCGAATCTAGGGA,275,276,1,18,16087,0,0
16526,ACGTCGAATCGAGGGA,276,291,15,21,13130,3,0
16527,ACGTCGAATCTAGGGA,276,302,26,20,13656,7,0
16528,ACGTCGAATCTAGGGA,276,299,23,23,13671,6,0
16529,ACGTCGAATCTAGGGA,276,276,0,23,14039,0,0
16530,ACGTCGAATCGAGGGA,276,277,1,17,14251,0,0
16531,ACGTCGAATGTAGGGA,276,285,9,19,14736,1,0
16532,ACGTCGAATCTAGGGA,276,297,21,22,15076,5,0
16533,TCGTCGAATCTAGGGA,276,282,6,22,15080,0,0
16534,ACGTCGAATCTAGGGA,276,292,16,22,15086,3,0
16535,ACGTCGAATCTAGGGA,276,280,4,25,15101,0,0
16536,ACGTCGAATCTAGGGA,276,284,8,18,15102,1,0
16537,ACGTCGAAAGTAGGGA,276,292,16,20,15251,3,0
16538,ACGTCGAATCTAGGGA,276,284,8,23,15265,1,0
16539,ACGTCGAATGTAGGGA,276,279,3,19,15431,0,0
16540,ACGTCGAATCTAGGGA,276,276,0,22,15613,0,0
16541,ACGTCGAATCTAGGGA,276,281,5,23,15617,0,0
16542,ACGTCGAATCTAGGGA,276,289,13,24,15621,2,0
16543,ACGTCGAATCTAGGGA,276,283,7,22,15626,0,0
16544,ACGTCGGATCTAGGGA,276,280,4,24,15633,0,0
16545,ACGTCGAATCTAGGGA,276,281,5,27,15648,0,0
16546,ACGTCGAATCTAGGGA,276,276,0,25,15654,0,0
16547,ACGTCGAATCTAGGGA,276,279,3,25,15656,0,0
16548,ACGTCGAATCTAGGGA,276,281,5,21,15658,0,0
16549,ACGTCGAATCTAGGGA,276,276,0,26,15715,0,0
16550,ACGTCGAATCTAGGGA,276,281,5,20,15768,0,0
16551,ACGTCGATTCTGGGGA,276,277,1,19,15769,0,0
16552,TCGTCGAATCTAGGGA,276,276,0,23,15786,0,0
16553,ACGTCGAATCTAGGGA,276,294,18,24,15788,4,0
16554,ACGTCGAATCTAGGGA,276,278,2,19,15789,0,0
16555,ACGTCGAATCTAGGGA,276,282,6,22,15794,0,0
16556,ACGTCGAATCTAGGGA,276,277,1,20,15797,0,0
16557,ACGTCGAATCTAGGGA,276,276,0,26,15798,0,0
16558,AAGTCGAATCTAGGGA,276,288,12,25,15799,2,0
16559,ACGTCGAATCTAGGGA,276,282,6,23,15802,0,0
16560,ACGTCGAATCGAGGGA,276,276,0,24,15803,0,0
16561,ACGTCGAATCTAGGGA,276,295,19,19,15804,4,0
16562,ACGTCGACTCTAGGGA,276,279,3,21,15805,0,0
16563,ACGTCGAATCTAGGGA,276,295,19,21,15806,4,0
16564,ACGTCGAATCTAGGGA,276,277,1,21,15809,0,0
16565,ACGTCGAATCTAGGGA,276,288,12,27,15811,2,0
16566,ACGCCGAATCTAGGGA,276,283,7,22,15819,0,0
16567,ACGTCGAATCTAGGGA,276,284,8,26,15821,1,0
16568,ACGTCGAATCTAGGGA,276,282,6,26,15837,0,0
16569,ACGTCGAATCTAGGGA,276,281,5,25,15941,0,0
16570,ACGTCGAATCTAGGGA,276,287,11,24,15948,2,0
16571,TCGTCGAATCTATTGA,276,277,1,23,16048,0,0
16572,ACGTCGAATCTAGGGA,276,286,10,23,16053,1,0
16573,ACGTCGAATCTAGGGA,276,302,26,20,16054,7,0
16574,ACGTTGAATCTAGGGA,276,305,29,25,16055,8,0
16575,ACGTCGAATCTAGGGA,276,281,5,26,16058,0,0
16576,ACGTCGAATCTAGGGA,276,285,9,19,16059,0,0
16577,ACGTCGAATCTAGGGA,276,302,26,24,16061,6,0
16578,ACGTCGAATCTAGGGA,276,277,1,27,16062,0,0
16579,ACGTCGAATCTAGGGA,276,282,6,25,16063,0,0
16580,ACGTCGAATCTAGGGA,276,283,7,24,16064,0,0
16581,ACGTCGAATGTAGGGA,276,285,9,22,16065,0,0
16582,ACGTCGAATCTAGGGA,276,278,2,19,16105,0,0
16583,ACGTCGAATCTAGGGA,276,283,7,18,16106,0,0
16584,ACGTCGAATCTAGGGA,276,283,7,24,16107,0,0
16585,ACGTCGAATCTAGGGA,276,282,6,25,16108,0,0
16586,TCGTCGAATCTAGGGA,276,293,17,23,16109,3,0
16587,ACGTCGAATCTAGGGA,276,277,1,26,16111,0,0
16588,ACGTCGGATCTAGGGA,276,279,3,24,16112,0,0
16589,ACGTCGAATCTAGGGA,276,278,2,23,16114,0,0
16590,ACGTCGAATCTAGGGA,276,282,6,24,16115,0,0
16591,ACGTCGAATCTAGGGA,276,307,31,21,16117,8,0
16592,ACGTCGAATCTAGGGA,276,299,23,22,16118,5,0
16593,ACGTCGAATCTAGGGT,276,310,34,20,16119,9,0
16594,ACGTCGACTCTAGGGA,276,307,31,21,16123,8,0
16595,TCGTCGAATCTATTGA,276,281,5,25,16127,0,0
16596,ACGTCGAATCTAGGGA,277,289,12,27,14079,2,0
16597,ACGTCGAATCTAGGGA,277,281,4,23,14084,0,0
16598,ACGTCGAATCTAGGGA,277,278,1,16,14225,0,0
16599,ACGTTGAATCTAGGGA,277,305,28,24,14626,7,0
16600,ACGTCGAATCTAGGGA,277,281,4,25,14864,0,0
16601,ACGTCGAATCTAGGGA,277,281,4,23,14965,0,0
16602,ACGTCGAATCTAGGGA,277,282,5,26,14978,0,0
16603,ACGTCGAATCTAGGGA,277,280,3,18,15398,0,0
16604,ACGTCGAATCTAGGGA,277,278,1,23,15497,0,0
16605,ACGTCGAATCGAGGGA,277,280,3,18,15502,0,0
16606,ACGTCGAATCTAGGGA,277,279,2,22,15503,0,0
16607,ACGTCGAATCTAGGGA,277,280,3,24,15513,0,0
16608,ACGTCGAATGTAGGGA,277,280,3,21,15518,0,0
16609,ACGTCGAATCTAGGGA,277,280,3,17,15677,0,0
16610,ACGTCGAATCTAGGGA,277,280,3,24,15682,0,0
16611,ACGTCGAATCTAGGGA,277,280,3,21,15683,0,0
16612,TCGTCGAATCTAGGGA,277,280,3,23,15690,0,0
16613,ACGTCGAATCTAGGGA,277,280,3,23,15693,0,0
16614,ACGTCGAATCTAGGGA,277,280,3,24,15702,0,0
16615,ACGTCGAATCTAGGGA,277,280,3,21,15705,0,0
16616,ACGTCGAATCTAGGGA,277,280,3,17,15708,0,0
16617,ACGTCGAATCTAGGGA,277,280,3,23,15857,0,0
16618,ACGTCGAATCGAGGGA,277,277,0,22,15999,0,0
16619,ACGTCGAATCTAGGGA,277,280,3,24,16003,0,0
16620,ACGTCGAATCTAGGGA,277,280,3,24,16004,0,0
16621,ACGTCGATTCTGGGGA,277,280,3,20,16008,0,0
16622,TCGTCGAATCTAGGGA,277,280,3,23,16010,0,0
16623,ACGTCGAATCTAGGGA,277,280,3,23,16011,0,0
16624,ACGTCGAATCTAGGGA,277,280,3,19,16014,0,0
16625,ACGTCGAATCTAGGGA,277,280,3,21,16017,0,0
16626,ACGTCGAATCTAGGGA,277,280,3,22,16025,0,0
16627,ACGTCGAATCTAGGGA,277,280,3,17,16026,0,0
16628,ACGTCGAATCTAGGGA,277,277,0,22,16028,0,0
16629,ACGTCGAATCTAGGGA,277,280,3,27,16034,0,0
16630,ACGTCGAATCTAGGGA,277,280,3,25,16035,0,0
16631,TCGTCGAATCTATTGA,277,280,3,25,16039,0,0
16632,ACGTCGAATCTAGGGA,277,280,3,20,16041,0,0
16633,ACGTCGAATCTAGGGA,277,280,3,26,16043,0,0
16634,ACGTCGAATCGAGGGA,277,280,3,22,16157,0,0
16635,ACGTCGAATCTAGGGA,277,280,3,21,16159,0,0
16636,ACGTCGATTCTGGGGA,277,277,0,20,16164,0,0
16637,TCGTCGAATCTAGGGA,277,280,3,23,16166,0,0
16638,ACGTCGAATCTAGGGA,277,277,0,23,16167,0,0
16639,ACGTCGAATCTAGGGA,277,280,3,24,16168,0,0
16640,ACGTCGAATCTAGGGA,277,280,3,19,16170,0,0
16641,ACGTCGAATCTAGGGA,277,280,3,17,16173,0,0
16642,ACGTCGAATCTAGGGA,277,280,3,18,16175,0,0
16643,ACGTCGAATCTAGGGA,277,280,3,22,16179,0,0
16644,ACGTCGAATCTAGGGA,277,280,3,23,16180,0,0
16645,ACGTCGAATCTAGGGA,277,280,3,22,16181,0,0
16646,ACGTCGAATCTAGGGA,277,280,3,19,16183,0,0
16647,ACGTCGAATCTAGGGA,277,280,3,25,16184,0,0
16648,ACGTCGAATCTAGGGA,277,280,3,26,16186,0,0
16649,ACGTCGAATCTAGGGA,277,280,3,25,16187,0,0
16650,ACGTCGAATCTAGGGA,277,277,0,18,16188,0,0
16651,ACGTCGAATCTAGGGA,277,280,3,22,16197,0,0
16652,ACGTCGAATCTAGGGA,277,280,3,27,16199,0,0
16653,ACGTCGAATCTAGGGA,278,281,3,19,13248,0,0
16654,ACGTCGATTCTGGGGA,278,283,5,18,13267,0,0
16655,ACGTCGGATCTAGGGA,278,290,12,23,14752,2,0
16656,TCGTCGAATCTAGGGA,278,290,12,22,14838,2,0
16657,ACGTCGAATCTAGGGA,278,281,3,22,14845,0,0
16658,ACGTCGAATCTAGGGA,278,285,7,23,14846,0,0
16659,TCGTCGAATCTATTGA,278,278,0,23,14858,0,0
16660,ACGTCGAATCTAGGGA,278,285,7,19,15184,0,0
16661,ACGTCGAATCTAGGGA,278,281,3,25,15186,0,0
16662,ACGTCGACTCTAGGGA,278,278,0,20,15269,0,0
16663,ACGTCGAATCTAGGGA,278,282,4,20,15272,0,0
16664,TCGTCGAATCTATTGA,278,283,5,24,15285,0,0
16665,ACGTCGAATCTAGGGA,278,280,2,20,15374,0,0
16666,ACGTCGAATCTAGGGA,278,278,0,18,15379,0,0
16667,TCGTCGAATCTAGGGA,278,340,62,22,15538,19,0
16668,ACGTCGAATCTAGGGA,278,278,0,23,15542,0,0
16669,ACGTCGAATCTAGGGA,278,284,6,16,15662,0,0
16670,ACGTCGAATCTAGGGA,278,284,6,23,15717,0,0
16671,ACGTCGAATCTAGGGA,278,294,16,25,15719,3,0
16672,ACGTCGAATCTAGGGA,278,291,13,21,15845,2,0
16673,ACGTCGAATCTAGGGA,278,293,15,22,15852,3,0
16674,ACGTCGAATCTAGGGA,278,288,10,17,15853,1,0
16675,ACGTCGAATCCAGGGA,278,280,2,28,15887,0,0
16676,ACATCGAATCTAGGGA,278,295,17,24,15897,4,0
16677,ACGTCGAATCTAGGGA,278,283,5,19,15911,0,0
16678,ACGTCGAATCTAGGGA,278,283,5,22,15912,0,0
16679,ACGTCGAATCTAGGGA,278,301,23,23,15928,6,0
16680,ACGTCGAATGTAGGGA,278,281,3,22,15933,0,0
16681,ACGTCGAATCTAGGGA,278,281,3,25,15934,0,0
16682,ACGTCGAATCTAGGGA,278,280,2,23,16068,0,0
16683,ACGTCGAATCTAGGGA,278,278,0,17,16070,0,0
16684,ACGTCGAATCTAGGGA,278,278,0,21,16071,0,0
16685,ACGTCGAATCTAGGGA,278,291,13,23,16073,2,0
16686,ACGTCGAATCTAGGGA,278,327,49,23,16074,14,0
16687,ACGTCGAATCTAGGGA,278,308,30,24,16075,8,0
16688,ACGTCGAATCGAGGGA,278,292,14,19,16077,3,0
16689,ACGTCGAATCTAGGGA,278,278,0,23,16079,0,0
16690,ACGTCGCATCTAGGGA,278,288,10,22,16081,1,0
16691,ACGTCGAATCTAGGGA,278,287,9,24,16084,1,0
16692,TCGTCGAATCTAGGGA,278,281,3,25,16085,0,0
16693,ACGTCGAATCTAGGGA,278,278,0,18,16087,0,0
16694,ACGTCGAATCTAGGGA,278,286,8,28,16232,1,0
16695,ACGTCGAATCTAGGGA,278,278,0,23,16235,0,0
16696,ACGTCGAATCTAGGGA,278,282,4,20,16236,0,0
16697,ACGTTGAATCTAGGGA,278,313,35,25,16238,10,0
16698,ACGTCGAATCTAGGGA,278,279,1,19,16240,0,0
16699,ACGTCGAATCTAGGGA,278,280,2,24,16242,0,0
16700,ACGTCGAATCTAGGGA,278,278,0,19,16246,0,0
16701,ACGTCGAATCTAGGGA,278,283,5,24,16248,0,0
16702,ACGTCGAATCTAGGGA,278,278,0,17,16249,0,0
16703,ACGTCGAATCTAGGGA,278,294,16,21,16250,3,0
16704,ACGTCGAATCTAGGGA,278,313,35,24,16253,10,0
16705,ACGTCGAATCTAGGGA,278,278,0,26,16254,0,0
16706,ACGTCGAATCTAGGGA,279,291,12,20,13656,3,0
16707,ACGTCGAATCTAGGGA,279,301,22,23,13671,6,0
16708,ACGTCGAATCGAGGGA,279,293,14,17,14251,3,0
16709,ACGACGAATCTAGGGA,279,282,3,22,15076,0,0
16710,TCGTCGAATCTAGGGA,279,281,2,22,15080,0,0
16711,ACGTCGAATCTAGGGA,279,286,7,25,15101,0,0
16712,ACGTCGAATCTAGGGA,279,299,20,18,15102,5,0
16713,ACGTCGAAAGTAGGGA,279,287,8,20,15251,1,0
16714,ACGTCGAATCTAGGGA,279,296,17,23,15265,4,0
16715,ACGTCGAATGTAGGGA,279,299,20,19,15431,5,0
16716,ACGTCGAATCTAGGGA,279,283,4,22,15613,0,0
16717,ACGTCGAATCTAGGGA,279,286,7,24,15621,0,0
16718,ACGTCGAATCTAGGGA,279,305,26,22,15626,7,0
16719,ACGTCGGATCTAGGAA,279,282,3,24,15633,0,0
16720,ACGTCGAATCTAGGGA,279,282,3,27,15648,0,0
16721,ACGTCGAATCTAGGGA,279,304,25,25,15656,6,0
16722,ACGTCGAATCTAGGGA,279,283,4,21,15658,0,0
16723,ACGTCGAATCTAGGGA,279,286,7,20,15768,0,0
16724,TCGTCGAATCTAGGGA,279,292,13,23,15786,2,0
16725,ACGTCGAATCTAGGGA,279,293,14,19,15789,3,0
16726,ACGTCGAATCTAGGGA,279,283,4,22,15794,0,0
16727,ACGTCGAATCTAGGGA,279,287,8,20,15797,1,0
16728,ACGTCGAATCTAGGGA,279,283,4,26,15798,0,0
16729,ACGTCGAATCTAGGGA,279,294,15,23,15802,3,0
16730,ACGTCGAATCGAGGGA,279,298,19,24,15803,4,0
16731,ACGTCGAATCTAGGGA,279,312,33,19,15804,9,0
16732,ACGTCGACTCTAGGGA,279,299,20,21,15805,5,0
16733,ACGTCGAATCTAGGGA,279,282,3,21,15809,0,0
16734,ACGTCGAATCTAGGGA,279,282,3,26,15821,0,0
16735,ACGTCGAATCTAGGGA,279,282,3,25,15941,0,0
16736,ACGTCGAATCTAGGGA,279,282,3,24,15948,0,0
16737,TCGTCGAATCTATTGA,279,282,3,23,16048,0,0
16738,ACGTCGAATCTAGGGA,279,282,3,20,16054,0,0
16739,ACGTTGAATCTAGGGA,279,280,1,25,16055,0,0
16740,ACGTCGAATCTAGGGA,279,282,3,26,16058,0,0
16741,ACGTCGAATCTAGGGA,279,282,3,19,16059,0,0
16742,ACGTCGAATCTAGGGA,279,282,3,24,16061,0,0
16743,ACGTCGAATCTAGGGA,279,281,2,27,16062,0,0
16744,ACGTCGAATCTAGGGA,279,281,2,25,16063,0,0
16745,ACGTCGAATCTAGGGA,279,282,3,24,16064,0,0
16746,ACGTCGAATGTAGGGA,279,279,0,22,16065,0,0
16747,ACGTCGAATCTAGGGA,279,282,3,18,16106,0,0
16748,ACGTCGAATCTAGGGA,279,282,3,24,16107,0,0
16749,ACGTCGAATCTAGGGA,279,282,3,25,16108,0,0
16750,TCGTCGAATCTAGGGA,279,282,3,23,16109,0,0
16751,ACGTCGAATCTAGGGA,279,281,2,26,16111,0,0
16752,ACGTCGGATCTAGGGA,279,282,3,24,16112,0,0
16753,ACGTCGAATCTAGGGA,279,282,3,22,16118,0,0
16754,ACGTCGGATCTAGGGT,279,282,3,20,16119,0,0
16755,ACGTCGACTCTAGGGA,279,282,3,21,16123,0,0
16756,ACGTCGATTCTGGGGA,279,282,3,20,16201,0,0
16757,ACGTCGAATCTAGGGA,279,282,3,20,16273,0,0
16758,TCGTCGAATCTAGGGA,279,279,0,23,16275,0,0
16759,ACGTCGAATCTAGGGA,279,282,3,25,16276,0,0
16760,ACGTCGAATCTAGGGA,279,282,3,21,16282,0,0
16761,ACGTCGAATCTAGGGA,279,279,0,22,16283,0,0
16762,ACGTCGACTCTAGGGA,279,282,3,21,16287,0,0
16763,ACGTCGAATCTAGGGA,279,282,3,21,16288,0,0
16764,ACGTCGAATCTAGGGA,279,282,3,27,16290,0,0
16765,ACGTCGAATCTAGGGA,279,282,3,22,16292,0,0
16766,ACGTCGAATCTAGGGA,280,280,0,27,14079,0,0
16767,ACGTCGAATCTAGGGA,280,299,19,23,14084,4,0
16768,ACGTCGAATCTTGGGA,280,326,46,16,14225,13,0
16769,ACGTTGAATCTAGGGA,280,282,2,24,14626,0,0
16770,ACGTCGAATCTAGGGA,280,281,1,23,14965,0,0
16771,ACGTCGAATCTAGGGA,280,315,35,26,14978,10,0
16772,ACGTCGAATCTAGGGA,280,283,3,18,15398,0,0
16773,ACGTCGAATCTAGGGA,280,283,3,23,15497,0,0
16774,ACGTCGAATCGAGGGA,280,283,3,18,15502,0,0
16775,ACGTCGAATCTAGGGA,280,292,12,22,15503,2,0
16776,ACGTCGAATCTAGGGA,280,280,0,24,15513,0,0
16777,ACGTCGAATGTAGGGA,280,285,5,21,15518,0,0
16778,ACGTCGAATCTAGGGA,280,281,1,17,15677,0,0
16779,ACGTCGAATCTAGGGA,280,283,3,24,15682,0,0
16780,ACGTCGAATCTAGGGA,280,310,30,21,15705,8,0
16781,ACGTCGAATCTAGGGA,280,311,31,23,15857,8,0
16782,ACGTCGAATCGAGGGA,280,280,0,22,15999,0,0
16783,ACGTCGAATCTAGGGA,280,290,10,24,16003,1,0
16784,ACGTCGAATCTAGGGA,280,287,7,24,16004,0,0
16785,ACGTCGATTCTGGGGA,280,280,0,20,16008,0,0
16786,TCGTCGAATCTAGGGA,280,280,0,23,16010,0,0
16787,ACGTCGAATCTAGGGA,280,281,1,23,16011,0,0
16788,ACGTCGAATCTAGGGA,280,294,14,19,16014,3,0
16789,ACGTCGAATCTAGGGA,280,283,3,17,16026,0,0
16790,ACGTCGAATCTAGGGA,280,287,7,27,16034,0,0
16791,ACGTCGAATCTAGGGA,280,293,13,25,16035,2,0
16792,ACGTCGAATCTAGGGA,280,290,10,20,16041,1,0
16793,ACGTCGAATCTAGGGA,280,280,0,26,16043,0,0
16794,ACGTCGAATCGAGGGA,280,294,14,22,16157,3,0
16795,ACGTCGAATCTAGGGA,280,288,8,21,16159,1,0
16796,TCGTCGAATCTAGGGA,280,285,5,23,16166,0,0
16797,ACGTCGAATCTAGGGA,280,284,4,23,16167,0,0
16798,ACGTCGAATCTAGGGA,280,283,3,24,16168,0,0
16799,ACGTCGAATCTAGGGA,280,292,12,19,16170,2,0
16800,ACGTCGAATCTAGGGA,280,294,14,17,16173,3,0
16801,ACGTCGAATCTAGGGA,280,280,0,22,16179,0,0
16802,ACGTCGAATCTAGGGA,280,283,3,23,16180,0,0
16803,ACGTCGAATCTAGGGA,280,330,50,22,16181,15,0
16804,ACGTCGAATCTAGGGA,280,289,9,25,16184,1,0
16805,ACGTCGAATCTAGGGA,280,291,11,26,16186,2,0
16806,ACGTCGAATCTAGGGA,280,280,0,25,16187,0,0
16807,ACGTCGAATCTAGGGA,280,292,12,18,16188,2,0
16808,ACGTCGAATCTAGGGA,280,282,2,22,16197,0,0
16809,TCGTCGAATCTAGGGA,280,294,14,23,16298,3,0
16810,ACGTCGAATCGAGGGA,280,280,0,22,16336,0,0
16811,ACGTCGAATCTAGGGA,280,293,13,24,16339,2,0
16812,ACGTCGAATCTAGGGA,280,285,5,24,16340,0,0
16813,ACGTCGAATCGAGGGA,280,281,1,18,16341,0,0
16814,ACGTCGAATGTAGGGA,280,293,13,20,16342,2,0
16815,TCGTCGAATCTAGGGA,280,291,11,23,16344,2,0
16816,ACGTCGAATCTAGGGA,280,289,9,19,16348,1,0
16817,ACGTCGAAAGTAGGGA,280,291,11,21,16349,2,0
16818,ACGTCGAATCTAGGGA,280,301,21,24,16350,5,0
16819,ACGTCGAATCTAGGGA,280,287,7,25,16352,0,0
16820,ACGTCGAATCTAGGGA,280,282,2,23,16357,0,0
16821,ACGTCGAATCTAGGGA,280,286,6,26,16358,0,0
16822,ACGTCGAATCAAGGGA,280,283,3,18,16359,0,0
16823,ACGTCGGATCTAGGGA,280,282,2,25,16360,0,0
16824,TCGTCGAATCTATTGA,280,283,3,25,16362,0,0
16825,ACGTCGAATCTAGGGA,280,283,3,26,16365,0,0
16826,ACGTCGAATCTAGGGA,280,282,2,27,16368,0,0
16827,ACGTCGAATCTAGGGA,280,283,3,23,16372,0,0
16828,ACGTCGAATCTAGGGA,280,281,1,23,16377,0,0
16829,ACGTCGAATCTAGGGA,281,284,3,19,13248,0,0
16830,ACGTCGATTCTGGGGA,281,284,3,18,13267,0,0
16831,ACGTCGGATCTAGGGA,281,296,15,23,14752,3,0
16832,TAGTCGAATCTAGGGA,281,286,5,22,14838,0,0
16833,ACGTCGAATCTAGGGA,281,292,11,22,14845,2,0
16834,ACGTCGAATCTAGGGA,281,281,0,23,14846,0,0
16835,TCGTCGAATCTATTGA,281,285,4,23,14858,0,0
16836,ACGTCGAATCTAGGGA,281,286,5,19,15184,0,0
16837,ACGTCGAATCTAGGGA,281,283,2,25,15186,0,0
16838,ACGTCGACTCTAGGGA,281,282,1,20,15269,0,0
16839,ACGTCGAATCTAGGGA,281,313,32,20,15272,9,0
16840,ACGTCGAATCTAGGGA,281,287,6,20,15374,0,0
16841,ACGTCGAATCTAGGGA,281,307,26,18,15379,7,0
16842,TCGTCGAATCTAGGGA,281,295,14,22,15538,3,0
16843,ACGTCGAATCTAGGGA,281,292,11,23,15542,2,0
16844,ACGTCGAATCTAGGGA,281,282,1,16,15662,0,0
16845,ACGTCGAATCTAGGGA,281,281,0,23,15717,0,0
16846,ACGTCGAATCTAGGGA,281,282,1,25,15719,0,0
16847,ACGTCGAATCTAGGGA,281,290,9,21,15845,1,0
16848,ACGTCGAATCCAGGGA,281,284,3,28,15887,0,0
16849,ACATCGAATCTAGGGA,281,284,3,24,15897,0,0
16850,ACGTCGAATCTAGGGA,281,283,2,19,15911,0,0
16851,ACGTCGAATCTAGGGA,281,284,3,22,15912,0,0
16852,ACGTCGAATCTAGGGA,281,282,1,23,15928,0,0
16853,ACGTCGAATCTAGGGA,281,283,2,23,16068,0,0
16854,ACGTCGAATCTAGGGA,281,281,0,21,16071,0,0
16855,ACGTCGAATCTAGGGA,281,284,3,23,16073,0,0
16856,TCGTCGAATCTAGGGA,281,284,3,23,16074,0,0
16857,ACGTCGAATCTAGGGA,281,284,3,24,16075,0,0
16858,ACGTCGAATCGAGGGA,281,284,3,19,16077,0,0
16859,ACGTCGAATCTAGGGA,281,284,3,23,16079,0,0
16860,ACGTCGCATCTAGGGA,281,284,3,22,16081,0,0
16861,ACGTCGAATCTAGGGA,281,281,0,24,16084,0,0
16862,TCGTCGAATCTAGGGA,281,284,3,25,16085,0,0
16863,ACGTCGAATCTAGGGA,281,284,3,18,16087,0,0
16864,ACGTCGAATCTAGGGA,281,283,2,28,16232,0,0
16865,ACGTCGAATCTAGGGA,281,284,3,23,16235,0,0
16866,ACGTCGAATCTAGGGA,281,284,3,20,16236,0,0
16867,ACGTTGAATCTAGGGA,281,284,3,25,16238,0,0
16868,ACGTCGAATCTAGGGA,281,281,0,24,16242,0,0
16869,ACGTCGAATCTAGGGA,281,284,3,24,16248,0,0
16870,ACGTCGAATCTAGGGA,281,284,3,17,16249,0,0
16871,ACGTCGAATCTAGGGA,281,282,1,21,16250,0,0
16872,ACGTCGAATCTAGGGA,281,284,3,24,16253,0,0
16873,ACGTCGAATCTAGGGA,281,284,3,26,16254,0,0
16874,ACGTCGAATCTAGGGA,281,284,3,27,16420,0,0
16875,ACGTCGAATCTAGGGA,281,284,3,25,16421,0,0
16876,ACGTCGAATCGAGGGA,281,284,3,23,16422,0,0
16877,ACGTCGAATCTAGGGA,281,284,3,24,16426,0,0
16878,ACGTCGAATCTAGGGA,281,281,0,23,16428,0,0
16879,ACGTCGAATCTAGGGA,281,284,3,25,16430,0,0
16880,ACGTCGAATCTAGGGA,281,284,3,22,16431,0,0
16881,ACGTCGAATGTAGGGA,281,284,3,22,16432,0,0
16882,ACGTCGAATCTAGGGA,281,284,3,18,16433,0,0
16883,TCGTCGAATCTAGGGA,281,284,3,24,16437,0,0
16884,ACGTCGAATCGAGGGA,281,284,3,23,16444,0,0
16885,ACGTCGAATCTAGGGA,282,284,2,20,13656,0,0
16886,ACGTCGAATCGAGGGA,282,285,3,17,14251,0,0
16887,ACGTCGAATCTAGGGA,282,285,3,22,15076,0,0
16888,TCGTCGAATCTAGGGA,282,282,0,22,15080,0,0
16889,ACGTCGAATCTAGGGA,282,285,3,25,15101,0,0
16890,ACGTCGAATCTAGGGA,282,294,12,18,15102,2,0
16891,ACGTCGAAAGTAGGGA,282,282,0,20,15251,0,0
16892,ACGTCGAATCTAGGGA,282,282,0,23,15265,0,0
16893,ACGTCGAATGTAGGGA,282,285,3,19,15431,0,0
16894,ACGTCGAATCTAGGGA,282,282,0,22,15613,0,0
16895,ACGTCGAATCTAGGGA,282,288,6,22,15626,0,0
16896,ACGTCGAATCTAGGGA,282,292,10,27,15648,1,0
16897,ACGTCGAATCTAGGGT,282,290,8,25,15656,1,0
16898,ACGTCGAATCTAGGGA,282,291,9,21,15658,1,0
16899,ACGTCGAATCTAGGGA,282,299,17,20,15768,4,0
16900,TCGTCGAATCTAGGGA,282,298,16,23,15786,3,0
16901,ACGTCGAATCTAGGGA,282,286,4,22,15794,0,0
16902,ACGTCGAATCTAGGGA,282,293,11,26,15798,2,0
16903,ACGTCGAATCTAGGGA,282,301,19,23,15802,4,0
16904,ACGTCGACTCTAGGGA,282,286,4,21,15805,0,0
16905,ACGTCGAATCTAGGGA,282,301,19,21,15809,4,0
16906,ACGTCGAATCTAGGGA,282,303,21,26,15821,5,0
16907,ACGTCGAATCTAGGGA,282,310,28,25,15941,7,0
16908,TCGTCGAATCTATTGA,282,283,1,23,16048,0,0
16909,ACGTCGAATCTAGGGA,282,294,12,20,16054,2,0
16910,ACGTTGAATCTAGGGA,282,288,6,25,16055,0,0
16911,ACGTCGAATCTAGGGA,282,283,1,26,16058,0,0
16912,ACGTCGAATCTAGGGA,282,283,1,19,16059,0,0
16913,ACGTCGAATCTAGGGA,282,288,6,24,16061,0,0
16914,ACGTCGAATCTAGGGA,282,292,10,27,16062,1,0
16915,ACGTCGAATCTAGGGA,282,291,9,25,16063,1,0
16916,ACGTCGAATCTAGGGA,282,283,1,24,16064,0,0
16917,ACGTCGAATGTAGGGA,282,291,9,22,16065,1,0
16918,ACGTCGAATCTAGGGA,282,296,14,18,16106,3,0
16919,ACGTCGAATCTAGGGA,282,284,2,24,16107,0,0
16920,TCGTCGAATCTAGGGA,282,286,4,23,16109,0,0
16921,ACGTCGGATCTAGGGA,282,288,6,24,16112,0,0
16922,ACGTCGAATCTAGGGT,282,290,8,20,16119,1,0
16923,ACGTCGATTCTGGGGA,282,308,26,20,16201,7,0
16924,TCGTCGAATCTAGGGA,282,305,23,23,16275,6,0
16925,ACGTCGAATCTAGGGA,282,284,2,22,16283,0,0
16926,ACGTCGACTCTAGGGA,282,282,0,21,16287,0,0
16927,ACGTCGAATCTAGGGA,282,308,26,21,16288,7,0
16928,ACGTCGAATCTAGGGA,282,285,3,27,16290,0,0
16929,ACGTCGAATCTAGGGA,282,283,1,22,16292,0,0
16930,ACGTCGAATCTAGGGA,282,288,6,21,16378,0,0
16931,ACGTCGAATCTAGGGA,282,290,8,24,16381,1,0
16932,ACGTCGAATCGAGGGA,282,289,7,25,16382,0,0
16933,ACGTCGAATCTAGGGA,282,288,6,20,16463,0,0
16934,ACGTCGATTCTGGGGA,282,309,27,19,16464,7,0
16935,ACGTCGAATCTAGGGA,282,310,28,23,16468,7,0
16936,ACGTCGAATCTAGGGA,282,283,1,24,16469,0,0
16937,ACGTCGAATCTAGGGA,282,283,1,21,16471,0,0
16938,ACGTCGAATCTAGGGA,282,299,17,22,16472,3,0
16939,ACGTCGAATCTAGGGT,282,285,3,20,16473,0,0
16940,ACGTCGAATCTAGGGA,282,295,13,20,16474,2,0
16941,ACGTCGAATCTAGGGA,282,326,44,26,16475,12,0
16942,ACGTCGAATCTAGGGA,283,298,15,27,14079,3,0
16943,ACGTCGAATCTAGGGA,283,295,12,23,14084,2,0
16944,ACGTCGAATCTAGGGA,283,303,20,16,14225,5,0
16945,ACGTTGAATCTAGGGA,283,285,2,24,14626,0,0
16946,ACGTCGAATCTAGGGA,283,298,15,23,14965,3,0
16947,ACGTCGAATCTAGGGA,283,284,1,26,14978,0,0
16948,ACGTCGAATCGAGGGA,283,291,8,18,15502,1,0
16949,ACGTCGAATCTAGGGA,283,284,1,22,15503,0,0
16950,ACGTCGAATCTAGGGA,283,316,33,24,15513,9,0
16951,ACGTCGAATCTAGGGA,283,287,4,24,15682,0,0
16952,ACGTCGAATCGAGGGA,283,283,0,22,15999,0,0
16953,ACGTCGAATCTAGGGA,283,308,25,24,16003,6,0
16954,ACGTCGAATCTAGGGA,283,287,4,24,16004,0,0
16955,ACGTCGATTCTGGGGA,283,287,4,20,16008,0,0
16956,TCGTCGAATCTAGGGA,283,310,27,23,16010,7,0
16957,ACGTCGAATCTAGGGA,283,286,3,23,16011,0,0
16958,ACGTCGAATCTAGGGA,283,283,0,17,16026,0,0
16959,ACGTCGAATCTAGGGA,283,286,3,27,16034,0,0
16960,ACGTCGAATCTAGGGA,283,286,3,25,16035,0,0
16961,ACGTCGAATCTAGGGA,283,286,3,20,16041,0,0
16962,ACGTCGAATCTAGGGA,283,286,3,26,16043,0,0
16963,ACGTCGAATCTAGGGA,283,286,3,21,16159,0,0
16964,TCGTCGAATCTAGGGA,283,286,3,23,16166,0,0
16965,ACGTCGAATCTAGGGA,283,285,2,23,16167,0,0
16966,ACGTCGAATCTAGGGA,283,286,3,24,16168,0,0
16967,ACGTCGAATCTAGGGA,283,286,3,19,16170,0,0
16968,ACGTCGAATCTAGGGA,283,286,3,22,16179,0,0
16969,ACGTCGAATCTAGGGA,283,283,0,23,16180,0,0
16970,ACGTCGAATCTAGGGA,283,286,3,22,16181,0,0
16971,ACGTCGAATCTAGGGA,283,286,3,25,16184,0,0
16972,ACGTCGAATCTAGGGA,283,286,3,25,16187,0,0
16973,ACGTCGAATCGAGGGA,283,286,3,22,16336,0,0
16974,ACGTCGAATCTAGGGA,283,286,3,24,16339,0,0
16975,ACGTCGAATCTAGGGA,283,286,3,24,16340,0,0
16976,ACGTCGAATGTAGGGA,283,285,2,20,16342,0,0
16977,ACGTCGAAAGTAGGGA,283,286,3,21,16349,0,0
16978,ACGTCGAATCTAGGGA,283,286,3,23,16357,0,0
16979,ACGTCGAATCTAGGGA,283,286,3,27,16368,0,0
16980,ACGTCGAATCTAGGGA,283,286,3,23,16377,0,0
16981,ACGTCGAATCTAGGGA,283,286,3,24,16449,0,0
16982,ACGTCGAATCTAGGGA,283,286,3,22,16452,0,0
16983,ACGTCGACTCTAGGGA,283,286,3,21,16476,0,0
16984,ACGTCGAATCGAGGGA,283,286,3,22,16526,0,0
16985,ACGTCGAATCTAGGGA,283,283,0,21,16527,0,0
16986,ACGTCGAATCTAGGGA,283,283,0,24,16528,0,0
16987,ACGTCGAATGTAGGGA,283,283,0,20,16531,0,0
16988,ACGTCGAATCTAGGGA,283,286,3,23,16532,0,0
16989,ACGTCGAATCTAGGGA,283,286,3,23,16534,0,0
16990,ACGTCGAATCTAGGGA,283,283,0,19,16536,0,0
16991,ACGTCGAAAGTAGGGA,283,286,3,21,16537,0,0
16992,ACGTCGAATCTAGGGA,283,286,3,24,16538,0,0
16993,ACGTCGAATCTAGGGA,283,286,3,25,16542,0,0
16994,ACGTCGAATCTAGGGA,283,286,3,25,16553,0,0
16995,AAGTCGAATTTAGGGA,283,283,0,26,16558,0,0
16996,ACGTCGAATCTAGGGA,283,286,3,20,16561,0,0
16997,ACGTCGAATCTAGGGA,283,286,3,22,16563,0,0
16998,ACGTCAAATCTAGGGA,283,284,1,28,16565,0,0
16999,ACGTCGAATCTAGGGA,283,286,3,27,16567,0,0
17000,ACGTCGAATCTAGGGA,283,285,2,25,16570,0,0
17001,ACGTCGAATCTAGGGA,283,286,3,24,16572,0,0
17002,ACGTCGAATCTAGGGA,283,286,3,21,16573,0,0
17003,ACGTTGAACCTAGGGA,283,286,3,26,16574,0,0
17004,ACGTCGAATCTAGGGA,284,296,12,19,13248,2,0
17005,ACGTCGATTCTGGGGA,284,288,4,18,13267,0,0
17006,ACGTCGGATCTAGGGA,284,284,0,23,14752,0,0
17007,ACGTCGAATCTAGGGA,284,285,1,22,14845,0,0
17008,ACGTCGAATCTAGGGA,284,296,12,23,14846,2,0
17009,TCGTCGAATCTATTGA,284,287,3,23,14858,0,0
17010,ACGTCGAATCTAGGGA,284,291,7,19,15184,0,0
17011,ACGTCGAATCTAGGGA,284,286,2,25,15186,0,0
17012,ACGTCGACTCTAGGGA,284,323,39,20,15269,11,0
17013,ACGTCGAATCTAGGGA,284,285,1,20,15272,0,0
17014,ACGTCGAATCTAGGGA,284,288,4,20,15374,0,0
17015,ACGTCGAATCTAGGGA,284,298,14,18,15379,3,0
17016,TCGTCGAATCTAGGGA,284,292,8,22,15538,1,0
17017,ACGTCGAATCTAGGGA,284,284,0,23,15542,0,0
17018,ACGTCGAATCTAGGGA,284,288,4,16,15662,0,0
17019,ACGTCGAATCTAGGGA,284,305,21,25,15719,5,0
17020,ACGTCGAATCTAGGGA,284,297,13,19,15911,2,0
17021,ACGTCGAATCTAGGGA,284,286,2,23,15928,0,0
17022,ACGTCGAATCTAGGGA,284,300,16,23,16068,3,0
17023,ACGTCGAATCTAGGGA,284,290,6,21,16071,0,0
17024,ACGTCGAATCTAGGGA,284,290,6,23,16073,0,0
17025,ACGTCGAATCTAGGGA,284,285,1,23,16074,0,0
17026,ACGTCGAATCGAGGGA,284,304,20,19,16077,5,0
17027,ACGTCGAATCTAAGGA,284,289,5,24,16084,0,0
17028,ACGTCGAATCTAGGGA,284,286,2,18,16087,0,0
17029,ACGTCGAATCTAGGGA,284,284,0,28,16232,0,0
17030,ACGTCGAATCTAGGGA,284,296,12,23,16235,2,0
17031,ACGTCGAATCTAGGGA,284,286,2,24,16248,0,0
17032,ACGTCGAATCTAGGGA,284,296,12,17,16249,2,0
17033,ACGTCGAATCTAGGGA,284,299,15,21,16250,3,0
17034,ACGTCGAATCTAGGGA,284,289,5,24,16253,0,0
17035,ACGTCGAATCTAGGGA,284,288,4,26,16254,0,0
17036,ACGTCGAATCTGGGGA,284,289,5,25,16421,0,0
17037,ACGTCGAATCGAGGGA,284,294,10,23,16422,1,0
17038,ACGTCGAATCTAGGGA,284,289,5,24,16426,0,0
17039,ACGTCGAATCTAGGGA,284,297,13,23,16428,2,0
17040,ACGTCGAATCTAGGGA,284,284,0,25,16430,0,0
17041,ACGTCGAATCTAGGGA,284,292,8,22,16431,1,0
17042,ACGTCGAATGTAGGGA,284,289,5,22,16432,0,0
17043,ACGTCGAATCTAGGGA,284,288,4,18,16433,0,0
17044,ACGTCGAATCGAGGGA,284,291,7,23,16444,0,0
17045,ACGTCGAATCTAGGGA,284,284,0,28,16596,0,0
17046,ACGTTGAATCTAGGGA,284,289,5,25,16599,0,0
17047,ACGTCGAATCTAGGGA,284,284,0,21,16706,0,0
17048,ACGTCGAATCTAGGGA,284,284,0,24,16707,0,0
17049,ACGTCGAATCGAGGGA,284,284,0,18,16708,0,0
17050,AAGTCGAATCTAGGGA,285,287,2,20,13656,0,0
17051,ACGTCGAATCGAGGGA,285,288,3,17,14251,0,0
17052,TCGTCGAATCTAGGGA,285,292,7,22,15080,1,0
17053,ACGTCGAGTCTAGGGA,285,307,22,25,15101,6,0
17054,ACGTCGAATCTAGGGA,285,298,13,18,15102,3,0
17055,ACGTCGAAAGTAGGGA,285,310,25,20,15251,7,0
17056,ACGTCGAATCTAGGGA,285,285,0,23,15265,0,0
17057,ACGTCGAATGTAGGGA,285,293,8,19,15431,1,0
17058,ATGTCGAATCTAGGGA,285,298,13,27,15648,3,0
17059,ACGTCGAATCTAGGGA,285,288,3,25,15656,0,0
17060,ACGTCGAATCTAGGGA,285,288,3,21,15658,0,0
17061,ACGTCGAATCTAGGGA,285,291,6,20,15768,0,0
17062,TCGTCGAATCTAGGGA,285,287,2,23,15786,0,0
17063,ACGTCGAATCTAGGGA,285,285,0,26,15798,0,0
17064,ACGTCGAATCTAGGGA,285,288,3,23,15802,0,0
17065,ACGTCGACTCTAGGGA,285,288,3,21,15805,0,0
17066,ACGTCGAATCTAGGGA,285,289,4,21,15809,0,0
17067,ACGTCGAATCTAGGGA,285,300,15,26,15821,3,0
17068,ACGTCGAATCTAGGGA,285,287,2,25,15941,0,0
17069,TCGTCGAATCTATTGA,285,289,4,23,16048,0,0
17070,ACGTCGAATCTAGGGA,285,289,4,20,16054,0,0
17071,ACGTTGAATCTAGGGA,285,314,29,25,16055,8,0
17072,ACGTCGAATCTAGGGA,285,285,0,26,16058,0,0
17073,ACGTCGAATCTAGGGA,285,285,0,24,16061,0,0
17074,ACGTCGAATCTAGGGA,285,338,53,27,16062,16,0
17075,ACGTCGAATCTAGGGA,285,301,16,25,16063,3,0
17076,ACGTCGAATCTAGGGA,285,296,11,24,16064,2,0
17077,ACGTCGAATGTAGGGA,285,301,16,22,16065,3,0
17078,ACGTCGAATCTAGGGA,285,286,1,18,16106,0,0
17079,ACGTCGAATCTAGGGA,285,291,6,24,16107,0,0
17080,TCGTCGAATCTAGGGA,285,296,11,23,16109,2,0
17081,ACGTCGATTCTGGGGA,285,328,43,20,16201,12,0
17082,TCGTCGAATCTAGGGA,285,299,14,23,16275,3,0
17083,ACGTCGACTCTAGGGA,285,285,0,21,16287,0,0
17084,ACGTCGAATCTAGGGA,285,288,3,27,16290,0,0
17085,ACGTCGAATCTAGGGA,285,286,1,22,16292,0,0
17086,ACGTCGAATCTAGGGA,285,285,0,21,16378,0,0
17087,ACGTCGAATCTAGGGA,285,288,3,20,16463,0,0
17088,ACGTCGAATCTAGGGA,285,288,3,23,16468,0,0
17089,ACGTCGAATCTAGGGA,285,288,3,24,16469,0,0
17090,ACGTCGAATCTAGGGA,285,288,3,21,16471,0,0
17091,ACGTCGAATCTAGGGA,285,288,3,22,16472,0,0
17092,ACGTCGAATCTAGGGT,285,288,3,20,16473,0,0
17093,ACGTCGAATCTAGGGA,285,288,3,20,16474,0,0
17094,ACGTCGAATCTAGGGA,285,288,3,26,16475,0,0
17095,ACGTCGAATCTAGGGA,285,288,3,25,16577,0,0
17096,TCGTCGAATCTAGGGC,285,288,3,24,16586,0,0
17097,ACGTCGAATCTAGGGA,285,288,3,22,16591,0,0
17098,ACGTCGAATCTAGGGA,285,288,3,23,16592,0,0
17099,ACGTCGAATCTAGGGT,285,288,3,21,16593,0,0
17100,ACGTCGACTCTAGGGA,285,288,3,22,16594,0,0
17101,ACGTCGGATCTAGGGA,285,288,3,24,16655,0,0
17102,TCGTCGAATCTAGGGA,285,286,1,23,16656,0,0
17103,TCGTCGAATCTAGGGA,285,288,3,23,16667,0,0
17104,ACGTCGAATCTAGGGA,285,287,2,26,16671,0,0
17105,ACGTCGAATCTAGGGA,285,288,3,22,16672,0,0
17106,ACGTCGAATCTAGGGA,285,285,0,23,16673,0,0
17107,ACGTCGAATCTAGGGA,285,288,3,18,16674,0,0
17108,ACATCAAATCTAGGGA,285,288,3,25,16676,0,0
17109,ACGTCGAATCTAGGGA,285,288,3,24,16679,0,0
17110,ACGTCGAATCTAGGGA,285,288,3,24,16685,0,0
17111,ACGTCGAATCTAGGGA,285,288,3,24,16686,0,0
17112,ACGTCGAATCTAGGGA,285,286,1,25,16687,0,0
17113,ACGTCGAATCGAGGGA,285,288,3,20,16688,0,0
17114,ACGTCGCATCTAGGGA,285,288,3,23,16690,0,0
17115,ACGTCGAATCTAGGGA,285,288,3,25,16691,0,0
17116,ACGTCGAATCTAGGGA,285,288,3,29,16694,0,0
17117,ACGTTGAATCTAGGGA,285,288,3,26,16697,0,0
17118,ACGTCGAATCTAGGGA,285,288,3,22,16703,0,0
17119,ACGTCGAATCTAGGGA,285,287,2,25,16704,0,0
17120,ACGTCGAATCTAGGGA,286,294,8,27,14079,1,0
17121,ACGTCGAATCTAGGGA,286,291,5,16,14225,0,0
17122,ACGTCGAATCGAGGGA,286,305,19,18,15502,4,0
17123,ACGTCGAATCTAGGGA,286,287,1,22,15503,0,0
17124,ACGTCGAATCTAGGGA,286,309,23,24,15513,6,0
17125,ACGTCGAATCTAGGGA,286,286,0,24,15682,0,0
17126,ACGTCGAATCGAGGGA,286,291,5,22,15999,0,0
17127,ACGTCGAATCTAGGGA,286,295,9,24,16003,1,0
17128,ACGGCGAATCTAGGGA,286,301,15,24,16004,3,0
17129,ACGTCGATTCTGGGGA,286,319,33,20,16008,9,0
17130,ACGTCGAATCTAGGGA,286,296,10,23,16011,1,0
17131,ACGTCGAATCTAGGGA,286,297,11,17,16026,2,0
17132,ACGTCGAATCTAGGGA,286,291,5,27,16034,0,0
17133,ACGTCGAATCTAGGGA,286,291,5,25,16035,0,0
17134,ACGTCGAATCTAGGGA,286,290,4,20,16041,0,0
17135,ACGTCGAATCTAGGGA,286,292,6,26,16043,0,0
17136,ACGTCGAATCTAGGGA,286,300,14,21,16159,3,0
17137,TCGTCGAATCTAGGGA,286,290,4,23,16166,0,0
17138,ACGTCGAATCTAGGGA,286,294,8,24,16168,1,0
17139,TCGTCGAATCTAGGGA,286,295,9,19,16170,1,0
17140,ACGTCGAATCTAGGGA,286,310,24,23,16180,6,0
17141,ACGTCGAATCTAGGGA,286,288,2,22,16181,0,0
17142,ACGTCGAATCTAGGGA,286,296,10,25,16184,1,0
17143,ACGTCGAATCGAGGGA,286,303,17,22,16336,4,0
17144,ACGTCGAATCTAGGGA,286,298,12,24,16340,2,0
17145,ACGTCGAAAGTAGGGA,286,311,25,21,16349,6,0
17146,ACGTCGAATCTAGGGA,286,302,16,24,16449,3,0
17147,ACGTCGAATCTAGGGA,286,286,0,22,16452,0,0
17148,ACGTCGACTCTAGGGA,286,286,0,21,16476,0,0
17149,ACGTCGAATCGAGGGA,286,289,3,22,16526,0,0
17150,ACGTCGAATCTAGGGA,286,287,1,21,16527,0,0
17151,ACGTCGAATCTAGGGA,286,296,10,24,16528,1,0
17152,ACGTCGAATCTAGGGA,286,294,8,23,16532,1,0
17153,ACGTCGAATCTAGGGA,286,297,11,23,16534,2,0
17154,ACGTCGAAAGTAGGGA,286,291,5,21,16537,0,0
17155,ACGTCGAATCTAGGGA,286,291,5,25,16542,0,0
17156,ACGTCGAATCTAGGGA,286,290,4,25,16553,0,0
17157,AAGTCGAATCTAGGGA,286,309,23,26,16558,6,0
17158,ACGTCGAATCTAGGGA,286,301,15,20,16561,3,0
17159,ACGTCGAATCTAGGGA,286,304,18,22,16563,4,0
17160,ACGTCGAATCTAGGGA,286,293,7,28,16565,0,0
17161,ACGTCGAATCTAGGGA,286,287,1,25,16570,0,0
17162,ACGTCGAATCTAGGGA,286,301,15,21,16573,2,0
17163,ACGTTGAATCTAGGGA,286,304,18,26,16574,3,0
17164,ACGTCGAATCTAGGGA,286,304,18,19,16712,3,0
17165,ACGTCGAAAGTAGGGA,286,299,13,21,16713,2,0
17166,ACGTCGAATCTAGGGA,286,286,0,24,16714,0,0
17167,ACGTCGAATGTAGGGA,286,314,28,20,16715,7,0
17168,ACGTCGAATCTAGGGA,286,286,0,23,16718,0,0
17169,ACGTCGAATCTAGGGA,286,297,11,26,16721,1,0
17170,TCGTCGAATCTAGGGA,286,291,5,24,16724,0,0
17171,ACGTCGCATCTAGGGA,286,286,0,20,16725,0,0
17172,ACGTCGAATCTAGGGA,286,316,30,21,16727,7,0
17173,ACGTCGAATCTAGGGA,286,287,1,24,16729,0,0
17174,ACGTCGAATCGAGGGA,286,294,8,25,16730,0,0
17175,ACGTCGAATCTAGGGA,286,290,4,20,16731,0,0
17176,ACGTCGACTCTAGGGA,286,294,8,22,16732,0,0
17177,ACGTCGGATCTAGGGA,287,296,9,23,14752,1,0
17178,ACGTCGAATCTAGGGA,287,312,25,22,14845,6,0
17179,TCGTCGAATCTATTGA,287,294,7,23,14858,0,0
17180,ACGTCGAATCTAGGGA,287,302,15,19,15184,3,0
17181,ACGTCGAATCTAGGGA,287,287,0,20,15272,0,0
17182,ACGTCGAATCTAGGGA,287,302,15,18,15379,3,0
17183,ACGTCGAATCTAGGGA,287,300,13,23,15542,2,0
17184,ACGTCGAATCTAGGGA,287,294,7,16,15662,0,0
17185,ACGTCGAATCTAGGGA,287,287,0,25,15719,0,0
17186,ACGTCGAATCTAGGGA,287,320,33,23,16068,9,0
17187,ACGTCGAATCTAGGGA,287,296,9,21,16071,1,0
17188,ACGTCGAATCTAGGGA,287,288,1,23,16073,0,0
17189,ACGTCGAATCGAGGGA,287,291,4,19,16077,0,0
17190,ACGTCGAATCTAGGGA,287,287,0,18,16087,0,0
17191,ACGTCGAATCTAGGGA,287,288,1,23,16235,0,0
17192,ACGTCGAATCTAGGGA,287,290,3,17,16249,0,0
17193,ACGTCGAATCTAGGGA,287,290,3,24,16253,0,0
17194,ACGTCGAATCTAGGGA,287,288,1,26,16254,0,0
17195,ACGTCGAATCGAGGGA,287,290,3,23,16422,0,0
17196,ACGTCGAATCTAGGGA,287,290,3,24,16426,0,0
17197,ACGTCGAATCTAGGGA,287,290,3,23,16428,0,0
17198,ACGTCGAATCTAGGGA,287,290,3,25,16430,0,0
17199,ACGTCGAATCTAGGGA,287,290,3,22,16431,0,0
17200,ACGTCGAATGTAGGGA,287,287,0,22,16432,0,0
17201,ACGTCGAATCTAGGGA,287,289,2,18,16433,0,0
17202,ACGTCGAATCGAGGGA,287,290,3,23,16444,0,0
17203,ACGTCGAATCTAGGGA,287,287,0,28,16596,0,0
17204,ACGTTGAATCTAGGGA,287,288,1,25,16599,0,0
17205,ACGTCGAATCTAGGGA,287,290,3,21,16706,0,0
17206,ACGTCGAATCTAGGGA,287,290,3,24,16707,0,0
17207,ACGTCGAATCGAGGGA,287,290,3,18,16708,0,0
17208,ACGTCGAATCTAGGGA,287,290,3,24,16767,0,0
17209,ACGTCGAATCTTGGGA,287,290,3,17,16768,0,0
17210,ACGTCGAATCTAGGGA,287,290,3,27,16771,0,0
17211,ACGTCGAATCTAGGGA,287,289,2,23,16775,0,0
17212,ACGTCGAATCTAGGGA,287,287,0,22,16780,0,0
17213,ACGTCGAATCTAGGGA,287,290,3,24,16781,0,0
17214,ACGTCGAATCTAGGGA,287,290,3,25,16783,0,0
17215,ACGTCGAATCTAGGGA,287,290,3,20,16788,0,0
17216,ACGTCGAATCTAGGGA,287,290,3,26,16791,0,0
17217,ACGTCGAATCTAGGGA,287,288,1,21,16792,0,0
17218,ACGTCGAATCGAGGGA,287,290,3,23,16794,0,0
17219,ACGTCGAATCTAGGGA,287,290,3,22,16795,0,0
17220,ACGTCGAATCTAGGGA,287,290,3,20,16799,0,0
17221,ACGTCGAATCTAGGGA,287,288,1,18,16800,0,0
17222,ACGTCGAATCTAGGGA,287,290,3,23,16803,0,0
17223,ACGTCGAATCTAGGGA,287,287,0,26,16804,0,0
17224,ACGTCGAATCGAGGGA,287,290,3,27,16805,0,0
17225,ACGTCGAATCTAGGGA,287,290,3,19,16807,0,0
17226,TCGTCGAATCTAGGGA,287,290,3,24,16809,0,0
17227,ACGTCGAATCTAGGGA,287,290,3,25,16811,0,0
17228,ACGTCGAATGTAGGGA,287,288,1,21,16814,0,0
17229,TCGTCGAATCTAGGGA,287,290,3,24,16815,0,0
17230,ACGTCGAATCTAGGGA,287,287,0,20,16816,0,0
17231,ACGTCGAAAGTAGGGA,287,290,3,22,16817,0,0
17232,ACGTCGAATCTAGGGA,287,288,1,25,16818,0,0
17233,ACGTCGAATCTAGGGA,288,293,5,20,13656,0,0
17234,TCGTCGAATCTAGGGA,288,289,1,22,15080,0,0
17235,ACGTCGAATCTAGGGA,288,288,0,18,15102,0,0
17236,ACGTCGAAAGTAGGGA,288,293,5,20,15251,0,0
17237,ACGTCGAATCTAGGGA,288,288,0,23,15265,0,0
17238,ACGTCGAATCTAGGGA,288,310,22,27,15648,5,0
17239,ACGTCGAATCTAGGGA,288,289,1,25,15656,0,0
17240,TCGTCGAATCTAGAGA,288,288,0,23,15786,0,0
17241,ACGTCGAATCTAGGGA,288,288,0,26,15798,0,0
17242,ACGTCGACTCTAGGGA,288,291,3,23,15802,0,0
17243,ACGTCGACTCTAGGGA,288,306,18,21,15805,4,0
17244,ACGTCGAATCTAGGGA,288,293,5,21,15809,0,0
17245,TCGTCGAATCTATCGA,288,293,5,23,16048,0,0
17246,ACGTCGAATCTAGGGA,288,341,53,20,16054,16,0
17247,ACGTCGAATCTAGGGA,288,288,0,26,16058,0,0
17248,ACGTCGAATCTAGGGA,288,291,3,27,16062,0,0
17249,ACGTCGAATCTAGGGA,288,316,28,24,16064,7,0
17250,ACGTCGAATGTAGGGA,288,299,11,22,16065,2,0
17251,ACGTCGAATCTAGGGA,288,290,2,18,16106,0,0
17252,ACGTCGAATCTAGGGA,288,290,2,24,16107,0,0
17253,TCGTCGAATCTAGGGA,288,289,1,23,16109,0,0
17254,ACGTCGACTCTAGGGA,288,292,4,21,16287,0,0
17255,ACGTCGAATCTAGGGA,288,344,56,27,16290,17,0
17256,ACGTCGAATCTAGGGA,288,305,17,22,16292,4,0
17257,ACGTCGAATCTAGGGA,288,301,13,20,16463,2,0
17258,ACGTCGAATGTAGGGA,288,290,2,23,16468,0,0
17259,ACGTCGAATCTAGGGA,288,302,14,22,16472,3,0
17260,ACGTCGAATCTAGGGT,288,302,14,20,16473,3,0
17261,ACGTCGAATCTAGGGA,288,292,4,20,16474,0,0
17262,ACGTCGAATCTAGGGA,288,298,10,26,16475,1,0
17263,ACGTCGAATCTAGGGA,288,290,2,25,16577,0,0
17264,TCGTCGAATCTAGGGA,288,289,1,24,16586,0,0
17265,ACGTCGAATCTAGGGA,288,291,3,22,16591,0,0
17266,ACGTCGAATCTAGGGA,288,293,5,23,16592,0,0
17267,ACGTCGAATCTAGGGT,288,299,11,21,16593,2,0
17268,ACGTCGACTCTAGGGA,288,289,1,22,16594,0,0
17269,ACGTCGGATCTAGGGA,288,289,1,24,16655,0,0
17270,TCGTCGAATCTAGGGA,288,301,13,23,16656,2,0
17271,TCGTCGAATCTAGGGA,288,300,12,23,16667,2,0
17272,ACGTCGAATCTAGGGA,288,289,1,26,16671,0,0
17273,ACGTCGAATCTAGGGA,288,300,12,22,16672,2,0
17274,ACGTCGAATCTAGGGA,288,330,42,23,16673,12,0
17275,ACATCGAATCTAGGGA,288,321,33,25,16676,9,0
17276,ACGTCGAATCTAGGGA,288,292,4,24,16679,0,0
17277,ACGTCGAATCTAGGGA,288,290,2,24,16685,0,0
17278,ACGTCGAATCTAGGGA,288,300,12,24,16686,2,0
17279,ACGTCGAATCTAGGGA,288,292,4,25,16687,0,0
17280,ACGTCGAATCGAGGGA,288,289,1,20,16688,0,0
17281,ACGTTGAATCTAGGGA,288,289,1,26,16697,0,0
17282,ACGTCGAATCTAGGGA,288,292,4,22,16703,0,0
17283,ACGTCGAATCTAGGGA,288,288,0,25,16704,0,0
17284,ACGTCGGATCTAGGGA,288,294,6,24,16831,0,0
17285,ACGTCGAATCTAGGGA,288,289,1,23,16833,0,0
17286,ACGTCGAATCTAGGGA,288,297,9,21,16839,1,0
17287,ACGTCGAATCTAGGGA,288,292,4,19,16841,0,0
17288,TCGTCGAATCTAGGGA,288,290,2,23,16842,0,0
17289,ACGTCGAATCTAGGGA,288,293,5,24,16843,0,0
17290,ACGTCGAATCTAGGGA,288,291,3,22,16847,0,0
17291,ACGTCGAATCTAGGGA,289,305,16,27,14079,3,0
17292,ACGTCGAATCGAGGGA,289,291,2,18,15502,0,0
17293,ACGTCGAATCTAGGGA,289,292,3,24,15682,0,0
17294,ACGTCGAATCGAGGGA,289,291,2,22,15999,0,0
17295,ACGTCGAATCTAGGGA,289,290,1,24,16004,0,0
17296,ACGTCGATTCTGGGGA,289,291,2,20,16008,0,0
17297,ACGTCGAATCTAGGGA,289,292,3,23,16011,0,0
17298,ACGTCGAATCTAGGGA,289,292,3,17,16026,0,0
17299,ACGTCGAATCTAGGGA,289,292,3,27,16034,0,0
17300,ACGTCGAATCTAGGGA,289,292,3,25,16035,0,0
17301,ACGTCGAATCTAGGGA,289,292,3,20,16041,0,0
17302,ACGTCGAATCTAGGGA,289,292,3,26,16043,0,0
17303,ACGTCGAATCTAGGGA,289,289,0,21,16159,0,0
17304,TCGTCGAATCTAGGGA,289,292,3,23,16166,0,0
17305,ACGTCGAATCTAGGGA,289,292,3,19,16170,0,0
17306,ACGTCGAATCTAGGGA,289,292,3,23,16180,0,0
17307,ACGTCGAATCGAGGGA,289,292,3,22,16336,0,0
17308,ACGTCGAATCTAGGGA,289,292,3,24,16449,0,0
17309,ACGTCGAATCTAGGGA,289,292,3,22,16452,0,0
17310,ACGTCGAATCGAGGGA,289,292,3,22,16526,0,0
17311,ACGTCGAATCTAGGGA,289,290,1,21,16527,0,0
17312,ACGTCGAATCTAGGGA,289,292,3,24,16528,0,0
17313,ACGTCGAATCTAGGGA,289,292,3,23,16532,0,0
17314,ACGTCGAATCTAGGGA,289,291,2,23,16534,0,0
17315,ACGTCGAAAGTAGGGA,289,292,3,21,16537,0,0
17316,ACGTCGAATCTAGGGA,289,292,3,25,16553,0,0
17317,ACGTCGAATCAAGGGA,289,292,3,20,16561,0,0
17318,ACGTCGAATCTAGGGA,289,289,0,22,16563,0,0
17319,ACGTCGAATCTAGGGA,289,292,3,21,16573,0,0
17320,ACGTTGAATCTAGGGA,289,292,3,26,16574,0,0
17321,ACGTCGAATCTAGGGA,289,292,3,19,16712,0,0
17322,ACGTCGAATCTAGGGA,289,292,3,24,16714,0,0
17323,ACGTCGAATGTAGGGA,289,291,2,20,16715,0,0
17324,ACGTCGAATCTAGGGA,289,292,3,23,16718,0,0
17325,ACGTCGAATCTAGGGA,289,292,3,26,16721,0,0
17326,TCGTCGAATCTAGGGA,289,292,3,24,16724,0,0
17327,ACGTCGAATCTAGGGA,289,290,1,20,16725,0,0
17328,ACGTCGAATCTACGGA,289,292,3,24,16729,0,0
17329,ACGTCGAATCGAGGGA,289,290,1,25,16730,0,0
17330,ACGTCGAATCTAGGGA,289,292,3,20,16731,0,0
17331,ACGTCGACTCTAGGGA,289,292,3,22,16732,0,0
17332,ACGTCGAATCTAGGGA,289,290,1,19,16890,0,0
17333,ACGTCGAATCTAGGGA,289,292,3,28,16896,0,0
17334,ACGTCGAATCTAGGGT,289,292,3,26,16897,0,0
17335,ACGTCGAATCTAGGGA,289,292,3,22,16898,0,0
17336,ACGTCGAATCTAGGGA,289,292,3,21,16899,0,0
17337,TCGTCGAATCTAGGGA,289,291,2,24,16900,0,0
17338,ACGTCGAATCTAGGGA,289,292,3,27,16902,0,0
17339,ACGTCGAATCTAGGGA,289,290,1,24,16903,0,0
17340,ACGTCGAATCTAGGGA,289,292,3,22,16905,0,0
17341,ACGTCGAATCTAGGGA,289,292,3,27,16906,0,0
17342,ACGTCGAATCTAGGGA,289,292,3,26,16907,0,0
17343,ACGTCGAATCTAGGGA,289,289,0,21,16909,0,0
17344,ACGTCGAATCTAGGGA,289,292,3,28,16914,0,0
17345,ACGTCGAATCTAGGGA,289,291,2,26,16915,0,0
17346,ACGTCGAATGTAGGGA,289,292,3,23,16917,0,0
17347,ACGTCGAATCTAGGGA,289,292,3,19,16918,0,0
17348,ACGTCGAATCTAGGGT,289,290,1,21,16922,0,0
17349,ACGTCGATTCTGGGGA,289,289,0,21,16923,0,0
17350,TCGTCGAATCTAGGGA,289,292,3,24,16924,0,0
17351,ACGTCGAATCTAGGGA,289,292,3,22,16927,0,0
17352,ACGTCGAATCTAGGGA,289,290,1,25,16931,0,0
17353,ACGTCGATTCTGGGGA,289,289,0,20,16934,0,0
17354,ACGTCGAATCTAGGGA,289,292,3,24,16935,0,0
17355,ACGTCGGATCTAGGGA,290,295,5,23,14752,0,0
17356,TCGTCGAATCTATTGA,290,300,10,23,14858,1,0
17357,ACGTCGAATCTAGGGA,290,318,28,19,15184,7,0
17358,ACGTCGAATCTAGGGA,290,294,4,20,15272,0,0
17359,ACGTCGAATCTAGGGA,290,294,4,18,15379,0,0
17360,ACGTCGAATCTAGGGA,290,297,7,23,15542,0,0
17361,ACGTCGAATCTAGGGA,290,327,37,25,15719,10,0
17362,ACGTCGAATCTAGGGA,290,290,0,23,16073,0,0
17363,ACGTCGAATCGAGGGA,290,311,21,19,16077,5,0
17364,ACGTCGAATCTAGGGA,290,295,5,18,16087,0,0
17365,ACGTCGAATCTAGGGA,290,290,0,17,16249,0,0
17366,ACGTCGAATCTAGGGA,290,297,7,24,16253,0,0
17367,ACGTCGAATCTAGGGA,290,293,3,26,16254,0,0
17368,ACGTCGAGTCGAGGGA,290,293,3,23,16422,0,0
17369,ACGTCGAATCTAGGGA,290,295,5,24,16426,0,0
17370,ACGTCGAATCTAGGGA,290,296,6,23,16428,0,0
17371,ACGTCGAATCTAGGGA,290,292,2,25,16430,0,0
17372,ACGTCGAATCTAGGGA,290,293,3,22,16431,0,0
17373,ACGTCGAATGTAGGGA,290,306,16,22,16432,3,0
17374,ACGTCGAATCTAGGGA,290,297,7,18,16433,0,0
17375,ACGTCGAATCGAGGGA,290,293,3,23,16444,0,0
17376,ACGTTGAATCTAGGGA,290,309,19,25,16599,4,0
17377,ACGTCGAATCTAGGGA,290,291,1,21,16706,0,0
17378,ACGTCGAATCTAGGGA,290,311,21,24,16707,5,0
17379,ACGTCGAATCGAGGGA,290,291,1,18,16708,0,0
17380,ACGTCGAATCTAGGGA,290,294,4,24,16767,0,0
17381,ACGTCGAATCTTGGGA,290,292,2,17,16768,0,0
17382,ACGTCGAATCTAGGGA,290,295,5,27,16771,0,0
17383,ACGTCGAATCTAGGGA,290,327,37,23,16775,10,0
17384,ACGTCGAATCTAGGGA,290,304,14,22,16780,3,0
17385,ACGTCGAATCTAGGGA,290,295,5,24,16781,0,0
17386,ACGTCGAATCTAGGGA,290,290,0,20,16788,0,0
17387,ACGTCGAATCTAGGGA,290,307,17,26,16791,4,0
17388,ACGTCGAATCGAGGGA,290,304,14,23,16794,3,0
17389,ACGTCGAATCTAGGGA,290,313,23,20,16799,6,0
17390,ACGTCGAATCTAGGGA,290,307,17,18,16800,4,0
17391,ACGTCGAATCTAGGGA,290,291,1,23,16803,0,0
17392,ACGTCGAATCTAGGGA,290,303,13,27,16805,2,0
17393,ACGTCGAATCTAGGGA,290,295,5,19,16807,0,0
17394,TCGTCGAATCTAGGGA,290,297,7,24,16809,0,0
17395,ACGTCGAATCTAGGGA,290,294,4,25,16811,0,0
17396,ACGTCGAATGTAGGGA,290,305,15,21,16814,3,0
17397,TCGTCGAATCTAGGGA,290,294,4,24,16815,0,0
17398,ACGTCGAAAGTAGGGA,290,308,18,22,16817,4,0
17399,ACGTCGAATCTAGGGA,290,295,5,25,16818,0,0
17400,ACGTCGAATCAAGGGA,290,290,0,28,16942,0,0
17401,ACGTCGAATCTAGGGA,290,294,4,24,16943,0,0
17402,ACGTCGAATCTAGGGA,290,291,1,17,16944,0,0
17403,ACGTCGAATCTAGGGA,290,298,8,24,16946,1,0
17404,ACGTCGAATCGAGGGA,290,313,23,19,16948,6,0
17405,ACGTCGAATCTAGGGA,290,294,4,25,16950,0,0
17406,ACGTCGAATCTAGGGA,290,314,24,25,16953,6,0
17407,TCGTCGAATCTAGGGA,290,290,0,23,17052,0,0
17408,ACGTCGAGTCTAGGGA,290,297,7,26,17053,0,0
17409,ACGTCGAATCTAGGGA,290,323,33,19,17054,9,0
17410,ACGTCGAAAGTAGGGA,290,308,18,21,17055,4,0
17411,ACGTCGAATGTAGGGA,290,321,31,20,17057,8,0
17412,ATGTCGAATCTAGGGA,290,296,6,28,17058,0,0
17413,ACGTCGAATCTAGGGA,291,291,0,20,13656,0,0
17414,TCGTCGAATCTAGGGA,291,293,2,22,15080,0,0
17415,ACGTCGAATCTAGGGA,291,296,5,18,15102,0,0
17416,ACGTCGAAAGTAGGGA,291,294,3,20,15251,0,0
17417,ACGTCGAATCTAGGGA,291,297,6,23,15265,1,0
17418,ACGTCGAATCTAGGGA,291,293,2,27,15648,0,0
17419,ACGTCGAATCTAGGGA,291,291,0,25,15656,0,0
17420,TCGTCGAATCTAGGGA,291,293,2,23,15786,0,0
17421,ACGTCGAATCTAGGGA,291,305,14,26,15798,3,0
17422,ACGTCGACTCTAGGGA,291,292,1,21,15805,0,0
17423,TCGTCGAATCTATTGA,291,307,16,23,16048,4,0
17424,ACGTCGAATCTAGGGA,291,297,6,20,16054,1,0
17425,ACGTCGAATCTAGGGA,291,291,0,26,16058,0,0
17426,ACGTCGAATGTAGGGA,291,293,2,22,16065,0,0
17427,ACGTCGAATCTAGGGA,291,298,7,24,16107,1,0
17428,TCGTCGAATCTAGGGA,291,300,9,23,16109,2,0
17429,ACGTCGACTCTAGGGA,291,297,6,21,16287,0,0
17430,ACGCCGAATCTAGGGA,291,306,15,22,16292,3,0
17431,ACGTCGAATCTAGGGA,291,303,12,23,16468,2,0
17432,ACGTCGAATCTAGGGA,291,295,4,22,16472,0,0
17433,ACGTCGAATCTAGGGT,291,292,1,20,16473,0,0
17434,ACGTCGAATCTAGGGA,291,302,11,20,16474,2,0
17435,ACGTCGAATCTAGGGA,291,291,0,25,16577,0,0
17436,TCGTCGCATCTAGGGA,291,292,1,24,16586,0,0
17437,ACGTCGAATCTAGGGA,291,309,18,22,16591,4,0
17438,ACGTCGAATCTAGGGA,291,304,13,23,16592,2,0
17439,ACGTCGAATCTAGGGT,291,304,13,21,16593,2,0
17440,ACGTCGACTCTAGGGA,291,308,17,22,16594,4,0
17441,TCGTCGAATCTAGGGA,291,296,5,23,16667,0,0
17442,ACGTCGAATCTAGGGA,291,292,1,26,16671,0,0
17443,ACGTCGAATCTAGGGA,291,301,10,23,16673,1,0
17444,ACATCGAATCTAGGGA,291,314,23,25,16676,6,0
17445,ACGTCGAATCTAGGGA,291,291,0,24,16679,0,0
17446,ACGTCGAATCTAGGGA,291,300,9,24,16686,1,0
17447,ACGTCGAATCTAGGGA,291,296,5,25,16687,0,0
17448,ACGTCGAATCGAGGGA,291,297,6,20,16688,0,0
17449,ACGTTGAATCTAGGGA,291,313,22,26,16697,5,0
17450,ACGTCGAATCTAGGGA,291,293,2,22,16703,0,0
17451,ACGTCGAATCTAGGGA,291,337,46,25,16704,13,0
17452,ACGTCGGATCTAGGGA,291,296,5,24,16831,0,0
17453,ACGTCGAATCTAGGGA,291,295,4,23,16833,0,0
17454,ACGTCGAATCTAGGGA,291,309,18,21,16839,4,0
17455,ACGTCGAATCTAGGGA,291,292,1,19,16841,0,0
17456,TCGTCGAATCTAGGGA,291,294,3,23,16842,0,0
17457,ACGTCGGATCTAGGGA,291,298,7,24,16843,0,0
17458,ACGTCGAATCTAGGGA,291,294,3,23,16938,0,0
17459,ACGTCGAATCTAGGGA,291,300,9,21,16940,1,0
17460,ACGTCGAATCTAGGGA,291,292,1,27,16941,0,0
17461,TCGTCGAATCTAGGGA,291,291,0,24,16956,0,0
17462,ACGTCGAATCTAGGGA,291,320,29,20,17004,8,0
17463,ACGTCGAATCTAGGGA,291,295,4,24,17008,0,0
17464,ACGTCGACTCTAGGGA,291,298,7,21,17012,0,0
17465,ACGTCGAATCTAGGGA,291,294,3,19,17015,0,0
17466,TCGTCGAATCTAGGGA,291,293,2,23,17016,0,0
17467,ACGTAGAATCTAGGGA,291,294,3,26,17019,0,0
17468,ACGTCGAATCTAGGGA,291,292,1,20,17020,0,0
17469,ACGTCGAATCTAGGGA,291,294,3,24,17022,0,0
17470,ACGTCGAATCGAGGGA,291,294,3,20,17026,0,0
17471,ACGTCGAATCTAGGGA,291,293,2,24,17030,0,0
17472,ACGTCGAATCTAGGGA,291,294,3,18,17032,0,0
17473,ACGTCGAATCTAGGGA,291,294,3,22,17033,0,0
17474,ACGTCGAATCGAGGGA,291,294,3,24,17037,0,0
17475,ACGTCGAATCTAGGGA,291,294,3,24,17039,0,0
17476,ACGTCGAATCTAGGGA,291,294,3,23,17041,0,0
17477,ACGTCGAATCTAGGGA,292,292,0,27,14079,0,0
17478,ACGTCGAATCGAGGGA,292,297,5,22,15999,0,0
17479,ACGTCGAATCTAGGGA,292,296,4,24,16004,0,0
17480,ACGTCGAATCTAGGGA,292,292,0,17,16026,0,0
17481,ACGTCGAATCTAGGGA,292,293,1,27,16034,0,0
17482,ACGTCGGATCTAGGGA,292,302,10,20,16041,1,0
17483,ACGTCGAATCTAGGGA,292,305,13,26,16043,2,0
17484,ACGTCGAATCTAGGGA,292,302,10,21,16159,1,0
17485,ACGTCGAATCTAGGGA,292,297,5,19,16170,0,0
17486,ACGTCGAATCTAGGGA,292,300,8,23,16180,1,0
17487,ACGTCGAATCGAGGGA,292,300,8,22,16336,1,0
17488,ACGTCGAATCTAGGGA,292,293,1,22,16452,0,0
17489,ACGTCGAATCTAGGGA,292,305,13,21,16527,2,0
17490,ACGTCGAATCTAGGGA,292,295,3,24,16528,0,0
17491,ACGTCGAATCTAGGGA,292,308,16,23,16532,3,0
17492,ACGTCGAATCTAGGGA,292,297,5,25,16553,0,0
17493,ACGTCGAATCTAGGGA,292,292,0,20,16561,0,0
17494,ACGTCGAATCTAGGGA,292,295,3,22,16563,0,0
17495,ACGTCGAATCTAGGGA,292,315,23,21,16573,6,0
17496,ACGTTGAATCTAGGGA,292,292,0,26,16574,0,0
17497,ACGTCGAATCTAGGGA,292,302,10,19,16712,1,0
17498,ACGTCGAATCTAGGGA,292,325,33,24,16714,9,0
17499,ACGTCGAATGTAGGGA,292,293,1,20,16715,0,0
17500,ACGTCGAATCTAGGGA,292,306,14,23,16718,3,0
17501,ACGTCGAATCTAGGGA,292,314,22,26,16721,5,0
17502,ACGTCGAATCTAGGGA,292,295,3,20,16725,0,0
17503,ACGTCGAATCTAGGGA,292,292,0,24,16729,0,0
17504,ACGTCGAATCGAGGGA,292,292,0,25,16730,0,0
17505,ACGTCGAATCTAGGGA,292,295,3,20,16731,0,0
17506,ACGTCGACTCTAGGGA,292,295,3,22,16732,0,0
17507,ACGTCGAATCTAGGGA,292,295,3,19,16890,0,0
17508,ACGTCGAATCTAGGGA,292,295,3,21,16899,0,0
17509,TCGTCGAATCTAGGGA,292,293,1,24,16900,0,0
17510,ACGTCGAATCTAGGGA,292,295,3,27,16902,0,0
17511,ACGTCGAATCTAGGGA,292,292,0,24,16903,0,0
17512,ACGTCGAATCTAGGGA,292,295,3,22,16905,0,0
17513,ACGTCGAATCTAGGGA,292,292,0,27,16906,0,0
17514,ACGTCGAATCTAGTGA,292,295,3,26,16907,0,0
17515,ACGTCGAATCTAGGGA,292,293,1,21,16909,0,0
17516,ACGTCGAATCTAGGGA,292,295,3,19,16918,0,0
17517,ACGTCGATTCTGGGGA,292,295,3,21,16923,0,0
17518,TCGTCGAATCTAGGGA,292,295,3,24,16924,0,0
17519,ACGTCGAATCTAGGGA,292,295,3,22,16927,0,0
17520,ACGTCGATTCTGGGGA,292,293,1,20,16934,0,0
17521,ACGTCGAATCTAGGGA,292,295,3,24,16935,0,0
17522,ACGTCGAATCTAGGGA,292,295,3,27,17067,0,0
17523,ACGTTGAATCTAGGGA,292,295,3,26,17071,0,0
17524,ACGTCGAATCTAGGGA,292,295,3,28,17074,0,0
17525,ACGTCGAATCTAGGGA,292,295,3,26,17075,0,0
17526,ACGTCGAATCTAGGTA,292,295,3,25,17076,0,0
17527,ACGTCGAATGTAGGGA,292,295,3,23,17077,0,0
17528,TCGTCGAATCTAGGGA,292,292,0,24,17080,0,0
17529,ACGTCGATTCTGGGGA,292,292,0,21,17081,0,0
17530,TCGTCGAATCTAGGGA,292,292,0,24,17082,0,0
17531,TCGTCGAATCTATTGA,293,306,13,23,14858,2,0
17532,ACGTCGAATCTAGGGA,293,293,0,19,15184,0,0
17533,ACGTCGAATCTAGGGA,293,293,0,20,15272,0,0
17534,ACGTCGAATCTAGGGA,293,295,2,18,15379,0,0
17535,ACGTCGAATCTAGGGA,293,294,1,25,15719,0,0
17536,ACGTCGAATCTAGGGA,293,294,1,23,16073,0,0
17537,ACGTCGAATCTAGGGA,293,323,30,17,16249,8,0
17538,ACGTCGAATCTAGGGA,293,294,1,24,16253,0,0
17539,ACGTCGAATCGAGGGA,293,306,13,23,16422,2,0
17540,ACGTCGAATCTAGGGA,293,307,14,24,16426,3,0
17541,ACGTCGAATCTAGGGA,293,296,3,25,16430,0,0
17542,ACGTCGAATGTAGGGA,293,297,4,22,16432,0,0
17543,ACGTCGAATCTAGGGA,293,311,18,18,16433,4,0
17544,ACGTCGAATCGAGGGA,293,303,10,23,16444,1,0
17545,ACGTTGAATCTAGGGA,293,295,2,25,16599,0,0
17546,ACGTCGAATCTAGGGA,293,293,0,24,16707,0,0
17547,ACGTCGAATCTAGGGA,293,301,8,24,16767,1,0
17548,ACGTCGAATCTTGGGA,293,356,63,17,16768,19,0
17549,ACGTCGAATCTAGGGA,293,297,4,27,16771,0,0
17550,ACGTCGAATCTAGGGA,293,331,38,22,16780,11,0
17551,ACGTCGAATCTAGGGA,293,299,6,24,16781,0,0
17552,ACGTCGAATCTAGGGA,293,293,0,20,16788,0,0
17553,ACGTCGAATCGAGGGA,293,295,2,23,16794,0,0
17554,ACGTCGAATCTAGGGA,293,340,47,18,16800,14,0
17555,ACGTCGAATCTAGGGA,293,302,9,23,16803,1,0
17556,TCGTCGAATCTAGGGA,293,301,8,24,16809,1,0
17557,ACGTCGAATCTAGGGA,293,296,3,25,16818,0,0
17558,ACGTCGAATCTAGGGA,293,306,13,28,16942,2,0
17559,ACGTCGAATCTAGGGA,293,293,0,24,16943,0,0
17560,ACGTCGAATCTAGGGA,293,313,20,17,16944,5,0
17561,ACGTCGAATCTAGGGA,293,295,2,24,16946,0,0
17562,ACGTCGAATCTAGGGA,293,306,13,25,16950,2,0
17563,ACGTCGAATCTAGGGA,293,300,7,25,16953,0,0
17564,ACGTCGAGTCTAGGGA,293,293,0,26,17053,0,0
17565,ACGTCGAATCTAGGGA,293,316,23,19,17054,6,0
17566,ACGTCGAAAGTATGGA,293,294,1,21,17055,0,0
17567,ATGTCGAATCTAGGGA,293,295,2,28,17058,0,0
17568,ACGTCGAATCTAGGGA,293,297,4,28,17120,0,0
17569,ACGTCGAATCGAGGGA,293,297,4,19,17122,0,0
17570,ACGTCGAATCTAGGGA,293,305,12,25,17124,2,0
17571,ACGTCGAATCTAGGGA,293,296,3,25,17127,0,0
17572,ACGGCGAATCTAGGGA,293,313,20,25,17128,5,0
17573,ACGTCGATTCTGGGGA,293,297,4,21,17129,0,0
17574,ACGTCGAATCTAGGGA,293,299,6,24,17130,0,0
17575,ACGTCGAATCTAGGGA,293,301,8,18,17131,1,0
17576,ACGTCGAATCTAGGGA,293,319,26,22,17136,7,0
17577,ACGTCGAATCTAGGGA,293,332,39,25,17138,11,0
17578,TCGTCGAATCTAGGGA,293,303,10,20,17139,1,0
17579,ACGTCGAATCTAGGGA,293,301,8,24,17140,1,0
17580,ACGTCGAATCTAGGGA,293,299,6,26,17142,0,0
17581,ACGTCGAATCGAGGGA,293,296,3,23,17143,0,0
17582,ACGTCGAATCTAGGGA,293,296,3,25,17144,0,0
17583,ACGTCGAAAGTAGGGA,293,295,2,22,17145,0,0
17584,ACGTCGAATCTAGGGA,293,296,3,25,17146,0,0
17585,ACGTCGAATCTAGGGA,293,294,1,25,17151,0,0
17586,AAGTCGAATCTAGGGA,293,296,3,24,17152,0,0
17587,ACGTCGAATCTAGGGA,293,294,1,24,17153,0,0
17588,AAGTCGAATCTAGGGA,293,296,3,27,17157,0,0
17589,ACGTCGAATCTAGGGA,293,296,3,21,17158,0,0
17590,ACGTCGAATCTAGGGA,293,296,3,23,17159,0,0
17591,ACGTCGAATCTAGGGA,294,298,4,18,15102,0,0
17592,ACGTCGAAAGTAGGGA,294,303,9,20,15251,1,0
17593,ACGTCGAATCTAGGGA,294,296,2,23,15265,0,0
17594,TCGTCGAATCTAGGGA,294,308,14,23,15786,3,0
17595,ACGTCGAATCTAGGGA,294,294,0,26,15798,0,0
17596,TCGTCGAATCTATTGA,294,300,6,23,16048,0,0
17597,ACGTCGAATCTAGGGA,294,294,0,20,16054,0,0
17598,ACGTCGAATCTAGGGA,294,295,1,26,16058,0,0
17599,ACGTCGACTCTAGGGA,294,295,1,21,16287,0,0
17600,ACGTCGAATCTAGGGA,294,299,5,22,16292,0,0
17601,ACGTCGAATCTAGGGA,294,294,0,23,16468,0,0
17602,ACGTCGAATCTAGGGA,294,294,0,22,16472,0,0
17603,ACGTCGAATCTAGGGT,294,358,64,20,16473,19,0
17604,ACGTCGAATCTAGGGA,294,300,6,20,16474,0,0
17605,ACGTCGAATCTAGGGA,294,296,2,25,16577,0,0
17606,ACGTCGAATCTAGGGA,294,311,17,22,16591,4,0
17607,ACGTCGAATCTAGGGA,294,306,12,23,16592,2,0
17608,ACGTCGAATCTAGGGT,294,305,11,21,16593,2,0
17609,ACGTCGACTCTAGGGA,294,295,1,22,16594,0,0
17610,TCGTCGAATCTAGGGA,294,310,16,23,16667,3,0
17611,ACATCGAATCTAGGGA,294,297,3,25,16676,0,0
17612,ACGTCGAATCTAGGGA,294,297,3,24,16679,0,0
17613,ACGTCGAATCTAGGGA,294,294,0,24,16686,0,0
17614,ACGTCGAATCTAGGGA,294,297,3,25,16687,0,0
17615,ACGTTGAATCTAGGGA,294,297,3,26,16697,0,0
17616,ACGTCGAATCTAGGGA,294,297,3,25,16704,0,0
17617,ACGTCGGATCTAGGGA,294,297,3,24,16831,0,0
17618,ACGTCGAATCTAGGGA,294,297,3,21,16839,0,0
17619,ACGTCGAATCTAGGGA,294,296,2,19,16841,0,0
17620,TCGTCGAATCTAGGGA,294,296,2,23,16842,0,0
17621,ACGTCGAATCTAGGGA,294,295,1,23,16938,0,0
17622,ACGTCGAATCTAGGGA,294,297,3,21,16940,0,0
17623,ACGTCGAATCTAGGGA,294,295,1,27,16941,0,0
17624,TCGTCGAATCTAGGGA,294,297,3,24,16956,0,0
17625,ACGTCGAATCTAGGGA,294,297,3,20,17004,0,0
17626,ACGTCGAATCTAGGGA,294,297,3,24,17008,0,0
17627,ACGTCGACTCTAGGGA,294,297,3,21,17012,0,0
17628,ACGTCGAATCTAGGGA,294,297,3,19,17015,0,0
17629,ACGTCGAATCTAGGGA,294,297,3,26,17019,0,0
17630,ACGTCGAATCTAGGGA,294,297,3,20,17020,0,0
17631,ACGTCGAATCTAGGGA,294,295,1,24,17022,0,0
17632,ACGTCGAATCGAGGGA,294,297,3,20,17026,0,0
17633,ACGTCGAATCTAGGGA,294,295,1,24,17030,0,0
17634,ACGTCGAATCTAGGGA,294,297,3,18,17032,0,0
17635,ACGTCGAATCTAGGGA,294,297,3,22,17033,0,0
17636,ACGTCGAATCTAGGGA,294,297,3,24,17039,0,0
17637,ACGTCGGATCTAGGGA,294,297,3,24,17177,0,0
17638,ACGTCGAATCTAGGGA,294,294,0,23,17178,0,0
17639,ACGTCGAATCTAGGTA,294,297,3,20,17180,0,0
17640,ACGTCGAATCTAGGGA,294,297,3,19,17182,0,0
17641,ACGTCGAATCTAGGGA,294,297,3,24,17183,0,0
17642,ACGTCGAATCTAGGGA,294,297,3,24,17186,0,0
17643,ACGTCGAATCTAGGGA,294,297,3,22,17187,0,0
17644,ACGTCGAATCGAGGGA,295,296,1,22,15999,0,0
17645,ACGTCGAATCTAGGGA,295,317,22,24,16004,5,0
17646,ACGTCGAATCTAGGGA,295,295,0,17,16026,0,0
17647,ACGTCGAATCTAGGGA,295,295,0,20,16041,0,0
17648,ACGTCGAATCTAGGGA,295,297,2,21,16159,0,0
17649,ACGTCGAATCTAGGGA,295,317,22,19,16170,5,0
17650,ACGTCGAATCTAGGGA,295,295,0,21,16527,0,0
17651,ACGTCGAATCTAGGGA,295,304,9,24,16528,1,0
17652,ACGTCGAATCTAGGGA,295,300,5,23,16532,0,0
17653,ACGTCGAATCTAGGGA,295,303,8,21,16573,1,0
17654,ACGTTGAATCTAGGGA,295,296,1,26,16574,0,0
17655,ACGTCGAATCTAGGGA,295,305,10,19,16712,1,0
17656,ACGTCGAATCTAGGGA,295,310,15,24,16714,3,0
17657,ACGTCGAATGTAGGGA,295,314,19,20,16715,4,0
17658,ACGTCGAATCTAGGGA,295,302,7,23,16718,0,0
17659,ACGTCGAATCTAGGGA,295,299,4,26,16721,0,0
17660,ACGTCGAATCGAGGGA,295,317,22,25,16730,5,0
17661,ACGTCGAATCTAGGGA,295,338,43,20,16731,12,0
17662,ACGTCGACTCTAGGGA,295,317,22,22,16732,5,0
17663,ACGTCGAATCTAGGGA,295,297,2,21,16899,0,0
17664,TCGTCGAATCTAGGGA,295,305,10,24,16900,1,0
17665,ACGTCGAATCTAGGGA,295,303,8,24,16903,1,0
17666,ACGTCGAATCTAGGGA,295,297,2,22,16905,0,0
17667,ACGTCGAATCTAGGGA,295,314,19,27,16906,4,0
17668,ACGTCGAATCTAGGGA,295,311,16,26,16907,3,0
17669,ACGTCGAATCTAGGGA,295,311,16,19,16918,3,0
17670,ACGTCGATTCTGGGGA,295,295,0,21,16923,0,0
17671,TCGTCGAATCTAGGGA,295,295,0,24,16924,0,0
17672,ACGTCGAATCTAGGGA,295,307,12,22,16927,2,0
17673,ACGTCGATTCTGGGGA,295,310,15,20,16934,3,0
17674,ACGTCGAATCTAGGGA,295,295,0,24,16935,0,0
17675,ACGTCGAATCTAGGGA,295,296,1,27,17067,0,0
17676,ACGTTGAATCTAGGGA,295,296,1,26,17071,0,0
17677,ACGTCGAATCTAGGGA,295,296,1,28,17074,0,0
17678,ACGTCGTATCTAGGGA,295,303,8,26,17075,1,0
17679,ACGTCGAATCTAGGGA,295,296,1,25,17076,0,0
17680,ACGTCGAATGTAGGGA,295,308,13,23,17077,2,0
17681,TCGTCGAATCTAGGGA,295,298,3,24,17080,0,0
17682,ACGTCGATTCTGGGGA,295,300,5,21,17081,0,0
17683,TCGTCGAATCTAGGGA,295,310,15,24,17082,3,0
17684,ACGTCGAATCTAGGGA,295,307,12,22,17162,2,0
17685,ACGTTGAATCTAGGGA,295,313,18,27,17163,4,0
17686,ACGTCGAATCTAGGGA,295,303,8,20,17164,1,0
17687,ACGTCGAAAGTAGGGA,295,301,6,22,17165,0,0
17688,ACGTCGAATGTAGGGA,295,303,8,21,17167,1,0
17689,ACGTCGAATCTAGGGA,295,302,7,27,17169,0,0
17690,ACGTCGAATCTAGGGA,295,298,3,22,17172,0,0
17691,ACGTCGAATCTAGGGA,295,301,6,28,17238,0,0
17692,ACGTCGACTCTAGGGA,295,295,0,22,17243,0,0
17693,ACGTCGAATCTAGGGA,295,305,10,21,17246,1,0
17694,ACGTCGAATCTAGGGA,295,326,31,25,17249,8,0
17695,ACGTCGAATGTAGGGA,295,296,1,23,17250,0,0
17696,ACGTCGAATCTAGGGA,295,299,4,28,17255,0,0
17697,ACGTCGAATCTAGGGA,295,315,20,23,17256,4,0
17698,ACGTCGAATCTAGGGA,295,298,3,21,17257,0,0
17699,ACGTCGAATCTAGGGA,295,362,67,23,17259,20,0
17700,ACGTCGAATCTAGGGT,295,302,7,21,17260,0,0
17701,ACGTCGAATCTAGGGA,295,300,5,27,17262,0,0
17702,ACGTCGAATCTAGGGT,295,299,4,22,17267,0,0
17703,TCGTCGAATCTAGGGA,295,297,2,24,17270,0,0
17704,TCGTCGAATCTAGGGA,295,304,9,24,17271,0,0
17705,ACGTCGAATCTAGGGA,295,295,0,23,17273,0,0
17706,ACGTCGAATCTAGGGA,295,323,28,24,17274,7,0
17707,ACATCGAATCTAGGGA,295,313,18,26,17275,3,0
17708,ACGTCGAATCTAGGGA,295,298,3,25,17278,0,0
17709,ACGTCGAATCTAGGGA,295,302,7,22,17286,0,0
17710,TCGTCGAATCTATTGA,296,307,11,23,14858,2,0
17711,ACGTCGAATCTAGGGA,296,299,3,19,15184,0,0
17712,ACGTCGAATCTAGGGA,296,298,2,18,15379,0,0
17713,ACGTCGAATCTAGGGA,296,299,3,25,15719,0,0
17714,ACGTCGAATCTAGGGA,296,296,0,23,16073,0,0
17715,ACGTCGAATCTAGGGA,296,299,3,17,16249,0,0
17716,ACGTCGAATCGAGGGA,296,299,3,23,16422,0,0
17717,ACGTCGAATCTAGGGA,296,299,3,24,16426,0,0
17718,ACGTCGAATCTAGGGA,296,299,3,25,16430,0,0
17719,ACGTCGAATGTAGGGA,296,299,3,22,16432,0,0
17720,ACGTCGAATCTAGGGA,296,299,3,18,16433,0,0
17721,ACGTCGAATCGAGGGA,296,298,2,23,16444,0,0
17722,ACGTTGAATCTAGGGA,296,299,3,25,16599,0,0
17723,ACGTCGAATCTAGGGA,296,298,2,24,16707,0,0
17724,ACGTCGAATCTAGGGA,296,299,3,24,16767,0,0
17725,ACGTCGAATCTTGGGA,296,299,3,17,16768,0,0
17726,ACGTCGAATCTAGGGA,296,299,3,27,16771,0,0
17727,ACGTCGAATCTAGGGA,296,299,3,22,16780,0,0
17728,ACGTCGAATCTAGGGA,296,299,3,24,16781,0,0
17729,AGGTCGAATCTAGGGA,296,299,3,23,16803,0,0
17730,ACGTCGAATCTAGGGA,296,299,3,25,16818,0,0
17731,ACGTCGAATCTAGGGA,296,299,3,28,16942,0,0
17732,ACGTCGAATCTAGGGA,296,296,0,17,16944,0,0
17733,ACGTCGAATCTAGGGA,296,296,0,24,16946,0,0
17734,ACGTCGAATCTAGGGA,296,299,3,25,16950,0,0
17735,ACGTCGAATATAGGGA,296,297,1,25,16953,0,0
17736,ACGTCGAGTCTAGGGA,296,299,3,26,17053,0,0
17737,ACGTCGAATCTATGGA,296,299,3,19,17054,0,0
17738,ACGTCGAAAGTAGGGA,296,299,3,21,17055,0,0
17739,ATGTCGAATCTAGGGA,296,299,3,28,17058,0,0
17740,ACGTCGAATCGAGGGA,296,299,3,19,17122,0,0
17741,ACGTCGAATCTAGGGA,296,297,1,25,17124,0,0
17742,ACGGCGAATCTTGGGA,296,299,3,25,17128,0,0
17743,ACGTCGATTCTGGGGA,296,299,3,21,17129,0,0
17744,ACGTCGAATCTAGGGA,296,299,3,18,17131,0,0
17745,ACGTCGAATCTAGGGA,296,297,1,22,17136,0,0
17746,ACGTCGAATCTAGGGA,296,299,3,24,17140,0,0
17747,ACGTCGAATCGAGGGA,296,299,3,23,17143,0,0
17748,ACGTCGAATCTAGGGA,296,296,0,25,17144,0,0
17749,ACGTCGAAAGTAGGGA,296,299,3,22,17145,0,0
17750,ACGTCGAATCTAGGGA,296,299,3,25,17146,0,0
17751,ACGTCGAATCTAGGGA,296,299,3,24,17153,0,0
17752,AAGTCGAATCTAGGGA,296,299,3,27,17157,0,0
17753,ACGTCGAATCTAGGGA,296,298,2,21,17158,0,0
17754,ACGTCGAATCTAGGGA,296,299,3,23,17159,0,0
17755,ACGTCGAATCTAGGGA,296,298,2,28,17291,0,0
17756,ACGTCGAATCTAGGGA,296,298,2,24,17417,0,0
17757,ACGTCGAATCTAGGGA,296,298,2,27,17421,0,0
17758,TCGTCGAATCTATTGA,296,299,3,24,17423,0,0
17759,ACGTCGAATCTAGGGA,296,299,3,21,17424,0,0
17760,ACGTCGAATCTAGGGA,296,299,3,25,17427,0,0
17761,TCGTCGAATCTAGGGA,296,299,3,24,17428,0,0
17762,ACGTCGAATCTAGGGA,297,333,36,18,15102,10,0
17763,ACGTCGAAAGTAGGGA,297,321,24,20,15251,6,0
17764,ACGTCGAATCTAGGGA,297,316,19,23,15265,4,0
17765,TCGACGAATCTAGGGA,297,299,2,23,15786,0,0
17766,ACGTCGAATCTAGGGA,297,299,2,26,15798,0,0
17767,TCGTCGAATCTATTGA,297,307,10,23,16048,1,0
17768,ACGTCGAATCTAGGGA,297,313,16,26,16058,3,0
17769,ACGTCGACTCTAGGGA,297,305,8,21,16287,1,0
17770,ACGTCGAATCTAGGGA,297,298,1,22,16292,0,0
17771,ACGTCGAATCTAGGGA,297,302,5,23,16468,0,0
17772,ACGTCGAATCTAGGGA,297,316,19,22,16472,4,0
17773,ACGTCGAATCTAGTGT,297,298,1,20,16473,0,0
17774,ACGTCGAATCTAGGGA,297,308,11,20,16474,2,0
17775,ACGTCGAATCTAGGGA,297,303,6,25,16577,0,0
17776,ACGTCGAATCTAGGGA,297,302,5,22,16591,0,0
17777,ACGTCGAATCTAGGGA,297,298,1,23,16592,0,0
17778,ACGTCGAATCTAGGGT,297,300,3,21,16593,0,0
17779,ACGTCGACTCTAGGGA,297,326,29,22,16594,8,0
17780,TCGTCGAATCTAGGGA,297,298,1,23,16667,0,0
17781,ACGTCGAATCTAGGGA,297,300,3,24,16679,0,0
17782,ACGTCGAATCTAGGGA,297,303,6,24,16686,0,0
17783,ACGTCGAATCTAGGGA,297,297,0,25,16687,0,0
17784,ACGTTGAATCTAGGGA,297,300,3,26,16697,0,0
17785,ACGTCGAATCTAGGGA,297,300,3,25,16704,0,0
17786,ACGTCGAATCTAGGGA,297,302,5,21,16839,0,0
17787,ACGTCGAATCTAGGGA,297,335,38,19,16841,11,0
17788,ACGTCGAATCTAGGGA,297,305,8,23,16938,1,0
17789,ACGTCGAATCTAGGGA,297,323,26,27,16941,7,0
17790,TCGTCGAATCTAGGGA,297,299,2,24,16956,0,0
17791,ACGTCGACTCTAGGGA,297,301,4,21,17012,0,0
17792,ACGTCGAATCTAGGGA,297,301,4,19,17015,0,0
17793,ACGTCGAATCTAGGGA,297,312,15,26,17019,3,0
17794,ACGTCGAATCTAGGGA,297,315,18,24,17022,4,0
17795,ACGTCGAATCGAGGGA,297,314,17,20,17026,4,0
17796,ACGTCGAATCTAGGGA,297,307,10,22,17033,1,0
17797,ACGTCGAATCTAGGGA,297,299,2,23,17178,0,0
17798,ACGTCGAATCTAGGGA,297,310,13,20,17180,2,0
17799,ACGTCGAATCTAGGGA,297,315,18,19,17182,4,0
17800,ACGTCGAATCTAGGGA,297,299,2,24,17183,0,0
17801,ACGTCGAATCTAGGGA,297,298,1,24,17186,0,0
17802,TCGTCGAATCTATTGA,297,297,0,24,17356,0,0
17803,ACGTCGAATCTAGGGA,297,325,28,20,17357,7,0
17804,ACGTCGAATCTAGGGA,297,301,4,26,17361,0,0
17805,ACGTCGAATCGAGGGA,297,297,0,20,17363,0,0
17806,ACGTCGAATGTAGGGA,297,310,13,23,17373,2,0
17807,ACGTTGAATCTAGGGA,297,312,15,26,17376,3,0
17808,ACGTCGAATCTAGGGA,297,305,8,25,17378,1,0
17809,ACGTCGAATCTAGGGA,297,314,17,24,17383,4,0
17810,ACGTCGAATCTAGGGA,297,297,0,23,17384,0,0
17811,ACGTCGAATCTAGGGA,297,301,4,27,17387,0,0
17812,ACGTCGAATCGAGGGA,297,300,3,24,17388,0,0
17813,ACGTCGAATCTAGGGA,297,304,7,21,17389,0,0
17814,ACTTCGAATCTAGGGA,297,298,1,19,17390,0,0
17815,ACGTCGAATCTAGGGA,297,301,4,28,17392,0,0
17816,ACGTCGAATGTAGGGA,297,297,0,22,17396,0,0
17817,ACGTCGAAAGTAGGGA,297,301,4,23,17398,0,0
17818,ACGTCGAATCTAGGGA,297,300,3,25,17403,0,0
17819,ACGTCGAATCGAGGGA,297,313,16,20,17404,3,0
17820,ACGTCGAATCTAGGGA,297,302,5,26,17406,0,0
17821,ACGTCGAATCTAGGGA,297,299,2,20,17409,0,0
17822,ACGTCGAAAGTAGGGA,297,299,2,22,17410,0,0
17823,ACGTCGAATGTAGGGA,297,333,36,21,17411,9,0
17824,ACGTCGAATCTAGGGA,298,301,3,24,16004,0,0
17825,ACGTCGAATCTAGGGA,298,313,15,17,16026,3,0
17826,ACGTCGAATCTAGGGA,298,298,0,20,16041,0,0
17827,ACGTCGAATCTAGGGA,298,325,27,21,16159,7,0
17828,ACGTCGAATCTAGGGA,298,309,11,19,16170,2,0
17829,ACGTCGAATCTAGGGA,298,298,0,21,16527,0,0
17830,ACGTCGAATCTAGGGA,298,310,12,24,16528,2,0
17831,ACGTCGAATCTAGGGA,298,300,2,21,16573,0,0
17832,ACGTTGAATCTAGGGA,298,316,18,26,16574,4,0
17833,ACGTCGAATCTAGGGA,298,316,18,19,16712,4,0
17834,ACGTCGAATGTAGGGA,298,298,0,20,16715,0,0
17835,ACGTCGAATCTAGGGA,298,308,10,23,16718,1,0
17836,ACGTCGAATCTAGGGA,298,307,9,26,16721,1,0
17837,ACGTCGAATCTAGGGA,298,302,4,20,16731,0,0
17838,ACGTCGACTCTAGGGA,298,303,5,22,16732,0,0
17839,ACGTCGAATCTAGGGA,298,299,1,21,16899,0,0
17840,ACGTCGAATCTTGGGA,298,321,23,24,16903,6,0
17841,ACGTCGAATCTAGGGA,298,306,8,22,16905,1,0
17842,ACGTCGAATCTAGGGA,298,309,11,27,16906,2,0
17843,ACGTCGAATCTAGGGA,298,318,20,26,16907,4,0
17844,ACGTCGATTCTGGGGA,298,301,3,21,16923,0,0
17845,TCGTCGAATCTAGGGA,298,301,3,24,16924,0,0
17846,ACGTCGAATCTAGGGA,298,299,1,22,16927,0,0
17847,ACGTCGATTCTGGGGA,298,301,3,20,16934,0,0
17848,ACGTCGAATCTAGGGA,298,300,2,24,16935,0,0
17849,ACGTCGAATCTAGGGA,298,301,3,27,17067,0,0
17850,ACGTTGAATCTAGGGA,298,301,3,26,17071,0,0
17851,ACGTCGAATCTAGGGA,298,300,2,28,17074,0,0
17852,ACGTCGAAGCTAGGGA,298,301,3,26,17075,0,0
17853,ACGTCGAATGTAGGGA,298,301,3,23,17077,0,0
17854,ACGTCGATTCTGGGGA,298,301,3,21,17081,0,0
17855,TCGTCGAATCTAGGGA,298,301,3,24,17082,0,0
17856,ACGTCGAATCTAGGGA,298,301,3,22,17162,0,0
17857,ACGTTGAATCTAGGGA,298,301,3,27,17163,0,0
17858,ACGTCGAATCTAGGGA,298,301,3,20,17164,0,0
17859,ACGTCGAAAGTACGGA,298,301,3,22,17165,0,0
17860,ACGTCGAATGTAGGGA,298,301,3,21,17167,0,0
17861,ACGTCGAATCTAGGGA,298,298,0,22,17172,0,0
17862,ACGTCGAATCTAGGGA,298,301,3,28,17238,0,0
17863,ACGTCGACTCTAGGGA,298,299,1,22,17243,0,0
17864,ACGTCGAATCTAGGGA,298,301,3,21,17246,0,0
17865,ACGTCGAATCTAGGGA,298,299,1,25,17249,0,0
17866,ACGTCGAATGTAGGGA,298,301,3,23,17250,0,0
17867,ACGTCGAATCTAGGGA,298,301,3,28,17255,0,0
17868,ACGTCGAATCTAGGGA,298,301,3,23,17256,0,0
17869,ACGTCGAATCTAGGGA,298,301,3,21,17257,0,0
17870,ACGTCGAATCTAGGGA,298,301,3,23,17259,0,0
17871,ACGTCGAATCTAGGGT,298,301,3,21,17260,0,0
17872,ACGTCGAATCTAGGGT,298,301,3,22,17267,0,0
17873,TCGTCGAATCTAGGGA,298,301,3,24,17270,0,0
17874,TCGTCGAATCTAGGGA,298,301,3,24,17271,0,0
17875,ACGTCGAATCTAGGGA,298,300,2,23,17273,0,0
17876,ACGTCGAATCTAGGGA,298,301,3,24,17274,0,0
17877,ACATCGAATCTAGGGA,298,301,3,26,17275,0,0
17878,ACGTCGAATCTAGGGA,298,301,3,25,17278,0,0
17879,ACGCCGAATCTAGGGA,298,300,2,23,17430,0,0
17880,ACGTCGAATCTAGGGA,298,301,3,24,17431,0,0
17881,ACGTCGAATCTAGGGA,298,299,1,21,17434,0,0
17882,ACGTCGAATCTAGGGA,298,301,3,23,17437,0,0
17883,ACGTCGAATCTAGGGA,298,301,3,24,17438,0,0
17884,ACGTCGAATCTAGGGT,298,301,3,22,17439,0,0
17885,ACGTCGACTCTAGGGA,298,301,3,23,17440,0,0
17886,ACGTCGAATGTAGGGA,298,298,0,24,17443,0,0
17887,ACATCGAATCTAGGGA,298,300,2,26,17444,0,0
17888,ACGTCGAATCTAGGGA,298,301,3,25,17446,0,0
17889,ACGTTGAATCTAGGGA,298,301,3,27,17449,0,0
17890,ACGTCGAATCTAGGGA,298,299,1,26,17451,0,0
17891,ACGTCGAATCTAGGGA,298,301,3,22,17454,0,0
17892,ACGTCGAATCTAGGTA,298,299,1,22,17459,0,0
17893,ACGTCGAATCTAGGGA,298,301,3,21,17462,0,0
17894,TCGTCGAATCTATTGA,299,301,2,23,14858,0,0
17895,ACGTCGAATCTAGGGA,299,319,20,19,15184,5,0
17896,ACGTCGAATCTAGGGA,299,316,17,18,15379,4,0
17897,ACGTCGAATCTAGGGA,299,306,7,25,15719,0,0
17898,ACGTCGAATCTAGGGA,299,304,5,23,16073,0,0
17899,ACGTCGAATCTAGGGA,299,313,14,17,16249,3,0
17900,ACGTCGAATCTAGGGA,299,299,0,24,16426,0,0
17901,ACGTCGAATCTAGGGA,299,302,3,25,16430,0,0
17902,ACGTCGAATGTAGGGA,299,300,1,22,16432,0,0
17903,ACGTCGAATCGAGGGA,299,299,0,23,16444,0,0
17904,ACGTTGAATCTAGGGA,299,310,11,25,16599,2,0
17905,ACGTCGAATCTAGGGA,299,300,1,24,16707,0,0
17906,ATGTCGAATCTTGGGA,299,319,20,17,16768,5,0
17907,ACGTCGAATCTAGGGA,299,313,14,27,16771,3,0
17908,ACGTCGAATCTAGGGA,299,303,4,22,16780,0,0
17909,ACGTCGAATCTAGGGA,299,326,27,24,16781,7,0
17910,ACGTCGAATCTAGGGA,299,310,11,23,16803,2,0
17911,ACGTCGAATTTAGGGA,299,303,4,25,16818,0,0
17912,ACGTCGAATCTAGGGA,299,315,16,17,16944,3,0
17913,ACGTCGAATCTAGGGA,299,306,7,25,16950,0,0
17914,ACGTCGAATCTAGGGA,299,322,23,25,16953,6,0
17915,ACGTCGAGTCTAGGGA,299,300,1,26,17053,0,0
17916,ACGTCGAAAGTAGGGA,299,310,11,21,17055,2,0
17917,ACGTCGAATCGAGGGA,299,299,0,19,17122,0,0
17918,ACGTCGAATCTAGGGA,299,331,32,25,17124,9,0
17919,ACGGCGAATCTAGGGA,299,319,20,25,17128,5,0
17920,ACGTCGATTCTGGGGA,299,307,8,21,17129,1,0
17921,ACGTCGAATCTAGGGA,299,299,0,22,17136,0,0
17922,ACGTCGAATCTAGGGA,299,302,3,24,17140,0,0
17923,ACGTCGAATCGAGGGA,299,300,1,23,17143,0,0
17924,ACGTCGAAAGTAGGGA,299,307,8,22,17145,1,0
17925,ACGTCGAATCTAGGGA,299,303,4,25,17146,0,0
17926,AAGTCGAATCTAGGGA,299,303,4,27,17157,0,0
17927,ACGTCGAATCTAGGGA,299,309,10,21,17158,1,0
17928,ACGTCGAATCTAGGGA,299,306,7,23,17159,0,0
17929,ACGTCGAATCTAGGGA,299,304,5,28,17291,0,0
17930,ACGTCGAATCTAGGGA,299,299,0,27,17421,0,0
17931,TCGTCGAATCTATTGA,299,299,0,24,17423,0,0
17932,TCGTCGAATCTAGGGA,299,300,1,24,17428,0,0
17933,ACGTCGGATCTAGGGA,299,327,28,21,17482,7,0
17934,ACGTCGAATCTAGGGA,299,312,13,27,17483,2,0
17935,ACGTCGAATCTAGGGA,299,301,2,22,17484,0,0
17936,ACGTCGAATCTAGGGA,299,299,0,24,17486,0,0
17937,ACGTCGAATCGAGGGA,299,299,0,23,17487,0,0
17938,ACGTCGAATCTAGGGA,299,301,2,22,17489,0,0
17939,ACGTCGAATCTAGGGA,299,299,0,24,17491,0,0
17940,ACGTCGAATCTAGGGA,299,317,18,22,17495,4,0
17941,ACGTCGAATCTAGGGA,299,304,5,20,17497,0,0
17942,ACGTCGAATCTAGGGA,299,306,7,25,17498,0,0
17943,ACGTCGAATCTAGGGA,299,307,8,24,17500,0,0
17944,ACGTCGAATCTAGGGA,299,299,0,27,17501,0,0
17945,ACGTCGAATCTAGGGA,300,309,9,18,15102,1,0
17946,ACGTCGAAAGTAGGGA,300,303,3,20,15251,0,0
17947,ACGTCGAATCTAGGGA,300,310,10,23,15265,1,0
17948,TCGTCGAATCTAGGGA,300,312,12,23,15786,2,0
17949,ACGTCGAATCTAGGGA,300,301,1,22,16292,0,0
17950,ACGTCGAATCTAGGGA,300,303,3,23,16468,0,0
17951,ACGTCGAATGTAGGGA,300,319,19,22,16472,4,0
17952,ACGTCGAATCTAGGGT,300,304,4,20,16473,0,0
17953,ACGTCGAATCTAGGGA,300,305,5,20,16474,0,0
17954,ACGTCGAATCTAGGGA,300,306,6,25,16577,0,0
17955,ACGTCGAATCTAGGGA,300,302,2,22,16591,0,0
17956,ACGTCGAATCTAGGGT,300,309,9,21,16593,1,0
17957,ACGTCGACGCTAGGGA,300,301,1,22,16594,0,0
17958,TCGTCGAATCTAGGGT,300,306,6,23,16667,0,0
17959,ACGTCGAATCTAGGGA,300,311,11,24,16679,2,0
17960,ACGTCGAATCTAGGGA,300,301,1,24,16686,0,0
17961,ACGTCGAATCTAGGGA,300,313,13,25,16687,2,0
17962,ACGTTGAATCTAGGGA,300,300,0,26,16697,0,0
17963,ACGTCGAATCTAGGGA,300,303,3,25,16704,0,0
17964,ACGTCGAATCTAGGGA,300,321,21,21,16839,5,0
17965,ACGTCGAATCTAGGGA,300,310,10,19,16841,1,0
17966,ACGTCGAATCTAGGGA,300,302,2,27,16941,0,0
17967,TCGTCGAATCTAGGGA,300,310,10,24,16956,1,0
17968,ACGTCGACTCTAGGGA,300,317,17,21,17012,4,0
17969,ACGTCGAATCTAGGGA,300,305,5,26,17019,0,0
17970,ACGTGGAATCGAGGGA,300,301,1,20,17026,0,0
17971,ACGTCGAATCTAGGGA,300,303,3,23,17178,0,0
17972,ACGTCGAATCTAGGGA,300,303,3,20,17180,0,0
17973,ACGTCGAATCTAGGGA,300,303,3,19,17182,0,0
17974,ACGTCGAATCTAGGGA,300,303,3,24,17186,0,0
17975,ACGTCGAATCTAGGGA,300,303,3,20,17357,0,0
17976,ACGTCGAATCTAGGGA,300,303,3,26,17361,0,0
17977,ACGTCGAATCGAGGGA,300,303,3,20,17363,0,0
17978,ACGTCGAATGTAGGGA,300,303,3,23,17373,0,0
17979,ACGTTGAATCTAGGGA,300,302,2,26,17376,0,0
17980,ACGTCGAATCTAGGGA,300,303,3,25,17378,0,0
17981,ACGTCGAATCTAGGGA,300,303,3,24,17383,0,0
17982,ACGTCGAATCTAGGGA,300,303,3,23,17384,0,0
17983,ACGTCGAATCTAGGGA,300,300,0,27,17387,0,0
17984,ACGTCGAATCGAGGGA,300,301,1,24,17388,0,0
17985,ACGTCGAATCTAGGGA,300,303,3,21,17389,0,0
17986,ACGTCGAATCTAGGGA,300,303,3,19,17390,0,0
17987,ACGTCGAATCTAGGGA,300,303,3,28,17392,0,0
17988,ACGTCGAATGTAGGGA,300,303,3,22,17396,0,0
17989,ACGTCGAAAGTAGGGA,300,303,3,23,17398,0,0
17990,ACGTCGAATCGAGGGA,300,303,3,20,17404,0,0
17991,ACGTCGAATCTAGGGA,300,301,1,26,17406,0,0
17992,ACGTCGAATCTAGGGA,300,303,3,20,17409,0,0
17993,ACGTCGAAAGTAGGGA,300,303,3,22,17410,0,0
17994,ACGTCCAATGTAGGGA,300,303,3,21,17411,0,0
17995,TCGTCGAATCTATTGA,300,300,0,24,17531,0,0
17996,ACATCGAATCTAGGGA,300,303,3,18,17537,0,0
17997,ACGTCGAATCGAGGGA,300,303,3,24,17539,0,0
17998,ACGTCGAATCTAGGGA,300,303,3,25,17540,0,0
17999,ACGTCGAATCTAGGGA,300,303,3,19,17543,0,0
18000,ACGTCGAATCGAGGGA,300,303,3,24,17544,0,0
18001,ACGTCGAATCTAGGGA,300,300,0,25,17547,0,0
18002,ACGTCGAATCTTGGGA,300,303,3,18,17548,0,0
18003,ACGTCGAATCAAGGGA,300,303,3,23,17550,0,0
18004,ACGTCGAATCTAGGGA,300,301,1,19,17554,0,0
18005,ACGTCGAATCTAGGGA,300,303,3,24,17555,0,0
18006,TCGTCGAATCTAGGGA,300,303,3,25,17556,0,0
18007,ACGTCGAATCTAGGGA,300,303,3,29,17558,0,0
18008,ACGTCGAATCTAGGGA,300,303,3,18,17560,0,0
18009,ACGTCGAATCTAGGGA,300,303,3,26,17562,0,0
18010,ACGTCGAATCTAGGGA,300,303,3,20,17565,0,0
18011,ACGTCGAATCTAGGGA,300,303,3,26,17570,0,0
18012,ACGACGAATCTAGGGA,300,303,3,26,17572,0,0
18013,ACGTCGAATCTAGGGA,300,300,0,19,17575,0,0
18014,ACGTCGAATCTAGGGA,300,303,3,23,17576,0,0
18015,ACGTCGAATCTAGGGA,300,301,1,26,17577,0,0
18016,TCGTCGAATCTAGGGA,300,303,3,21,17578,0,0
18017,ACGTCGAATCTAGGGA,300,303,3,25,17579,0,0
18018,ACGTCGAATCTAGGGA,301,301,0,24,16004,0,0
18019,ACGTCGAATCTAGGGA,301,317,16,17,16026,3,0
18020,ACGTCGAATCTAGGGA,301,301,0,20,16041,0,0
18021,ACGTCGAATCTAGGGA,301,303,2,21,16159,0,0
18022,ACGTCGAATCTAGGGA,301,307,6,21,16527,0,0
18023,ACGTCGAATCTAGGGA,301,343,42,21,16573,12,0
18024,ACGTTGAATCTAGGGA,301,320,19,26,16574,4,0
18025,ACGTCGAATCTAGGGA,301,315,14,23,16718,3,0
18026,ACGTCGAATCTAGGGA,301,304,3,26,16721,0,0
18027,ACGTCGAATCTAGGGA,301,310,9,20,16731,1,0
18028,ACGTCGAATCTAGGGA,301,302,1,27,16906,0,0
18029,ACGTCGAATCTAGGGA,301,304,3,26,16907,0,0
18030,ACGTCGATTCTGGGGA,301,349,48,21,16923,14,0
18031,TCGTCGAATCTAGGGA,301,301,0,24,16924,0,0
18032,ACGTCGAATCTAGGGA,301,311,10,22,16927,1,0
18033,ACGTCGATTCTGGGGA,301,309,8,20,16934,1,0
18034,ACGTCGAATCTAGGGA,301,306,5,24,16935,0,0
18035,ACGTTGAATCTAGGGA,301,309,8,26,17071,1,0
18036,ACGTCGAATCTAGGGA,301,335,34,28,17074,9,0
18037,ACGTCGATTCTGGGGA,301,314,13,21,17081,2,0
18038,ACGTTGAATCTAGGGA,301,338,37,27,17163,10,0
18039,ACGTCGCATCTAGGGA,301,316,15,20,17164,3,0
18040,ACGTCGAATGTAGGGA,301,307,6,21,17167,0,0
18041,ACGTCGAATCTAGGGA,301,301,0,22,17172,0,0
18042,ACGTCGAATCTAGGGA,301,313,12,28,17238,2,0
18043,ACGTCTACTCTAGGGA,301,318,17,22,17243,4,0
18044,ACGTCGAATCTAGGGA,301,301,0,21,17246,0,0
18045,ACGTCGAATCTAGGGA,301,313,12,25,17249,2,0
18046,ACGTCGAATCTATGGA,301,306,5,28,17255,0,0
18047,ACGTCGAATCTAGGGA,301,317,16,23,17256,3,0
18048,ACGTCGAATCTAGGGA,301,302,1,23,17259,0,0
18049,ACGTCGAATCTAGGGT,301,302,1,21,17260,0,0
18050,ACGTCGAATCTAGGGA,301,315,14,24,17274,3,0
18051,ACATCGAATCTAGGGA,301,306,5,26,17275,0,0
18052,ACGCCGAATCTAGGGA,301,304,3,23,17430,0,0
18053,ACGTCGAATCTAGGGA,301,303,2,24,17431,0,0
18054,ACGTCGAATCTAGGGA,301,321,20,21,17434,5,0
18055,ACGTCGAATCTAGGGA,301,305,4,23,17437,0,0
18056,ACGTCGAATCTAGGGA,301,303,2,24,17438,0,0
18057,ACGTCGAATCTAGGGT,301,305,4,22,17439,0,0
18058,ACGTCGACTCTAGGGA,301,325,24,23,17440,5,0
18059,ACATCGAATCTAGGGA,301,303,2,26,17444,0,0
18060,ACGTTGAATCTAGGGA,301,324,23,27,17449,5,0
18061,ACGTCGAATCTAGGGA,301,305,4,26,17451,0,0
18062,ACGTCGAATCTAGGGA,301,302,1,22,17454,0,0
18063,ACGTCGAATCTAGGGA,301,324,23,21,17462,5,0
18064,ACGTCGAAAGTAGGGA,301,330,29,21,17592,7,0
18065,TCGTCGAATCTAGGGA,301,318,17,24,17594,3,0
18066,ACGTCGAATCTAGGGT,301,303,2,21,17603,0,0
18067,ACGTCGAATCTAGGGA,301,312,11,23,17606,1,0
18068,ACGTCGAATCTAGGGA,301,312,11,24,17607,1,0
18069,ACGTCGAATCTAGGGT,301,316,15,22,17608,2,0
18070,TCGTCGAATCTAGGGA,301,307,6,24,17610,0,0
18071,ACGTCGAATCTAGGGA,302,305,3,19,15184,0,0
18072,ACGTCGAATCTAGGGA,302,304,2,25,15719,0,0
18073,ACGTCGAATCTAGGGA,302,305,3,23,16073,0,0
18074,ACGTCGAATCTAGGGA,302,321,19,17,16249,4,0
18075,ACGTCGAATCTAGGGA,302,315,13,24,16426,2,0
18076,ACGTCGAATCTAGGGA,302,310,8,25,16430,1,0
18077,ACGTCGAATGTAGGGA,302,303,1,22,16432,0,0
18078,ACGTTGAATCTAGGGA,302,307,5,25,16599,0,0
18079,ACGTCGAATCTTGGGA,302,306,4,17,16768,0,0
18080,ACGTCGAATCTAGGGA,302,302,0,27,16771,0,0
18081,ACGTCGAATCTAGGGA,302,306,4,22,16780,0,0
18082,ACGTCGAATCTAGGGA,302,331,29,24,16781,8,0
18083,ACGTCGAATCTAGGGA,302,317,15,23,16803,3,0
18084,ACGTCGAATCTAGGGA,302,310,8,17,16944,1,0
18085,ACGTCGAATCTAGGGA,302,305,3,25,16950,0,0
18086,ACGTCGAATCTAGGGA,302,305,3,25,16953,0,0
18087,ACGTCGAGTCTAGGGA,302,305,3,26,17053,0,0
18088,ACGTCGAAAGTAGGGA,302,304,2,21,17055,0,0
18089,ACGTCGAATCGAGGGA,302,305,3,19,17122,0,0
18090,ACGTCGAATCTAGGGA,302,305,3,25,17124,0,0
18091,ACGTCGATTCTGGGGA,302,303,1,21,17129,0,0
18092,ACGTCGAATCTAGGGA,302,305,3,24,17140,0,0
18093,ACGTCGAATCGAGGGA,302,302,0,23,17143,0,0
18094,ACGTCGAAAGTAGGGA,302,305,3,22,17145,0,0
18095,AAGTCGAATCTAGGGA,302,305,3,27,17157,0,0
18096,ACGTCGAATCTAGGGA,302,302,0,23,17159,0,0
18097,ACGTCGAATCTAGGGA,302,305,3,28,17291,0,0
18098,ACGTCGAATCTAGGGA,302,305,3,27,17421,0,0
18099,TCGTCGAATCTATTGA,302,304,2,24,17423,0,0
18100,ACGTCGAATCTAGGGA,302,305,3,27,17483,0,0
18101,ACGTCGAATCTAGGGA,302,305,3,22,17489,0,0
18102,ACGTCGAATCTAGGGA,302,302,0,24,17491,0,0
18103,ACGTCGAATCTAGGGA,302,305,3,22,17495,0,0
18104,ACGTCGAATCTAGGGA,302,303,1,25,17498,0,0
18105,ACGTCGAATCTAGGGA,302,305,3,24,17500,0,0
18106,ACGTCGAATCTAGGGA,302,305,3,27,17501,0,0
18107,ACGTCGAATCTAGGGA,302,305,3,25,17645,0,0
18108,ACGTCGAATCTAGGGA,302,302,0,20,17649,0,0
18109,ACGTCGAATCTAGGGA,302,302,0,25,17651,0,0
18110,ACGTCGAATCTAGGGA,302,305,3,22,17653,0,0
18111,ACGTCGAATCTAGGGA,302,303,1,20,17655,0,0
18112,ACGTCGAATCTAGGGA,302,305,3,25,17656,0,0
18113,ACGTCGAATGTAGGGA,302,304,2,21,17657,0,0
18114,ACGTCGAATCGAGGGA,302,305,3,26,17660,0,0
18115,ACGTCGAATCTAGGGA,302,305,3,21,17661,0,0
18116,ACGTCGACTCTAGGGA,302,305,3,23,17662,0,0
18117,TCGTCGAATCTAGGGA,302,305,3,25,17664,0,0
18118,ACGTCGAATCTAGGGA,302,302,0,25,17665,0,0
18119,ACGTCGAATCTAGGGA,302,305,3,28,17667,0,0
18120,ACGTCGAATCTAGGGA,302,304,2,27,17668,0,0
18121,ACGTCGAATCTAGGGA,302,302,0,20,17669,0,0
18122,ACGTCGAATCTAGGGA,302,304,2,23,17672,0,0
18123,ACGTCGATTCTGGGGA,302,304,2,21,17673,0,0
18124,ACGTCGTATCTAGGGA,302,305,3,27,17678,0,0
18125,ACGTCGAATGTAGGGA,302,305,3,24,17680,0,0
18126,TCGTCGAATCTAGGGA,302,305,3,25,17683,0,0
18127,ACGTCGAATCTAGGGA,302,305,3,23,17684,0,0
18128,ACGTTGAATCTAGGGA,302,305,3,28,17685,0,0
18129,ACGTCGAATCTAGGGA,302,305,3,21,17686,0,0
18130,ACGTCGAATGTAGGGA,302,305,3,22,17688,0,0
18131,ACGTCGAATCTAGGGA,302,305,3,22,17693,0,0
18132,ACGTCGAAAGTAGGGA,303,310,7,20,15251,0,0
18133,ACGTCGAATCTAGGGA,303,305,2,23,15265,0,0
18134,ACGTCGAATCTAGGGA,303,323,20,22,16292,5,0
18135,ACGTCGAATCTAGGGA,303,304,1,23,16468,0,0
18136,ACGTCGAATCTAGGGA,303,308,5,22,16472,0,0
18137,ACGTCGAATCTAGGGT,303,319,16,20,16473,3,0
18138,ACGTCGAATCTAGGGA,303,304,1,20,16474,0,0
18139,ACGTCGAATCTAGGGA,303,325,22,22,16591,5,0
18140,ACGTCGAATCTAGGGT,303,310,7,21,16593,0,0
18141,ACGTCGACTCTAGGGA,303,305,2,22,16594,0,0
18142,TCGTCGAATCTAGGGA,303,317,14,23,16667,3,0
18143,ACGTCGAATCTAGGGA,303,304,1,24,16686,0,0
18144,ACGTCGAATCTAGGGA,303,328,25,25,16687,6,0
18145,ACGTTGAATCTAGGGA,303,321,18,26,16697,4,0
18146,ACCTCGAATCTAGGGA,303,318,15,25,16704,3,0
18147,ACGTCGAATCTAGGGA,303,303,0,21,16839,0,0
18148,ACGTCGAATCTAGGGA,303,309,6,19,16841,0,0
18149,ACGTCGAATCTAGGGA,303,306,3,27,16941,0,0
18150,TCGTCGAATCTAGGGA,303,307,4,24,16956,0,0
18151,ACGTCGACTCTAGGGA,303,303,0,21,17012,0,0
18152,ACGTCGAATCTAGGGA,303,308,5,26,17019,0,0
18153,ACGTCGAATCGAGGGA,303,312,9,20,17026,1,0
18154,ACGTCGAATCTAGGGA,303,323,20,23,17178,5,0
18155,ACGTCGAATCTAGGGA,303,320,17,24,17186,4,0
18156,ACGTCGAATCTAGGGA,303,304,1,20,17357,0,0
18157,ACGTCGAATCTAGGGA,303,306,3,26,17361,0,0
18158,ACGTCGAATCGAGGGA,303,304,1,20,17363,0,0
18159,ACGTCGAATGTAGGGA,303,316,13,23,17373,2,0
18160,ACGTTGAATCTAGGGA,303,305,2,26,17376,0,0
18161,ACGTCGAATCTAGGGA,303,307,4,25,17378,0,0
18162,ACGTCGAATCTAGGGA,303,304,1,24,17383,0,0
18163,ACGTCGAATCTAGGGA,303,313,10,23,17384,1,0
18164,ACGTCGAATCTAGGGA,303,308,5,27,17387,0,0
18165,ACGTCGAATCGAGGGA,303,304,1,24,17388,0,0
18166,ACGTCGAATCTAGGGA,303,325,22,21,17389,5,0
18167,ACGTCGAATCTAGGGA,303,303,0,19,17390,0,0
18168,ACGTCGAATGTAGGGA,303,323,20,22,17396,5,0
18169,ACGTCGAAAGTAGGGA,303,305,2,23,17398,0,0
18170,ACGTCGAATCGAGGGA,303,316,13,20,17404,2,0
18171,ACGTCGAATCTAGGGA,303,304,1,26,17406,0,0
18172,ACGTCGAATCTAGGGA,303,306,3,20,17409,0,0
18173,ACGTCGAAAGTAGGGA,303,304,1,22,17410,0,0
18174,ACGTCGAATGTAGGGA,303,306,3,21,17411,0,0
18175,TCGTCGAATCTATTGA,303,303,0,24,17531,0,0
18176,ACGTCGAATCTAGGGA,303,303,0,18,17537,0,0
18177,ACGTCGAATCGAGGGA,303,312,9,24,17539,1,0
18178,ACGTCGAATCTAGGGA,303,306,3,25,17540,0,0
18179,ACGTCGAATCTAGGGA,303,307,4,19,17543,0,0
18180,ACGTCGAATCTTGGGA,303,304,1,18,17548,0,0
18181,ACGTCGAATCTAGGGA,303,303,0,23,17550,0,0
18182,ACGTCGAATCTAGGGA,303,314,11,19,17554,2,0
18183,ACGTCGAATCTAGGGA,303,306,3,29,17558,0,0
18184,ACGTCGAATCTAGGGA,303,336,33,18,17560,9,0
18185,ACGTCGAATCTAGGGA,303,339,36,26,17562,10,0
18186,ACGTCGAATCTAGGGA,303,311,8,20,17565,1,0
18187,ACGTCGAATCTAGGGA,303,312,9,26,17570,1,0
18188,ACGGCGAATCTAGGGA,303,315,12,26,17572,1,0
18189,ACGTCGAATCTAGGGA,303,308,5,23,17576,0,0
18190,ACGTCGAATCTAGGGA,303,306,3,26,17577,0,0
18191,TCGTCGAATCTATTGA,303,312,9,24,17710,0,0
18192,ACGTCGAATCTAGGGA,304,305,1,24,16004,0,0
18193,ACGTCGAATCTAGGGA,304,306,2,17,16026,0,0
18194,ACGTCGAATCTAGGGA,304,307,3,20,16041,0,0
18195,ACGTTGAATCTAGGGA,304,311,7,26,16574,0,0
18196,ACGTCGAATCTAGGGA,304,306,2,23,16718,0,0
18197,ACGTCGAATCTAGGGA,304,308,4,20,16731,0,0
18198,ACGTCGAATCTAGGGA,304,310,6,26,16907,0,0
18199,ACGTCGATTCTGGGGA,304,311,7,21,16923,0,0
18200,TCGTCGAATCTAGGGA,304,305,1,24,16924,0,0
18201,CCGTCGAATCTAGGGA,304,308,4,22,16927,0,0
18202,ACGTCGATTCCGGGGA,304,316,12,20,16934,2,0
18203,ACGTCGAATCTAGGGA,304,305,1,24,16935,0,0
18204,ACGTTGAATCTAGGGA,304,338,34,26,17071,9,0
18205,ACGTCGAATCTAGGGA,304,305,1,28,17074,0,0
18206,ACGTCGATTCTGGGGA,304,308,4,21,17081,0,0
18207,ACGTCGAATGTAGGGA,304,307,3,21,17167,0,0
18208,ACGTCGAATCTAGGGA,304,304,0,22,17172,0,0
18209,ACGTCGAATCTAGGGA,304,306,2,28,17238,0,0
18210,ACGTCGACTCTAGGGA,304,307,3,22,17243,0,0
18211,ACGTCGAATCTAGGGA,304,304,0,21,17246,0,0
18212,ACGTCGAATCTAGGGA,304,307,3,25,17249,0,0
18213,ACGTCGAATCTAGGGA,304,306,2,28,17255,0,0
18214,ACGTCGAATCTAGGGA,304,305,1,23,17256,0,0
18215,ACGTCGAATCTAGGGA,304,306,2,24,17274,0,0
18216,ACATCGAATCTAGGGA,304,306,2,26,17275,0,0
18217,ACGCCGAATCTAGGGA,304,307,3,23,17430,0,0
18218,ACGTCGAATCTAGGGA,304,307,3,23,17437,0,0
18219,ACGTCGACTCTAGGGA,304,304,0,23,17440,0,0
18220,ACATCGAATCTAGGGA,304,307,3,26,17444,0,0
18221,ACGTTGAATCTAGGGA,304,306,2,27,17449,0,0
18222,ACGTCGAATCTAGGGA,304,304,0,26,17451,0,0
18223,ACGTCGAATCTAGGGA,304,307,3,22,17454,0,0
18224,ACGTCGAATCTAGGGA,304,307,3,21,17462,0,0
18225,TCGTCGAATCTAGGGA,304,307,3,24,17594,0,0
18226,ACGTCGAATCTAGGGT,304,307,3,21,17603,0,0
18227,ACGTCGAATCTAGGGA,304,307,3,23,17606,0,0
18228,ACGTCGAATCTAGGGA,304,307,3,24,17607,0,0
18229,ACGTCGAATCTAGGGT,304,307,3,22,17608,0,0
18230,TCGTCGAATCTAGGGA,304,304,0,24,17610,0,0
18231,ACGTCGAATCTAGGGA,304,307,3,26,17694,0,0
18232,ACGTCGAATCTAGGGA,304,306,2,24,17697,0,0
18233,ACGTCGAATCTAGGGA,304,307,3,24,17699,0,0
18234,ACGTCGAATCTAGGGA,304,305,1,25,17706,0,0
18235,ACATCGAATCTAGGGA,304,306,2,27,17707,0,0
18236,ACGTCGAATCTAGGGA,304,307,3,19,17762,0,0
18237,ACGTCGAAAGTAGGGA,304,307,3,21,17763,0,0
18238,ACGTCGAATCTAGGGA,304,307,3,24,17764,0,0
18239,TCGTCGAATCTATTGA,304,304,0,24,17767,0,0
18240,ACGTCGAATCTAGGGA,304,307,3,27,17768,0,0
18241,ACGTCGACTCTAGGGA,304,307,3,22,17769,0,0
18242,ACGTCCAATCTAGGGA,304,307,3,23,17772,0,0
18243,ACGTCGAATCTAGGGA,304,307,3,21,17774,0,0
18244,ACGTCGACTCTAGGGA,304,307,3,23,17779,0,0
18245,ACGTCGAATCTAGGGA,304,307,3,20,17787,0,0
18246,ACGTCGAATCTAGGGA,304,304,0,24,17788,0,0
18247,ACGTCGAATCTAGGGA,304,307,3,28,17789,0,0
18248,ACGTCGAATCTAGGGA,304,307,3,27,17793,0,0
18249,ACGTCGAATCTAGGGA,304,307,3,25,17794,0,0
18250,ACGTCGAATCGAGGGA,304,307,3,21,17795,0,0
18251,ACGTCGAATCTAGGGA,304,307,3,23,17796,0,0
18252,ACGTCGAATCTAGGGA,304,306,2,21,17798,0,0
18253,ACGTCGAATCTAGGGA,304,307,3,20,17799,0,0
18254,ACGTCGAATCTAGGGA,304,307,3,21,17803,0,0
18255,ACGTCGAATGTAGGGA,304,307,3,24,17806,0,0
18256,ACGTTGAATCTAGGGA,304,307,3,27,17807,0,0
18257,ACGTCGAATCTAGGGA,304,307,3,26,17808,0,0
18258,ACGTCGAATCTAGGGA,304,306,2,25,17809,0,0
18259,ACGTCCAATCTAGGGA,305,317,12,19,15184,2,0
18260,ACGTCGAATCTAGGGA,305,305,0,23,16073,0,0
18261,ACGTCGAATCTAGGGA,305,305,0,24,16426,0,0
18262,ACGTCGAATCTAGGGA,305,307,2,25,16430,0,0
18263,ACGTCGAATGTAGGGA,305,310,5,22,16432,0,0
18264,ACGTCGAATCTTGGGA,305,314,9,17,16768,1,0
18265,ACGTCGAATCTAGGGA,305,309,4,27,16771,0,0
18266,ACGTCGAATCTAGGGA,305,308,3,22,16780,0,0
18267,ACGTCGAATCTAGGGA,305,313,8,24,16781,1,0
18268,ACGTCGAATCTAGGGA,305,326,21,23,16803,5,0
18269,ACGTCGAATCTAGGGA,305,310,5,25,16950,0,0
18270,ACGTCGAATCTAGGGA,305,318,13,25,16953,2,0
18271,ACGTCGAGTCTAGGGA,305,319,14,26,17053,3,0
18272,ACGTCGAAAGTAGGGA,305,317,12,21,17055,2,0
18273,ACGTCGAATCTAGGGA,305,309,4,25,17124,0,0
18274,ACGTCGATTCTGGGGA,305,315,10,21,17129,1,0
18275,ACGTCGAATCTAGGGA,305,306,1,24,17140,0,0
18276,ACGTCGAAAGTAGGGA,305,310,5,22,17145,0,0
18277,AAGTCGAATCTAGGGA,305,307,2,27,17157,0,0
18278,TCGTCGAATCTATTGA,305,307,2,24,17423,0,0
18279,ACGTCGAATCTAGGGA,305,343,38,24,17491,11,0
18280,ACGTCGAATCTAGGGA,305,313,8,22,17495,1,0
18281,ACGTCGAATCTAGGGA,305,320,15,25,17498,3,0
18282,ACGTCGAATCTAGGGA,305,306,1,24,17500,0,0
18283,ACGTCGAATCTAGGGA,305,307,2,27,17501,0,0
18284,ACGTCGAATCTAGGGA,305,308,3,25,17645,0,0
18285,ACGTCGAATCTAGGGA,305,305,0,20,17649,0,0
18286,ACGTCGAATCTAGGGA,305,315,10,25,17656,1,0
18287,ACGTCGAATGTAGGGA,305,306,1,21,17657,0,0
18288,ACGTCGAATCGAGGGA,305,318,13,26,17660,2,0
18289,ACGTCGAATCTAGGGA,305,323,18,21,17661,4,0
18290,ACGTCGACTCTAGGGA,305,307,2,23,17662,0,0
18291,ACGTCGAATCTAGGGA,305,309,4,28,17667,0,0
18292,ACGTCGAATCTAGGGA,305,308,3,27,17668,0,0
18293,ACGTCGAATCTAGGGA,305,306,1,20,17669,0,0
18294,ACGTCGAATCTAGGGA,305,324,19,23,17672,4,0
18295,ACGTCGATTCTGGGGA,305,321,16,21,17673,3,0
18296,ACGTCGAATGTAGGGA,305,332,27,24,17680,7,0
18297,TCGTCGAATCTAGGGA,305,312,7,25,17683,0,0
18298,ACGTCGAATCTAGGGA,305,307,2,23,17684,0,0
18299,ACGTTGAATCTAGGGA,305,324,19,28,17685,4,0
18300,ACGTCGAATCTAGGGA,305,306,1,18,17825,0,0
18301,ACGTCGAATCTAGGGA,305,325,20,22,17827,5,0
18302,ACGTCGAATCTAGGGA,305,322,17,20,17828,4,0
18303,ACGTCGAATCTAGGGA,305,308,3,25,17830,0,0
18304,ACGTTGAATCTAGGGA,305,317,12,27,17832,2,0
18305,ACGTCGAATCTAGGGA,305,321,16,20,17833,3,0
18306,ACGTCGAATCTAGGGA,305,310,5,24,17835,0,0
18307,ACGTCGAATCTAGGGA,305,308,3,27,17836,0,0
18308,ACGTCGAATCTTGGGA,305,306,1,25,17840,0,0
18309,ACGTCGAATCTAGGGA,305,319,14,23,17841,3,0
18310,ACGTCGAATCTAGGGA,305,319,14,28,17842,3,0
18311,ACGTCGAATCTAGGGA,306,330,24,23,15265,7,0
18312,ACGTCGAATCTAGGGA,306,313,7,20,16474,1,0
18313,ACGTCGAATCTAGGGA,306,313,7,22,16591,0,0
18314,ACGTCGAATCTAGGGT,306,321,15,21,16593,3,0
18315,ACGTCGACTCTAGGGA,306,308,2,22,16594,0,0
18316,TCGTCGAATCTAGGGA,306,323,17,23,16667,4,0
18317,ACGTCGAATCTAGGGA,306,320,14,24,16686,3,0
18318,ACGTCGAATCTAGGGA,306,307,1,25,16687,0,0
18319,ACGTTGAATCTAGGGA,306,306,0,26,16697,0,0
18320,ACGTCGAATCTAGGGA,306,310,4,25,16704,0,0
18321,ACGTCGAATCTAGGGA,306,318,12,21,16839,2,0
18322,ACGTCGAATCTAGGGA,306,314,8,19,16841,1,0
18323,ACGTCGAATCTAGGGA,306,310,4,27,16941,0,0
18324,TCGTCGAATCTAGGGA,306,307,1,24,16956,0,0
18325,ACGTCGACTCTAGGGA,306,308,2,21,17012,0,0
18326,ACGTCGAATCTAGGGA,306,337,31,23,17178,8,0
18327,ACGTCGAATCTAGGGA,306,311,5,24,17186,0,0
18328,ACGTCGAATCTAGGGA,306,306,0,20,17357,0,0
18329,ACGTCGAATCTAGGGA,306,308,2,26,17361,0,0
18330,ACGTCGAATCGAGGGA,306,309,3,20,17363,0,0
18331,ACGTTGAATCTAGGGA,306,308,2,26,17376,0,0
18332,ACGTCGAATCTAGGGA,306,320,14,25,17378,3,0
18333,ACGTCGAATCTAGGGA,306,311,5,24,17383,0,0
18334,ACGTCGAATCTAGGGA,306,330,24,27,17387,6,0
18335,ACGTCGAATCTAGGGA,306,315,9,21,17389,1,0
18336,ACGTCGAATCTAGGGC,306,306,0,19,17390,0,0
18337,ACGTCGAAAGTAGGGA,306,329,23,23,17398,6,0
18338,ACGTCGAATCGAGGGA,306,314,8,20,17404,1,0
18339,ACGTCGAATCTAGGGA,306,314,8,26,17406,1,0
18340,ACGTCGAATCTAGGGA,306,309,3,20,17409,0,0
18341,ACGTCGAAAGTAGGGA,306,306,0,22,17410,0,0
18342,ACGTCGAATGTAGGGA,306,309,3,21,17411,0,0
18343,ACGTCGAATCTAGGGA,306,306,0,18,17537,0,0
18344,ACGTCGAATCTAGGGA,306,309,3,25,17540,0,0
18345,ACGTCGAATCTAGGGA,306,309,3,19,17543,0,0
18346,ACGTCGAATCTTGGGA,306,309,3,18,17548,0,0
18347,ACGTCGAATCTAGGGA,306,309,3,23,17550,0,0
18348,ACGTCGAATCTAGGGA,306,309,3,19,17554,0,0
18349,ACGTCGAATCTAGGGA,306,309,3,18,17560,0,0
18350,ACGTCGAATCTAGGGA,306,308,2,20,17565,0,0
18351,ACGGCGAATCTAGGGA,306,308,2,26,17572,0,0
18352,ACGTCGAATCTAGGGA,306,306,0,23,17576,0,0
18353,ACGTCGAATCTAGGGA,306,309,3,26,17577,0,0
18354,TCGTCGAATCTATTGA,306,309,3,24,17710,0,0
18355,ACGTCGAATCGAGGGA,306,309,3,21,17819,0,0
18356,ACGTCGAATGTAGGGA,306,309,3,22,17823,0,0
18357,ACGTCGAATCTAGGGA,306,309,3,27,17843,0,0
18358,ACGTCGAATCTAGGGA,306,309,3,20,17895,0,0
18359,ACGTCGAATCTAGGGA,306,309,3,19,17896,0,0
18360,ACGTCGAATCTAGGGA,306,309,3,18,17899,0,0
18361,ACGTTGAATCTAGGGA,306,309,3,26,17904,0,0
18362,ATGTCGAATCTTGGGA,306,309,3,18,17906,0,0
18363,ACGTCGAATCTAGGGA,306,309,3,28,17907,0,0
18364,ACGTCGAATCTAGGGA,306,309,3,25,17909,0,0
18365,ACGTCGAATCTAGGGA,306,309,3,24,17910,0,0
18366,ACGTCGAATCTAGGGA,306,306,0,18,17912,0,0
18367,ACGTCGAATCTAGGGA,306,309,3,26,17914,0,0
18368,ACGTCGAAAGTAGGGA,306,306,0,22,17916,0,0
18369,ACGTCGAATCTAGGGA,306,309,3,26,17918,0,0
18370,ACGGCGAATCTAGGGA,306,309,3,26,17919,0,0
18371,ACGTCGATTCTGGGGA,306,309,3,22,17920,0,0
18372,ACGTCGAAAGTAGGGA,306,309,3,23,17924,0,0
18373,ACGTCGAATCTAGGGA,306,306,0,22,17927,0,0
18374,ACGTCGGATCTAGGGA,306,309,3,22,17933,0,0
18375,ACGTCGAATCTAGGGA,306,306,0,28,17934,0,0
18376,ACGTCGAATCTAGGGA,306,309,3,23,17940,0,0
18377,ACGTCGAATCTAGGGA,307,307,0,24,16004,0,0
18378,ACGTCGAATCTAGGGA,307,313,6,17,16026,0,0
18379,ACGTCGAATCTAGGGA,307,308,1,20,16041,0,0
18380,ACGTCGAATCTAGGGA,307,312,5,20,16731,0,0
18381,ACGTCGAATCTAGGGA,307,308,1,26,16907,0,0
18382,ACGTCGATTCTGGGGA,307,308,1,21,16923,0,0
18383,ACGTCGAATCTAGGGA,307,319,12,22,16927,2,0
18384,ACGTCGATTCTGGGGA,307,320,13,20,16934,2,0
18385,ACGTCTAATCTAGGGA,307,310,3,24,16935,0,0
18386,ACGTTGAATCTAGGGA,307,316,9,26,17071,1,0
18387,ACGTCGAATCTAGGGA,307,309,2,28,17074,0,0
18388,ACGTCGATTCTGGGGA,307,369,62,21,17081,19,0
18389,ACGTCGAATGTAGGGA,307,319,12,21,17167,2,0
18390,ACGTCGAATCTAGGGA,307,335,28,22,17172,7,0
18391,ACCTCGAATCTAGGGA,307,308,1,28,17238,0,0
18392,ACGTCGAATCTAGGGA,307,317,10,21,17246,1,0
18393,ACGTCGAATCTAGGGA,307,314,7,25,17249,0,0
18394,ACGTCGAATCTAGGGA,307,310,3,28,17255,0,0
18395,ACGTCGAATCTAGGGA,307,319,12,24,17274,2,0
18396,ACATCGAATCTAGGGA,307,321,14,26,17275,3,0
18397,ACGTCGAATCTAGGGA,307,312,5,23,17437,0,0
18398,ACGTCGACTCTAGGGA,307,315,8,23,17440,1,0
18399,ACATCGAATCTAGGGA,307,315,8,26,17444,1,0
18400,ACGTTGAATCTAGGGA,307,308,1,27,17449,0,0
18401,ACGTCGAATCTAGGGA,307,308,1,26,17451,0,0
18402,ACGTCGAATCTAGGGA,307,318,11,22,17454,2,0
18403,ACGTCGAATCTAGGGA,307,328,21,21,17462,5,0
18404,TCGTCGAATCTAGGGA,307,337,30,24,17594,8,0
18405,ACGTCGAATCTAGGGT,307,312,5,21,17603,0,0
18406,ACGTCGAATCTAGGGA,307,308,1,23,17606,0,0
18407,TCGTCGAATCTAGGGA,307,308,1,24,17610,0,0
18408,ACGTCGAATCTAGAGA,307,307,0,26,17694,0,0
18409,ACGTCGAATCTAGGGA,307,332,25,24,17697,6,0
18410,ACGTCGAATCTAGGGA,307,315,8,24,17699,1,0
18411,ACGTCGAATCTAGGGA,307,311,4,25,17706,0,0
18412,ACATCGAATCTAGGGA,307,315,8,27,17707,1,0
18413,ACGTCGAATCTAGGGA,307,307,0,19,17762,0,0
18414,ACGTCGAAAGTAGGGA,307,313,6,21,17763,0,0
18415,ACATCGAATCTAGGGA,307,311,4,24,17764,0,0
18416,ACGTCGAATCTAGGGA,307,310,3,27,17768,0,0
18417,TCGTCGAATCTAGGGA,307,316,9,23,17772,1,0
18418,ACGTCGAATCTAGGGA,307,315,8,21,17774,1,0
18419,ACGTCGACTCTAGGGA,307,309,2,23,17779,0,0
18420,ACGTCGAATCTAGGGA,307,313,6,20,17787,0,0
18421,ACGTCGAATCTAGGGA,307,315,8,28,17789,1,0
18422,ACGTCGAATCTAGGGA,307,322,15,27,17793,3,0
18423,ACGTCGAATCTAGGGA,307,320,13,25,17794,2,0
18424,ACGTCGAATCGAGGGA,307,310,3,21,17795,0,0
18425,ACGTCGTATCTAGGGA,307,313,6,21,17798,0,0
18426,ACGTCGAATCTAGGGA,307,323,16,20,17799,3,0
18427,ACGTCGAATCTAGGGA,307,324,17,21,17803,4,0
18428,ACGTCGAATGTAGGGA,307,314,7,24,17806,0,0
18429,ACGTTGAATCTAGGGA,307,309,2,27,17807,0,0
18430,ACGTCGAATCTAGGGA,307,310,3,25,17809,0,0
18431,ACGTCGAATCTAGGGA,307,310,3,19,17945,0,0
18432,ACGTCGAATCTAGGGA,307,310,3,24,17947,0,0
18433,TCGTCGAATCTAGGTA,307,310,3,24,17948,0,0
18434,ACGTCGAATGTAGGGA,307,310,3,23,17951,0,0
18435,ACGTCGAATCTAGGGT,307,307,0,22,17956,0,0
18436,ACGTCGAATCTAGGGA,307,310,3,25,17959,0,0
18437,ACGTCGAATCTAGGGA,307,310,3,26,17961,0,0
18438,ACGTCGAATCTAGGGA,307,309,2,22,17964,0,0
18439,ACGTCGAATCTAGGGA,307,310,3,20,17965,0,0
18440,TCGTCGAATCTAGGGA,307,310,3,25,17967,0,0
18441,ACGTCGACTCTAGGGA,307,308,1,22,17968,0,0
18442,ACGTCGAATCTAGGGA,308,309,1,24,16426,0,0
18443,ACGTCGAATGTAGGGA,308,314,6,22,16432,0,0
18444,TCGTCGAATCTTGGGA,308,321,13,17,16768,2,0
18445,ACGTCGAATCTAGGGA,308,322,14,27,16771,3,0
18446,ACGTCGAATCTAGGGA,308,342,34,22,16780,9,0
18447,ACGTCGAATCTAGGGA,308,311,3,24,16781,0,0
18448,ACGTCGAATCTAGGGA,308,326,18,23,16803,4,0
18449,ACGTCGAATCTAGGGA,308,311,3,25,16950,0,0
18450,ACGTCGAAAGTAGGGA,308,315,7,21,17055,0,0
18451,ACGTCGAATCTAGGGA,308,310,2,25,17124,0,0
18452,ACGTCGATTCTGGGGA,308,311,3,21,17129,0,0
18453,ACGTCGAATCTAGGGA,308,311,3,24,17140,0,0
18454,ACGTCGAAAGTAGGGA,308,314,6,22,17145,0,0
18455,AAGTCGAATCTAGGGA,308,309,1,27,17157,0,0
18456,ACGTCGAATCTAGGGA,308,313,5,22,17495,0,0
18457,ACGTCGAATCTAGGGA,308,309,1,25,17498,0,0
18458,ACGTCGAATCTAGGGA,308,311,3,27,17501,0,0
18459,ACGTCGAATCTAGGGA,308,311,3,25,17645,0,0
18460,ACGTCGAATCTAGGGA,308,311,3,20,17649,0,0
18461,ACGTCGAATCTAGGGA,308,311,3,25,17656,0,0
18462,ACGTCGAATGTAGGGA,308,311,3,21,17657,0,0
18463,ACGTCGAATCGAGGGA,308,308,0,26,17660,0,0
18464,ACGTCGAATCTAGGGA,308,311,3,21,17661,0,0
18465,ACGTCGACTCTAGGGA,308,311,3,23,17662,0,0
18466,ACGTCGAATCTAGGGA,308,311,3,28,17667,0,0
18467,ACGTCGAATCTAGGGA,308,311,3,27,17668,0,0
18468,ACGTCGAATCTAGGGA,308,311,3,20,17669,0,0
18469,ACGTCGATTCTGGGGA,308,311,3,21,17673,0,0
18470,TCGTCGAATCTAGGGA,308,311,3,25,17683,0,0
18471,ACGTTGAATCTAGGGA,308,311,3,28,17685,0,0
18472,ACGTCGAATCTAGGGA,308,311,3,18,17825,0,0
18473,ACGTCGAATCTAGGGA,308,311,3,22,17827,0,0
18474,ACGTCGAATCTAGGGA,308,311,3,20,17828,0,0
18475,ACGTCGAATCTAGGGA,308,311,3,25,17830,0,0
18476,ACGTTGAATCTAGGGA,308,311,3,27,17832,0,0
18477,ACGTCGAATCTAGGGA,308,308,0,20,17833,0,0
18478,ACGTCGAATCTTGGGA,308,310,2,25,17840,0,0
18479,ACGTCGAATCTAGGGA,308,309,1,28,17842,0,0
18480,ACGTCGAATCTAGGGA,308,308,0,18,18019,0,0
18481,ACGTCGAATCTAGGGA,308,311,3,22,18023,0,0
18482,ACGTTGAATCTAGGGA,308,309,1,27,18024,0,0
18483,ACGTCGAATCTAGGGA,308,311,3,24,18025,0,0
18484,ACGTCGAATCTAGGGA,308,311,3,21,18027,0,0
18485,ACGTCGATTCTGGGGA,308,308,0,22,18030,0,0
18486,ACGTCGAATCTAGGGA,308,311,3,23,18032,0,0
18487,ACGTCGATTCTGGGGA,308,309,1,21,18033,0,0
18488,ACGTTGAATCTAGGGA,308,311,3,27,18035,0,0
18489,ACGTCGAATCTAGGGA,308,311,3,29,18036,0,0
18490,ACGTCGATTCTGGGGA,308,311,3,22,18037,0,0
18491,ACGTTGAATCTAGGGA,308,309,1,28,18038,0,0
18492,ACGTCGCATCTAGGGA,308,311,3,21,18039,0,0
18493,ACGTCGAATCTAGGGA,308,311,3,29,18042,0,0
18494,ACGTCTACTCTAGGGA,308,311,3,23,18043,0,0
18495,ACGTCGAATCTAGGGA,308,311,3,26,18045,0,0
18496,ACGTCGAATCTAGGGA,308,311,3,24,18047,0,0
18497,ACGTCGAATCTAGGGA,308,311,3,25,18050,0,0
18498,ACGTCGAATCTAGGGA,308,309,1,22,18054,0,0
18499,ACGTCGAATCTAGGGA,309,320,11,20,16474,2,0
18500,ACGTCGAATCTAGGGT,309,333,24,21,16593,6,0
18501,TCGTCGAATCTAGGGA,309,311,2,23,16667,0,0
18502,ACGTCGAATCTAGGGA,309,310,1,24,16686,0,0
18503,ACGTTGAATCTAGGGA,309,315,6,26,16697,0,0
18504,ACGTCGAATCTAGGGA,309,325,16,25,16704,3,0
18505,ACGTCGAATCTAGGGA,309,310,1,21,16839,0,0
18506,ACGTCGAATCTAGGGA,309,311,2,27,16941,0,0
18507,TCGTCGAATCTAGGGA,309,344,35,24,16956,10,0
18508,ACGTCGACTCTAGGGA,309,310,1,21,17012,0,0
18509,ACGTCGAATCTAGGGA,309,325,16,23,17178,3,0
18510,ACGTCGAATCTAGGGA,309,320,11,24,17186,2,0
18511,ACGTCGAATCTAGGGA,309,309,0,20,17357,0,0
18512,ACGTCGAATCTAGGGA,309,313,4,26,17361,0,0
18513,ACGTCGAATCGAGGGA,309,313,4,20,17363,0,0
18514,ACGTCGAATCTAGGGA,309,314,5,25,17378,0,0
18515,ACGTCGAATCTAGGGA,309,322,13,24,17383,2,0
18516,ACGTCGAATCTAGGGA,309,317,8,21,17389,1,0
18517,ACGTCGAATCGAGGGA,309,317,8,20,17404,1,0
18518,ACGTCGAATCTAGGGA,309,310,1,26,17406,0,0
18519,ACGTCGAATCTAGGGA,309,314,5,20,17409,0,0
18520,ACGTCGAATGTAGGGA,309,309,0,21,17411,0,0
18521,ACGTCGAATCTAGGGA,309,313,4,18,17537,0,0
18522,ACGTCGAATCTAGGGA,309,312,3,19,17543,0,0
18523,ACGTCGAATCTTGGGA,309,334,25,18,17548,6,0
18524,ACGTCGAATCTAGGGA,309,312,3,23,17550,0,0
18525,ACGTCGAATCTAGGGA,309,315,6,19,17554,0,0
18526,ACGTCGAATCTAGGGA,309,314,5,18,17560,0,0
18527,ACGTCGAATCTAGGGA,309,312,3,20,17565,0,0
18528,ACGGCGAATCTAGGGA,309,311,2,26,17572,0,0
18529,ACGTCGAATCTAGGGA,309,337,28,23,17576,7,0
18530,ACGTCGAATCTAGGGA,309,311,2,26,17577,0,0
18531,ACGTCGAATCGAGGGA,309,319,10,21,17819,1,0
18532,ACGTCGAATGTAGGGA,309,310,1,22,17823,0,0
18533,ACGTCGAATCTAGGGA,309,310,1,27,17843,0,0
18534,ACGTCGAATCTAGGGA,309,318,9,20,17895,1,0
18535,ACGTCGAATCTAGGGA,309,320,11,19,17896,2,0
18536,ACGTCGAATCTAGGGA,309,313,4,18,17899,0,0
18537,ACGTTGAATCTAGGGA,309,314,5,26,17904,0,0
18538,ATGTCGAATCTTGGGA,309,309,0,18,17906,0,0
18539,ACGTCGAATCTAGGGA,309,314,5,28,17907,0,0
18540,ACGTCGAATCTAGGGA,309,309,0,25,17909,0,0
18541,ACGTCGAATCTAGGGA,309,314,5,24,17910,0,0
18542,ACGTCGAATCTAGGGA,309,311,2,18,17912,0,0
18543,ACGTCGAATCTAGGGA,309,320,11,26,17914,1,0
18544,ACGTCGAAAGTAGGGA,309,310,1,22,17916,0,0
18545,ACGTCGAATCTAGGGA,309,312,3,26,17918,0,0
18546,ACGGCGAATCTAGGGA,309,310,1,26,17919,0,0
18547,ACGTCGGATCTAGGGA,309,311,2,22,17933,0,0
18548,ACGTCGAATCTAGGGA,309,309,0,28,17934,0,0
18549,ACGTCGAATCTAGGGA,309,315,6,23,17940,0,0
18550,ACGTCGAATCTAGGGA,309,323,14,18,18074,2,0
18551,ACGTCGAATCTAGGGA,309,324,15,25,18075,2,0
18552,ACGTCGAATCTAGGGA,309,310,1,26,18076,0,0
18553,ACGTCGAATCTAGGGA,309,317,8,25,18082,0,0
18554,ACGTCGAATCTAGGGA,309,315,6,24,18083,0,0
18555,ACGTCGAATCTAGGGA,309,312,3,18,18084,0,0
18556,ACGTCGAATCTAGGGA,310,310,0,24,16004,0,0
18557,ACGTCGAATCTAGGGA,310,313,3,20,16041,0,0
18558,ACGTCGAATCTAGGGA,310,310,0,20,16731,0,0
18559,ACGTTGAATCTAGGGA,310,313,3,26,17071,0,0
18560,ACGTCGAATCTAGGGA,310,317,7,28,17074,0,0
18561,ACGTCGATTCTGGGGA,310,310,0,21,17081,0,0
18562,ACGTCGAATGTAGGGA,310,316,6,21,17167,0,0
18563,ACGTCGAATCTAGGGA,310,316,6,22,17172,0,0
18564,ACGTCGAATCTAGGGA,310,317,7,21,17246,0,0
18565,ACGTCGAATCTAGGGA,310,315,5,25,17249,0,0
18566,ACGTCGAATCTAGGGA,310,312,2,28,17255,0,0
18567,ACGTCGAATCTAGGGA,310,332,22,24,17274,5,0
18568,ACATCGAATCTAGGGA,310,339,29,26,17275,8,0
18569,ACATCGAATCTAGGGA,310,327,17,26,17444,4,0
18570,ACGTTGAATCTAGGGA,310,336,26,27,17449,7,0
18571,ACGTCGAATCTAGGGA,310,316,6,26,17451,0,0
18572,ACGTCGAATCTAGGGA,310,312,2,21,17462,0,0
18573,ACGTCGAATCTAGGGT,310,313,3,21,17603,0,0
18574,ACGTCGAATCTAGGGA,310,310,0,23,17606,0,0
18575,ACGTCGAATCTAGGGA,310,311,1,26,17694,0,0
18576,ACGTCGAATCTAGGGA,310,313,3,24,17697,0,0
18577,ACGTCGAATCTAGGGA,310,313,3,24,17699,0,0
18578,ACGTCGAATCTAGGGA,310,313,3,25,17706,0,0
18579,ACATCGAATCTAGGGA,310,313,3,27,17707,0,0
18580,ACGTCGAATCTAGGGA,310,313,3,19,17762,0,0
18581,ACGTCGAAAGTAGGGA,310,313,3,21,17763,0,0
18582,ACGTCGAATCTAGGGA,310,311,1,24,17764,0,0
18583,ACGTCGAATCTAGGGA,310,313,3,27,17768,0,0
18584,ACGTCGAATCTAGGGA,310,313,3,23,17772,0,0
18585,ACGTCGACTCTAGGGA,310,312,2,23,17779,0,0
18586,ACGTCGAATCTAGGGA,310,313,3,20,17787,0,0
18587,ACGTCGAATCTAGGGA,310,313,3,28,17789,0,0
18588,ACGTCGAATCTAGGGA,310,313,3,27,17793,0,0
18589,ACGTCGAATCTAGGGA,310,313,3,25,17794,0,0
18590,ACGTCGAATCGAGGGA,310,313,3,21,17795,0,0
18591,ACGTCGAATCTAGAGA,310,313,3,20,17799,0,0
18592,ACGTCGAATCTAGGGA,310,310,0,21,17803,0,0
18593,ACGTTGAATCTAGGGA,310,313,3,27,17807,0,0
18594,ACGTCGAATCTAGGGA,310,313,3,25,17809,0,0
18595,TCGTCGAATCTAGGGA,310,313,3,24,17948,0,0
18596,ACGTCGAATGTAGGGA,310,313,3,23,17951,0,0
18597,ACGTCGAATCTAGGGA,310,311,1,25,17959,0,0
18598,ACGTCGAATCTAGGGA,310,313,3,26,17961,0,0
18599,ACGTCGAATCTAGGGA,310,310,0,22,17964,0,0
18600,ACGTCGACTCTAGGGA,310,310,0,22,17968,0,0
18601,ACGTCGACTCTAGGGA,310,313,3,24,18058,0,0
18602,ACGTTGAATCTAGGGA,310,313,3,28,18060,0,0
18603,ACGTCGAATCTAGGGA,310,313,3,22,18063,0,0
18604,ACGTCGAAAGTAGGGA,310,313,3,22,18064,0,0
18605,TCGTCGAATCTAGGGA,310,313,3,25,18065,0,0
18606,ACGTCGAATCTAGGGA,310,313,3,24,18067,0,0
18607,ACGTCGAATCTAGGGA,310,311,1,25,18068,0,0
18608,ACGTCGAATCTAGGGT,310,313,3,23,18069,0,0
18609,ACGTCGAATCTAGGGA,310,313,3,23,18134,0,0
18610,ACGTCGAATCTAGGGT,310,313,3,21,18137,0,0
18611,ACGTCGAATCTAGGGA,310,313,3,23,18139,0,0
18612,TCGTCGAATCTAGGGA,310,313,3,24,18142,0,0
18613,ACGTCGAATCTAGGGA,310,313,3,26,18144,0,0
18614,ACGTTGAATCTAGGGA,310,313,3,27,18145,0,0
18615,ACCTCGAATCTAGGGA,310,310,0,26,18146,0,0
18616,ACGTCGAATCGAGGGA,310,310,0,21,18153,0,0
18617,ACGTCGAATCTAGGGA,310,310,0,24,18154,0,0
18618,ACGTCGAATCTAGGGA,310,313,3,25,18155,0,0
18619,ACGTCGAATGTAGGGA,310,313,3,24,18159,0,0
18620,ACGTCGAATCTAGGGA,310,313,3,24,18163,0,0
18621,ACGTCGAATCTAGGGA,310,313,3,22,18166,0,0
18622,ACGTCGAATGTAGGGA,310,313,3,23,18168,0,0
18623,ACGTCGAATCGAGGGA,310,313,3,21,18170,0,0
18624,ACGTCGAATCGAGGGA,310,313,3,25,18177,0,0
18625,ACGTCGAATCTAGGGA,310,313,3,20,18182,0,0
18626,ACGTCGAATCTAGGGA,310,313,3,19,18184,0,0
18627,ACGTCGAATCTAGGGA,310,313,3,27,18185,0,0
18628,ACGTCGAATCTAGGGA,310,313,3,21,18186,0,0
18629,ACGTCGAATCTAGGGA,310,313,3,27,18187,0,0
18630,ACGTCGAATCTAGGGA,311,315,4,24,16426,0,0
18631,ACGTCGAATGTAGGGA,311,334,23,22,16432,6,0
18632,ACGTCGAATCTTGGGA,311,314,3,17,16768,0,0
18633,ACGTCGAATCTAGGGA,311,315,4,27,16771,0,0
18634,ACGTCGAATCTAGGGA,311,313,2,23,16803,0,0
18635,ACGTCGAATCTAGGGA,311,317,6,25,16950,0,0
18636,ACGTCGATTCTGGGGA,311,316,5,21,17129,0,0
18637,ACGTCGAATCTAGGGA,311,318,7,22,17495,0,0
18638,ACGTCGAATCTAGGGA,311,327,16,25,17498,3,0
18639,ACGTCGAATCTAGGGA,311,314,3,27,17501,0,0
18640,ACGTCGAATCTAGGGA,311,314,3,25,17645,0,0
18641,ACGTCGAATCTAGGGA,311,311,0,20,17649,0,0
18642,ACGTCCAATGTAGGGA,311,317,6,21,17657,0,0
18643,ACGTCGAATCGAGGGA,311,318,7,26,17660,0,0
18644,ACGTCGAATCTAGGGA,311,311,0,21,17661,0,0
18645,ACGTCGACTCTAGGGA,311,325,14,23,17662,3,0
18646,ACGTCGAATCTAGGGA,311,316,5,28,17667,0,0
18647,ACGTTGAATCTAGGGA,311,316,5,28,17685,0,0
18648,ACGTCGAATCTAGGGA,311,321,10,18,17825,1,0
18649,ACGTCGAATCTAGGGA,311,316,5,22,17827,0,0
18650,ACGTTGAATCTAGGGA,311,319,8,27,17832,1,0
18651,ACGTCGAATCTAGGGA,311,314,3,20,17833,0,0
18652,ACGTCGAATCTTGGGA,311,323,12,25,17840,2,0
18653,ACGTCGAATCTAGGGA,311,311,0,18,18019,0,0
18654,ACGTCGAATCTAGGGA,311,323,12,22,18023,2,0
18655,ACGTTGAATCTAGGGA,311,321,10,27,18024,1,0
18656,ACGTCGAATCTAGGGA,311,323,12,24,18025,2,0
18657,ACGTCGATTCTGGGGA,311,314,3,22,18030,0,0
18658,ACGTCGAATCTAGGGA,311,311,0,29,18036,0,0
18659,ACGTCGATTCTGGGGA,311,314,3,22,18037,0,0
18660,ACGTTGAATCTAGGGA,311,344,33,28,18038,9,0
18661,ACGTCGCATCTAGGGA,311,311,0,21,18039,0,0
18662,ACGTCGAATCTAGGGA,311,333,22,29,18042,5,0
18663,ACGTCTACTCTAGGGA,311,312,1,23,18043,0,0
18664,ACGTCGAATCTAGGGA,311,315,4,26,18045,0,0
18665,ACGTCGAATCTAGGGA,311,319,8,24,18047,1,0
18666,ACGTCGAATCTAGGGA,311,365,54,25,18050,16,0
18667,ACGTCGAATCTAGGGA,311,311,0,22,18054,0,0
18668,ACGTCGATTCCGGGGA,311,313,2,21,18202,0,0
18669,ACGTTGAATCTAGGGA,311,312,1,27,18204,0,0
18670,ACGTCGACTCTAGGGA,311,343,32,24,18311,9,0
18671,ACGTCGAATCTAGGGA,311,315,4,21,18312,0,0
18672,ACGTCGAATCTAGGGA,312,326,14,20,16474,3,0
18673,TCGTCGAATCTAGGGA,312,333,21,23,16667,6,0
18674,ACGTCGAATCTAGGGA,312,327,15,24,16686,4,0
18675,ACGTTGAATCTAGGGA,312,336,24,26,16697,7,0
18676,ACGTCGAATCTAGGGA,312,312,0,25,16704,0,0
18677,ACGTCGAATCTAGGGA,312,314,2,21,16839,0,0
18678,ACGTCGAATCTAGGGA,312,316,4,27,16941,0,0
18679,ACGTCGACTCTAGGGA,312,326,14,21,17012,3,0
18680,ACGTCGAATCTAGGGA,312,342,30,24,17186,9,0
18681,ACGTCGAATCTAGGGA,312,358,46,20,17357,14,0
18682,ACGTCGAATCTAGGGA,312,317,5,26,17361,0,0
18683,ACGTCGAATCTAGGGA,312,329,17,24,17383,4,0
18684,ACGTCGAATCTAGGGA,312,320,8,21,17389,1,0
18685,ACGTCGAATCGAGGGA,312,334,22,20,17404,6,0
18686,ACGTCGAATCTAGGGA,312,325,13,26,17406,3,0
18687,ACGTCGAATCTAGGGA,312,318,6,20,17409,1,0
18688,ACGTCGAATGTAGGGA,312,317,5,21,17411,0,0
18689,ACGTCGAATCTAGGGA,312,312,0,18,17537,0,0
18690,ACGTCGAATCTTGGGA,312,318,6,18,17548,1,0
18691,ACGTCGAATCTAGGGA,312,317,5,23,17550,0,0
18692,ACGTCGAATCTAGGGA,312,317,5,19,17554,0,0
18693,ACGTCGAATCTAGGGA,312,316,4,18,17560,0,0
18694,ACGTCGAATCTAGGGA,312,318,6,20,17565,0,0
18695,ACGGCGAATCTAGGGA,312,317,5,26,17572,0,0
18696,ACGTCGAATCTAGGGA,312,312,0,23,17576,0,0
18697,ACGTCGAATCTAGGGA,312,328,16,26,17577,3,0
18698,ACGTCGAATCGAGGGA,312,314,2,21,17819,0,0
18699,ACGTCGAATGTAGGGA,312,313,1,22,17823,0,0
18700,ACGTCGAATCTAGGGA,312,315,3,27,17843,0,0
18701,ACGTCGAATCTAGGGA,312,315,3,20,17895,0,0
18702,ACGTCGAATCTAGGGA,312,342,30,19,17896,8,0
18703,ACGTCGAATCTAGGGA,312,337,25,18,17899,6,0
18704,ATGTCGAATCTTGGGA,312,313,1,18,17906,0,0
18705,ACGTCGAATCTAGGGA,312,317,5,28,17907,0,0
18706,ACGTCGAATCTAGGGA,312,323,11,25,17909,2,0
18707,ACGTCGAATCTAGGGA,312,313,1,18,17912,0,0
18708,ACGTCGAATCTAGGGA,312,322,10,26,17914,1,0
18709,ACGTCGAATCTAGGGA,312,323,11,26,17918,2,0
18710,ACGGCGAATCTAGGGA,312,316,4,26,17919,0,0
18711,ACGTCGGATCTAGGGA,312,312,0,22,17933,0,0
18712,ACGTCGAATCTAGGGA,312,329,17,23,17940,4,0
18713,ACGTCGAATCTAGGGA,312,318,6,18,18074,0,0
18714,ACGTCGAATCTAGGGA,312,328,16,25,18075,3,0
18715,ACGTCGAATCTAGGGA,312,322,10,25,18082,1,0
18716,ACGTCGAATCTAGGGA,312,341,29,24,18083,8,0
18717,ACGGCGAATCTAGGGA,312,317,5,27,18188,0,0
18718,ACGTCCAATCTAGGGA,312,325,13,20,18259,2,0
18719,ACGTCGAATCTTGGGA,312,312,0,18,18264,0,0
18720,ACGTCGAATCTAGGGA,312,315,3,25,18267,0,0
18721,ACGTCGAATCTAGGGA,312,333,21,24,18268,5,0
18722,ACGTCGAATCTAGGGA,312,320,8,26,18270,1,0
18723,ACGTCGAGTCTAGGGA,312,335,23,27,18271,6,0
18724,ACGTCGAAAGTAGGGA,312,312,0,22,18272,0,0
18725,ACGTCGATTCTGGGGA,312,332,20,22,18274,5,0
18726,ACGTCGAATCTAGGGA,312,316,4,25,18279,0,0
18727,ACGTCGAATCTAGGGA,312,340,28,23,18280,7,0
18728,ACGTCGAATCTAGGGA,312,332,20,26,18281,5,0
18729,ACGTCGAATCTAGGGA,312,315,3,26,18286,0,0
18730,ACGTCGAATCGAGGGA,312,315,3,27,18288,0,0
18731,ACGTCGAATCTAGGGA,312,315,3,22,18289,0,0
18732,ACGTCGAATCTAGGGA,312,315,3,24,18294,0,0
18733,ACGTCGATTCTGGGGA,312,314,2,22,18295,0,0
18734,ACGTCGAATGTAGGGA,312,315,3,25,18296,0,0
18735,ACGTTGAATCTAGGGA,312,315,3,29,18299,0,0
18736,ACGTCGAATCTAGGGA,312,313,1,23,18301,0,0
18737,ACGTCGAATCTAGGGA,312,312,0,21,18302,0,0
18738,ACGTTGAATCTAGGGA,312,315,3,28,18304,0,0
18739,TCGTCGAATCTAGGGA,312,315,3,21,18305,0,0
18740,ACGTCGAATCTAGGGA,312,312,0,24,18309,0,0
18741,ACGTCGAATCTAGGGA,312,315,3,29,18310,0,0
18742,ACGTTGATTCTAGGGA,313,317,4,26,17071,0,0
18743,ACGTCGAATCTAGGGA,313,332,19,28,17074,4,0
18744,ACGTCGATTCTGGGGA,313,326,13,21,17081,2,0
18745,ACGTCGAATGTAGGGA,313,331,18,21,17167,4,0
18746,ACGTCGAATCTAGGGA,313,326,13,22,17172,2,0
18747,ACGTCGAATCTAGGGA,313,332,19,21,17246,4,0
18748,ACGTCGAATCTAGGGA,313,319,6,25,17249,0,0
18749,ACGTCGAATCTAGGGA,313,313,0,28,17255,0,0
18750,ACGTCGAATCTAGGGA,313,313,0,24,17274,0,0
18751,ACATCGAATCTAGGGA,313,319,6,26,17275,0,0
18752,ACATCGAATCTAGGGA,313,314,1,26,17444,0,0
18753,ACGTCGAATCTAGGGA,313,314,1,26,17451,0,0
18754,ACGTCGAATCTAGGGA,313,313,0,21,17462,0,0
18755,ACGTCGAATCTAGGGT,313,326,13,21,17603,2,0
18756,ACGTCGAATCTAGGGA,313,316,3,26,17694,0,0
18757,ACGTCGAATCTAGGGA,313,318,5,24,17697,0,0
18758,ACGTCGAATCTAGGGA,313,316,3,24,17699,0,0
18759,ACGTCGAATCTAGGGA,313,313,0,25,17706,0,0
18760,ACGTCGAATCTAGGGA,313,316,3,19,17762,0,0
18761,ACGTCGAAAGTAGGGA,313,313,0,21,17763,0,0
18762,ACGTCGAATCTAGGGA,313,316,3,24,17764,0,0
18763,ACGTCGAATCTAGGGA,313,316,3,23,17772,0,0
18764,ACGTCGACTCTAGGGA,313,316,3,23,17779,0,0
18765,ACGTCGAATCTAGGGG,313,316,3,20,17787,0,0
18766,ACGTCGAATCTAGGGA,313,316,3,28,17789,0,0
18767,ACGTCGAATCTAGGGA,313,316,3,25,17794,0,0
18768,ACGTCGAATCGAGGGA,313,316,3,21,17795,0,0
18769,ACGTCGAATCTAGGGA,313,316,3,20,17799,0,0
18770,ACGTCGAATCTAGGGA,313,313,0,21,17803,0,0
18771,ACGTCGAATCTAGGGA,313,316,3,25,17809,0,0
18772,ACGTCGAATGTAGGGA,313,316,3,23,17951,0,0
18773,ACGTCGAATCTAGGGA,313,316,3,22,17964,0,0
18774,ACGTCGACTCTAGGGA,313,316,3,22,17968,0,0
18775,ACGTCGACTCTAGGGA,313,315,2,24,18058,0,0
18776,ACGTTGAATCTAGGGA,313,316,3,28,18060,0,0
18777,ACGTCGAATCTAGGGA,313,316,3,22,18063,0,0
18778,ACGTCGAAAGTAGGGA,313,316,3,22,18064,0,0
18779,TCGTCGAATCTAGGGA,313,316,3,25,18065,0,0
18780,ACGTCGAATCTAGGGT,313,315,2,23,18069,0,0
18781,ACGTCGAATCTAGGGA,313,316,3,23,18134,0,0
18782,ACGTCGAATCTAGGGT,313,316,3,21,18137,0,0
18783,ACGTCGAATCTAGGGA,313,316,3,23,18139,0,0
18784,TCGTCGAATCTAGGGA,313,316,3,24,18142,0,0
18785,ACGTCGAATCTAGGGA,313,316,3,26,18144,0,0
18786,ACGTTGAATCTAGGGA,313,314,1,27,18145,0,0
18787,ACCTCGAATCTAGGGA,313,315,2,26,18146,0,0
18788,ACGTCGAATCTAGGGA,313,316,3,24,18154,0,0
18789,ACGTCGAATCTAGGGA,313,316,3,25,18155,0,0
18790,ACGTCGAATGTAGGGA,313,316,3,24,18159,0,0
18791,ACGTCGAATCTAGGGA,313,316,3,22,18166,0,0
18792,ACGTCGAATGTAGGGA,313,313,0,23,18168,0,0
18793,ACGTCGAATCGAGGGA,313,315,2,21,18170,0,0
18794,ACGTCGAATCTAGGGA,313,316,3,20,18182,0,0
18795,ACGTCGAATCTAGGGA,313,313,0,19,18184,0,0
18796,ACGTCGAATCTAGGGA,313,316,3,27,18185,0,0
18797,ACGTCGAATCTAGGGT,313,316,3,22,18314,0,0
18798,TCGTCGAATCTAGGGA,313,315,2,24,18316,0,0
18799,ACGTCGAATCTAGGGA,313,316,3,25,18317,0,0
18800,ACGTCGAATCTAGGGA,313,313,0,22,18321,0,0
18801,ACGTCGAATCTAGGGA,313,316,3,20,18322,0,0
18802,ACGTCGAATCTAGGGA,313,316,3,24,18326,0,0
18803,ACGTCGAATCTAGGGA,313,316,3,26,18332,0,0
18804,ACGTCGAATCTAGGGA,313,316,3,28,18334,0,0
18805,ACGTCGAATCTAGGGA,313,316,3,22,18335,0,0
18806,ACGTCGAAAGTAGGGA,313,316,3,24,18337,0,0
18807,ACGTCGAATCGAGGGA,313,316,3,21,18338,0,0
18808,ACGTCGAATCTAGGGA,313,314,1,27,18339,0,0
18809,ACGTCGATTGTAGGGA,314,319,5,22,16432,0,0
18810,ACGTCGAATCTTGGGA,314,318,4,17,16768,0,0
18811,ACGTCGAATCTAGGGA,314,322,8,27,16771,1,0
18812,ACGTCGAATCTAGGGA,314,349,35,23,16803,10,0
18813,ACGTCGAATCTAGGGA,314,317,3,25,16950,0,0
18814,ACGTCGATTCTGGGGA,314,323,9,21,17129,1,0
18815,ACGTCGAATCTAGGGA,314,326,12,22,17495,2,0
18816,ACGTCGAATCTAGGGA,314,314,0,25,17498,0,0
18817,ACGTCGAATCTAGGGA,314,317,3,25,17645,0,0
18818,ACGTCGAATCGAGGGA,314,317,3,20,17649,0,0
18819,ACGTCGAATCGAGGGA,314,316,2,26,17660,0,0
18820,ACGTCGAATCTAGGGA,314,316,2,21,17661,0,0
18821,ACGTCGACTCTAGGGA,314,316,2,23,17662,0,0
18822,ACGTCGAATCTAGGGA,314,319,5,22,17827,0,0
18823,ACGTTGAATCTAGGGA,314,327,13,27,17832,2,0
18824,ACGTCGAATCTAGGGA,314,322,8,20,17833,1,0
18825,ACGTCGAATCTTGGGA,314,363,49,25,17840,14,0
18826,ACGTCGAATCTAGGGA,314,324,10,18,18019,1,0
18827,ACGTCGAATCTAGGGA,314,316,2,22,18023,0,0
18828,ACGTTGAATCTAGGGA,314,314,0,27,18024,0,0
18829,ACGTCGAATCTAGGGA,314,314,0,24,18025,0,0
18830,ACGTCGATTCTGGGGA,314,344,30,22,18030,8,0
18831,ACGTCGAATCTAGGGA,314,325,11,29,18036,2,0
18832,ACGTTGAATCTAGGGA,314,316,2,28,18038,0,0
18833,ACGTCGCATCTAGGGA,314,331,17,21,18039,4,0
18834,ACGTCTACTCTAGGGA,314,342,28,23,18043,7,0
18835,ACGTCGAATCTAGGGA,314,321,7,24,18047,0,0
18836,ACGTCGAATCTAGGGA,314,316,2,25,18050,0,0
18837,ACGTCGAATCTAGGGA,314,320,6,22,18054,0,0
18838,ACGTCGATTCCGGGGA,314,326,12,21,18202,2,0
18839,ACGTTGAATCTAGGGA,314,318,4,27,18204,0,0
18840,ACGTCGAATCTAGGGA,314,342,28,24,18311,7,0
18841,ACGTCGAATCTAGGGA,314,330,16,23,18383,3,0
18842,ACGTCGATTCTGGGGA,314,337,23,21,18384,6,0
18843,ACGTTGAATCTAGGGA,314,318,4,27,18386,0,0
18844,ACGTCGATTCTGGGGA,314,317,3,22,18388,0,0
18845,ACGTCGAATGTAGGGA,314,339,25,22,18389,6,0
18846,ACGTCGAATCTAGGGA,314,329,15,23,18390,3,0
18847,ACGTCGAATCTAGGGA,314,325,11,22,18392,2,0
18848,ACGTCGAATCTAGGGA,314,322,8,25,18395,1,0
18849,ACATCGAATCTAGGGA,314,324,10,27,18396,1,0
18850,ACGTCGACTCTAGGGA,314,318,4,24,18398,0,0
18851,ACATCGAATCTAGGGA,314,322,8,27,18399,1,0
18852,ACGTCGAATCTAGGGA,314,315,1,23,18402,0,0
18853,ACGTCGAATCTAGGGA,314,333,19,22,18403,4,0
18854,TCGTCGAATCTAGGGA,314,339,25,25,18404,6,0
18855,ACGTCGAATCTAGGGA,314,316,2,25,18409,0,0
18856,ACGTCGAATCTAGGGA,314,326,12,25,18410,2,0
18857,ACATCGAATCTAGGGA,314,317,3,28,18412,0,0
18858,TCGTCGAATCTAGGGA,314,318,4,24,18417,0,0
18859,ACGTCGAATCTAGGGA,314,316,2,22,18418,0,0
18860,ACGTCGAATCTAGGGA,314,330,16,29,18421,3,0
18861,ACGTCGAATCTAGGGA,314,314,0,28,18422,0,0
18862,ACGTCGAATCTAGGGA,314,318,4,26,18423,0,0
18863,ACGTCGAATCTAGGGA,314,328,14,21,18426,3,0
18864,ACGTCGAATCTAGGGA,314,322,8,22,18427,1,0
18865,ACGTCGAATCTAGGGA,315,316,1,20,16474,0,0
18866,TCGTCGAATCTAGGGA,315,321,6,23,16667,1,0
18867,ACGTCGAATCTAGGGA,315,326,11,24,16686,2,0
18868,ACGTCGAATCTAGGGA,315,316,1,27,16941,0,0
18869,ACGTCGACTCTAGGGA,315,327,12,21,17012,3,0
18870,ACGTCGAATCTAGGGA,315,320,5,24,17186,0,0
18871,ACCTCGAATCTAGGGA,315,316,1,20,17357,0,0
18872,ACGTCGAATCTAGGGA,315,317,2,26,17361,0,0
18873,ACGTCGAATCTAGGGA,315,315,0,24,17383,0,0
18874,ACGTCGAATCTAGGGA,315,327,12,20,17409,3,0
18875,ACGTCGAATGTAGGGA,315,324,9,21,17411,2,0
18876,ACGTCGAATCTAGGGA,315,315,0,18,17537,0,0
18877,ACGTCGAATCTTGGGA,315,317,2,18,17548,0,0
18878,ACGTCGAATCTAGGGA,315,327,12,23,17550,3,0
18879,ACGTCGAATCTAGGGA,315,315,0,19,17554,0,0
18880,ACGTCGAATCTAGGGA,315,317,2,20,17565,0,0
18881,ACGTCGAATCTAGGGA,315,317,2,23,17576,0,0
18882,ACGTCGAATCTAGGGA,315,319,4,26,17577,0,0
18883,ACGTCGAATGTAGGGA,315,322,7,22,17823,1,0
18884,ACGTCGAATCTAGGGA,315,324,9,27,17843,2,0
18885,ACGTCGAATCTAGGGA,315,323,8,20,17895,1,0
18886,ACGTCGAATCTAGGGA,315,329,14,19,17896,3,0
18887,ATGTCGAATCTTGGGA,315,325,10,18,17906,1,0
18888,ACGTCGAATCTAGGGA,315,316,1,25,17909,0,0
18889,ACGTCGAATCTAGGGA,315,316,1,26,17914,0,0
18890,ACGTCGAATCTAGGGA,315,318,3,26,17918,0,0
18891,ACGGCGAATCTAGGGA,315,321,6,26,17919,0,0
18892,ACGTCGGATCTAGGGA,315,317,2,22,17933,0,0
18893,ACGTCGAATCTAGGGA,315,320,5,23,17940,0,0
18894,ACGTCGAATCTAGGGA,315,332,17,18,18074,4,0
18895,ACGTCGAATCTAGGGA,315,335,20,25,18082,5,0
18896,ACGTCGAATCTAGGGA,315,316,1,24,18083,0,0
18897,ACGTCCAATCTAGGGA,315,333,18,20,18259,4,0
18898,ACGTCGAATCTAGGGA,315,322,7,24,18268,0,0
18899,ACGTCGAATCTAGGGA,315,317,2,26,18270,0,0
18900,ACGTCGAGTCTAGGGA,315,326,11,27,18271,2,0
18901,ACGTCGAAAGTAGGGA,315,318,3,22,18272,0,0
18902,ACGTCGAATCTAGGGA,315,323,8,25,18279,1,0
18903,ACGTCGAATCTAGGGA,315,318,3,26,18281,0,0
18904,ACGTCGAATCGAGGGA,315,324,9,27,18288,1,0
18905,ACGTCGAATCTAGGGA,315,318,3,22,18289,0,0
18906,ACGTCGAATCTAGGGA,315,318,3,24,18294,0,0
18907,ACGTCGATTCTGGGGA,315,315,0,22,18295,0,0
18908,ACGTCGAATGTAGGGA,315,317,2,25,18296,0,0
18909,ACGTTGAATCTAGGGA,315,318,3,29,18299,0,0
18910,ACGTCGAATCTAGGGA,315,317,2,23,18301,0,0
18911,ACGTCGAATCTAGGGA,315,318,3,21,18302,0,0
18912,ACGTTGAATCTAGGGA,315,318,3,28,18304,0,0
18913,ACGTCGAATCTAGGGA,315,318,3,21,18305,0,0
18914,ACGTCGAATCTAGGGA,315,317,2,24,18309,0,0
18915,ACGTCGAATCTAGGGA,315,318,3,29,18310,0,0
18916,TCGTCGAATCTTGGGA,315,318,3,18,18444,0,0
18917,ACGTCGAATCTAGGGA,315,318,3,28,18445,0,0
18918,ACGTCGAATCTAGGGA,315,318,3,23,18446,0,0
18919,ACGTCGAATCTAGGGA,315,318,3,24,18448,0,0
18920,ACGTCGAATCTAGGGA,316,322,6,28,17074,0,0
18921,ACGTCGATTCTGGGGA,316,318,2,21,17081,0,0
18922,ACGTCGAATCTAGGGA,316,328,12,21,17246,2,0
18923,ACGTCGAATCTAGGGA,316,328,12,28,17255,2,0
18924,ACGTCGAATCTAGGAA,316,324,8,24,17274,1,0
18925,ACATCGAATCTAGGGA,316,327,11,26,17275,2,0
18926,ACGTCGAATCTAGGGA,316,317,1,26,17451,0,0
18927,ACGTCGAATCTAGGGA,316,322,6,21,17462,0,0
18928,ACGTCGAATCTAGGGT,316,316,0,21,17603,0,0
18929,ACGTCGAATCTAGGGA,316,337,21,26,17694,5,0
18930,ACGTCGAATCTAGGGA,316,320,4,24,17699,0,0
18931,ACGTCGAATCTAGGGA,316,318,2,25,17706,0,0
18932,ACGTCGAATCTAGGGA,316,366,50,19,17762,15,0
18933,ACGTCGAAAGTAGGGA,316,329,13,21,17763,2,0
18934,ACGTCGACTCTAGGGA,316,318,2,23,17779,0,0
18935,ACGTCGAATCTAGGGA,316,326,10,20,17787,1,0
18936,ACGTCGAATCTAGGGA,316,318,2,28,17789,0,0
18937,ACGTCGAATCTAGGGA,316,330,14,21,17803,3,0
18938,ACGTCGAATGTAGGGA,316,317,1,23,17951,0,0
18939,ACGTCGAATCTAGGGA,316,319,3,22,17964,0,0
18940,ACGTCGACTCTAGGGA,316,316,0,22,17968,0,0
18941,ACGTCGACTCTAGGGA,316,331,15,24,18058,3,0
18942,ACGTTGAATCTAGGGA,316,331,15,28,18060,3,0
18943,ACGTCGAATCTAGGGA,316,336,20,22,18063,5,0
18944,ACGTCGAAAGTAGGGA,316,317,1,22,18064,0,0
18945,TCGTCGAATCTAGGGA,316,344,28,25,18065,7,0
18946,ACGTCGAATCTAGGGA,316,318,2,23,18134,0,0
18947,ACGTCGAATCTAGGGT,316,329,13,21,18137,2,0
18948,ACGTCGAATCTAGGGA,316,317,1,23,18139,0,0
18949,TCGTCGAATCTAGGGA,316,317,1,24,18142,0,0
18950,ACGTCGAATCTAGGGA,316,319,3,26,18144,0,0
18951,ACGTTGAATCTAGGGA,316,321,5,27,18145,0,0
18952,ACCTCGAATCTAGGGA,316,322,6,26,18146,0,0
18953,ACGTCGAATCTAGGGA,316,319,3,24,18154,0,0
18954,ACGTCGAATCTAGGGA,316,319,3,25,18155,0,0
18955,ACGTCGAATCTAGGGA,316,320,4,22,18166,0,0
18956,ACGTCGAATGTAGGGA,316,323,7,23,18168,0,0
18957,ACGTCGAATCTAGGGA,316,318,2,19,18184,0,0
18958,ACGTCGAATCTAGGGA,316,324,8,27,18185,1,0
18959,ACGTCGAATCTAGGGT,316,318,2,22,18314,0,0
18960,TCGTCGAATCTAGGGA,316,331,15,24,18316,3,0
18961,ACGTCGAATCTAGGGA,316,318,2,25,18317,0,0
18962,ACGTCGAATCTAGGGA,316,319,3,22,18321,0,0
18963,ACGTCGAATCTAGGGA,316,319,3,24,18326,0,0
18964,ACGTCGAATCTAGGGA,316,318,2,26,18332,0,0
18965,ACGGCGAATCTAGGGA,316,316,0,28,18334,0,0
18966,ACGTCGAAAGTAGGGA,316,319,3,24,18337,0,0
18967,ACGTCGAATCTAGGGA,316,319,3,21,18499,0,0
18968,ACGTCGAATCTAGGGT,316,319,3,22,18500,0,0
18969,ACGTCGAATCTAGGGA,316,319,3,26,18504,0,0
18970,ACGTCGAATCTAGGGA,316,319,3,25,18507,0,0
18971,ACGTCGAATCTAGGGA,316,316,0,24,18509,0,0
18972,ACGTCGAAACTAGGGA,316,319,3,25,18510,0,0
18973,ACGTCGAATCTAGGGA,316,319,3,25,18515,0,0
18974,ACGTCGAATCTAGGGA,316,319,3,22,18516,0,0
18975,ACGTCGAATCGAGGGA,316,319,3,21,18517,0,0
18976,ACGTCGAATCTTGGGA,316,318,2,19,18523,0,0
18977,ACGTCGAATCTAGGGA,316,319,3,24,18529,0,0
18978,ACGTCGAATCGAGGGA,316,319,3,22,18531,0,0
18979,ACGTCGAATCTAGGGA,316,317,1,21,18534,0,0
18980,ACGTCGAATCTAGGGA,316,319,3,20,18535,0,0
18981,ACGTCGAATGTAGGGA,317,330,13,22,16432,2,0
18982,ACGTCGAATCTTGGGA,317,318,1,17,16768,0,0
18983,ACGTCGAATCTAGGGA,317,323,6,23,16803,0,0
18984,ACGTCGATTCTGGGGA,317,322,5,21,17129,0,0
18985,ACGTCGAATCTAGGGA,317,334,17,25,17498,4,0
18986,ACGTCGAATCTAGGGA,317,319,2,21,17661,0,0
18987,ACGTCGAATCTAGGGA,317,317,0,22,17827,0,0
18988,ACGTCGAATCTTGGGA,317,319,2,25,17840,0,0
18989,ACGTCGAATCTAGGGA,317,324,7,22,18023,0,0
18990,ACGTTGAATCTAGGGA,317,321,4,27,18024,0,0
18991,ACGTCGATTCTGGGGA,317,317,0,22,18030,0,0
18992,ACGTCGAATCTAGGGA,317,319,2,29,18036,0,0
18993,ACGTTGATTCTAGGGA,317,323,6,28,18038,0,0
18994,ACGTCTACTCTAGGGA,317,333,16,23,18043,3,0
18995,ACGTCGAATCTAGGGA,317,325,8,22,18054,1,0
18996,ACGTTGAATCTAGGGA,317,320,3,27,18204,0,0
18997,ACGTCGAATCTAGGGA,317,332,15,24,18311,3,0
18998,ACGTCGAATCTAGGGA,317,320,3,23,18383,0,0
18999,ACGTCGATTCTGGGGA,317,317,0,21,18384,0,0
19000,ACGTCGATTCTGGGGA,317,317,0,22,18388,0,0
19001,ACGTCGAATGTAGGGA,317,318,1,22,18389,0,0
19002,ACGTCGAATCTAGGGA,317,332,15,23,18390,3,0
19003,ACGTCGAATCTAGGGA,317,321,4,25,18395,0,0
19004,ACATCGAATCTAGGGA,317,323,6,27,18396,0,0
19005,ACGTCGAATCTAGGGA,317,344,27,23,18402,7,0
19006,ACGTCGAATCTAGGGA,317,320,3,22,18403,0,0
19007,TCGTCGAATCTAGGGA,317,334,17,25,18404,4,0
19008,ACGTCGAATCTAGGGA,317,317,0,25,18409,0,0
19009,ACGTCGAATCTAGGGA,317,319,2,28,18422,0,0
19010,ACGTCGAATCTAGGGA,317,319,2,26,18423,0,0
19011,ACGTCGAATCTAGGGA,317,326,9,21,18426,1,0
19012,ACGTCGAATCTAGGGA,317,332,15,22,18427,3,0
19013,ACGTCGAATCTAGGGA,317,317,0,25,18567,0,0
19014,ACATCGAATCTAGGGA,317,375,58,27,18568,17,0
19015,ACATCGAATCTAGGGA,317,319,2,27,18569,0,0
19016,ACGTTGAATCTAGGGA,317,321,4,28,18570,0,0
19017,ACGTCGAATCTAGGGA,317,336,19,21,18672,4,0
19018,TCGTCGAATCTAGGGA,317,319,2,24,18673,0,0
19019,ACGTCGAATCTAGGGA,317,318,1,25,18674,0,0
19020,ACGTTGAATCTAGGGA,317,324,7,27,18675,0,0
19021,ACGTCGACTCTAGGGA,317,338,21,22,18679,5,0
19022,ACGTCGAATCTAGGGA,317,323,6,25,18680,0,0
19023,ACGTCGAATCTAGGGA,317,318,1,21,18681,0,0
19024,ACGTCGAATCTAGGGA,317,325,8,25,18683,1,0
19025,ACGTCGAATCTAGGGA,317,330,13,22,18684,2,0
19026,ACGTCGAATCGAGGGA,317,317,0,21,18685,0,0
19027,ACGTCGAATCTAGGGA,317,320,3,27,18686,0,0
19028,ACGTCGAATCTAGGGA,317,320,3,21,18687,0,0
19029,ACGTCGAATCTTGGGA,317,320,3,19,18690,0,0
19030,ACGTCGAATCTAGGGA,318,324,6,20,16474,0,0
19031,TCGTCGAATCTAGGGA,318,321,3,23,16667,0,0
19032,ACGTCGAATCTAGGGA,318,324,6,24,16686,0,0
19033,ACGTCGAATCTAGGGA,318,319,1,27,16941,0,0
19034,ACGTCGACTCTAGGGA,318,322,4,21,17012,0,0
19035,ACGTCGAATCTAGGGA,318,329,11,24,17186,2,0
19036,ACGTCGAATCTAGGGA,318,323,5,26,17361,0,0
19037,ACGTCGAATCTAGGGA,318,322,4,24,17383,0,0
19038,ACGTCGAATCTAGGGA,318,326,8,20,17409,1,0
19039,ACGTCGAATGTAGGGA,318,328,10,21,17411,1,0
19040,ACGTCGAATCTAGGGA,318,332,14,18,17537,2,0
19041,ACGTCGAATCTTGGGA,318,318,0,18,17548,0,0
19042,ACGTCGAATCTAGGGA,318,320,2,23,17550,0,0
19043,ACGTCGAATCTAGGGA,318,321,3,19,17554,0,0
19044,ACGGCGAATCTAGGGA,318,321,3,23,17576,0,0
19045,ACGTCGAATCTAGGGA,318,321,3,26,17577,0,0
19046,ACGTCGAATGTAGGGA,318,321,3,22,17823,0,0
19047,ACGTCGAATCTAGGGA,318,321,3,20,17895,0,0
19048,ATGTCGAATCTTGGGA,318,321,3,18,17906,0,0
19049,ACGTCGAATCTAGGGA,318,321,3,25,17909,0,0
19050,ACGTCGAATCTAGGGA,318,321,3,26,17914,0,0
19051,ACGTCGAATCTAGGGA,318,321,3,26,17918,0,0
19052,ACGGCGAATCTAGGGA,318,319,1,26,17919,0,0
19053,ACGTCGGATCTAGGGA,318,318,0,22,17933,0,0
19054,ACGTCGAATCTAGGGA,318,321,3,18,18074,0,0
19055,ACTTCGAATCTAGGGA,318,321,3,25,18082,0,0
19056,ACGTCGAATCTAGGGA,318,321,3,24,18268,0,0
19057,ACGTCGAGTCTAGGGA,318,321,3,27,18271,0,0
19058,ACGTCGAATCTAGGGA,318,320,2,25,18279,0,0
19059,ACGTCGAATCTAGGGA,318,318,0,26,18281,0,0
19060,ACGTCGAATCTAGGGA,318,320,2,22,18289,0,0
19061,ACGTCGAATCTAGGGA,318,321,3,24,18294,0,0
19062,ACGTCGATTCTGGGGA,318,321,3,22,18295,0,0
19063,ACGTCGAATGTAGGGA,318,320,2,25,18296,0,0
19064,ACGTTGAATCTAGGGA,318,321,3,29,18299,0,0
19065,ACGTCGAATCTAGGGA,318,321,3,23,18301,0,0
19066,ACGTCGAATCTAGGGA,318,321,3,21,18302,0,0
19067,ACGTCGAATCTAGGGA,318,321,3,21,18305,0,0
19068,ACGTCGAATCTAGGGA,318,321,3,24,18309,0,0
19069,ACGTCGAATCTAGGGA,318,321,3,29,18310,0,0
19070,TCGTCGAATCTTGGGA,318,321,3,18,18444,0,0
19071,ACGTCGAATCTAGGGA,318,321,3,28,18445,0,0
19072,ACGTCGAATCTAGGGA,318,319,1,23,18446,0,0
19073,ACGTCGAATCTAGGGA,318,321,3,24,18448,0,0
19074,ACGTCGAATCTAGGGA,318,321,3,27,18543,0,0
19075,ACGTCGAATCTAGGGA,318,321,3,19,18550,0,0
19076,ACGTCGAATCTAGGGA,318,320,2,26,18551,0,0
19077,ACGTCGAATGTAGGGA,318,321,3,23,18631,0,0
19078,ACGTCGAATCTAGGGA,318,321,3,26,18638,0,0
19079,ACGTCGACTCTAGGGA,318,321,3,24,18645,0,0
19080,ACGTCGAATCTAGGGA,318,321,3,19,18648,0,0
19081,ACGTTGAATCTAGGGA,318,321,3,28,18650,0,0
19082,ACGTCGAATCTTGGGA,318,321,3,26,18652,0,0
19083,ACGTCGAATCTAGGGA,318,321,3,23,18654,0,0
19084,ACGTTGAATCTAGGGA,318,321,3,28,18655,0,0
19085,ACGTCGAATCTAGGGA,318,321,3,25,18656,0,0
19086,ACGTTGAATCTAGGGA,318,320,2,29,18660,0,0
19087,ACGTCGAATCTAGGGA,318,321,3,30,18662,0,0
19088,ACGTCGAATCTAGGGA,318,321,3,25,18665,0,0
19089,ACGTCGAATCTAGGGA,318,321,3,26,18666,0,0
19090,ACGTCGACTCTAGGGA,318,321,3,25,18670,0,0
19091,ACGTCGAATCTAGGGA,319,323,4,28,17074,0,0
19092,ACGTCGATTCTGGGGA,319,324,5,21,17081,0,0
19093,ACGTCGAATCTAGGGA,319,319,0,21,17246,0,0
19094,ACGTCGAATCTAGGGA,319,334,15,28,17255,3,0
19095,ACGTCGAATCTAGGGA,319,331,12,24,17274,2,0
19096,ACATCGAATCTAGGGA,319,343,24,26,17275,6,0
19097,ACGTCGAATCTAGGGA,319,324,5,26,17451,0,0
19098,ACGTCGAATCTAGGGA,319,327,8,21,17462,1,0
19099,ACGTCGAATCTAGGGT,319,340,21,21,17603,5,0
19100,ACGTCGAATCTAGGGA,319,321,2,26,17694,0,0
19101,ACGTCGAATCTAGGGA,319,347,28,24,17699,7,0
19102,ACGTCGAATCTAGGGA,319,319,0,25,17706,0,0
19103,ACGTCGAATCTAGGGA,319,328,9,19,17762,1,0
19104,ACGTCGAAAGCAGGGA,319,346,27,21,17763,7,0
19105,ACGTCGACTCTAGGGA,319,332,13,23,17779,2,0
19106,ACGTCGAATCTAGGGA,319,336,17,20,17787,4,0
19107,ACGTCGAATCTAGGGA,319,334,15,28,17789,3,0
19108,ACGTCGAATCTAGGGA,319,330,11,21,17803,2,0
19109,ACGTCGAATCTAGGGA,319,324,5,22,17964,0,0
19110,ACGTCGACTCTAGGGA,319,323,4,24,18058,0,0
19111,ACGTTGAATCTAGGGA,319,337,18,28,18060,4,0
19112,ACGTCGAATCTAGGGA,319,319,0,22,18063,0,0
19113,ACGTCGAAAGTAGGGA,319,319,0,22,18064,0,0
19114,ACGTTGAATCTAGGGA,319,355,36,23,18134,10,0
19115,ACGTCGAATCTAGGGA,319,339,20,23,18139,5,0
19116,ACGTCGAATCTAGGGA,319,333,14,26,18144,3,0
19117,ACGTTGCATCTAGGGA,319,319,0,27,18145,0,0
19118,ACGTCGAATCTAGGGA,319,320,1,24,18154,0,0
19119,ACGTCGAATCTAGGGA,319,327,8,25,18155,1,0
19120,ACGTCGAATCTAGGGA,319,325,6,22,18166,0,0
19121,ACGTCGAATGTAGGGA,319,322,3,23,18168,0,0
19122,ACGTCGAATCTAGGGA,319,321,2,19,18184,0,0
19123,ACGTCGAATCTAGGGA,319,348,29,27,18185,8,0
19124,ACGTCGAATCTAGGGT,319,331,12,22,18314,2,0
19125,TCGTCGAATCTAGGGA,319,320,1,24,18316,0,0
19126,ACGTCGAATCTAGGGA,319,321,2,25,18317,0,0
19127,ACGTCGAATCTAGGGA,319,323,4,24,18326,0,0
19128,ACGTCGAATCTAGGGA,319,321,2,26,18332,0,0
19129,ACGTCGAATCTAGGGA,319,321,2,28,18334,0,0
19130,ACGTCGAAAGTAGGGA,319,346,27,24,18337,7,0
19131,ACGTCGAATCTAGGGA,319,341,22,21,18499,5,0
19132,ACGTCGAATCTAGGGT,319,320,1,22,18500,0,0
19133,ACGTCGAATCTAGGGA,319,324,5,26,18504,0,0
19134,TCGTCGAATCTAGGGA,319,329,10,25,18507,1,0
19135,ACGTCGAATCTAGGGA,319,332,13,24,18509,2,0
19136,ACGTCGAATCTAGGGA,319,326,7,25,18510,0,0
19137,ACGTCGAATCTAGGGA,319,332,13,25,18515,2,0
19138,ACGTCGAATCTTGGGA,319,333,14,19,18523,3,0
19139,ACGTCGAATCTAGGGA,319,330,11,24,18529,2,0
19140,ACGTCGAATCTAGGGA,319,330,11,20,18535,2,0
19141,ACGTCGAATCTAGGGA,319,324,5,27,18697,0,0
19142,ACGTCGAATCTAGGGA,319,321,2,20,18702,0,0
19143,ACGTCGAATCTAGGGA,319,319,0,19,18703,0,0
19144,ACGTCGAATGTAGGGA,319,320,1,26,18706,0,0
19145,ACGTCGAATCTAGGGA,319,319,0,27,18708,0,0
19146,ACGTCGAATCTAGGGA,319,325,6,27,18709,0,0
19147,ACGTCGAATCTAGGGA,319,338,19,24,18712,4,0
19148,ACGTCGAATCTAGGGA,319,326,7,26,18714,0,0
19149,ACGTCGAATCCAGGGA,319,331,12,26,18715,1,0
19150,ACGTCGAATCTAGGGA,319,324,5,25,18716,0,0
19151,ACGTCCAATCTAGGGA,319,321,2,21,18718,0,0
19152,ACGTCGAATCTAGGGA,319,326,7,25,18721,0,0
19153,ACGTCGAATCTAGGGA,319,329,10,27,18722,1,0
19154,ACGTCGAGTCTAGGGA,319,343,24,28,18723,5,0
19155,ACGTCGATTCTGGGGA,319,333,14,23,18725,2,0
19156,ACGTCGAATCTAGGGA,319,323,4,24,18727,0,0
19157,ACGTCGAATCTAGGGA,319,323,4,27,18728,0,0
19158,ACGTCGAATGTAGGGA,320,332,12,22,16432,2,0
19159,ACGTCGAATCTTGGGA,320,337,17,17,16768,4,0
19160,ACGTCGAATCTAGGGA,320,344,24,23,16803,6,0
19161,ACGTCGAATCTAGGGA,320,329,9,25,17498,1,0
19162,ACGTCGAATCTAGGGA,320,332,12,21,17661,2,0
19163,ACGTCGAATCTAGGGA,320,326,6,22,17827,0,0
19164,ACGTCGAATCTTGGGA,320,328,8,25,17840,1,0
19165,ACGTCGAATCTAGGGA,320,325,5,22,18023,0,0
19166,ACGTCGATTCTGGGGA,320,327,7,22,18030,0,0
19167,ACGTCGAATCTAGGGA,320,324,4,29,18036,0,0
19168,ACGTTGAATCTAGGGA,320,324,4,28,18038,0,0
19169,ACGTCGAATCTAGGGA,320,325,5,22,18054,0,0
19170,ACGTTGAATCTAGGGA,320,341,21,27,18204,5,0
19171,ACGTCGAATCTAGGGA,320,322,2,24,18311,0,0
19172,ACGTCGATTCTGGGGA,320,321,1,22,18388,0,0
19173,ACGTCGAATCTAGGGA,320,327,7,23,18390,0,0
19174,ACATCGAATCTAGGGA,320,321,1,27,18396,0,0
19175,ACGTCGAATCTAGGGA,320,325,5,22,18403,0,0
19176,TCGTCGAATCTAGGGA,320,341,21,25,18404,5,0
19177,ACGTCGAATCTAGGGA,320,328,8,25,18409,1,0
19178,ACGTCGAATCTAGGGA,320,337,17,28,18422,4,0
19179,ACGTCGAATCTAGGGA,320,324,4,21,18426,0,0
19180,ACGTCGAATCTAGGGA,320,322,2,22,18427,0,0
19181,ACGTCGAATCTAGGGA,320,323,3,25,18567,0,0
19182,ACATCGAATCTAGGGA,320,323,3,27,18568,0,0
19183,ACATCGAATCTAGGGA,320,321,1,27,18569,0,0
19184,ACGTTGAATCTAGGGA,320,323,3,28,18570,0,0
19185,ACGTCGAATCTAGGGA,320,323,3,21,18672,0,0
19186,TCGTCGAATCTAGGGA,320,323,3,24,18673,0,0
19187,ACGTCGAATCTAGGGA,320,320,0,25,18674,0,0
19188,ACGTTGAATCTAGGGA,320,322,2,27,18675,0,0
19189,ACGTCGACTCTAGGGA,320,323,3,22,18679,0,0
19190,ACGTCGAATCTAGCGA,320,321,1,25,18680,0,0
19191,ACGTCGAATCTAGGGA,320,323,3,21,18681,0,0
19192,ACGTCGAATCTAGGGA,320,323,3,25,18683,0,0
19193,ACGTCGAATCGAGGGA,320,323,3,21,18685,0,0
19194,ACGTCGAATCTAGGGA,320,323,3,27,18686,0,0
19195,ACGTCGAATCTAGGGA,320,321,1,29,18743,0,0
19196,ACGTCGATTCTGGGGA,320,323,3,22,18744,0,0
19197,ACGTCGAATGTAGGGA,320,320,0,22,18745,0,0
19198,ACGTCGAATCTAGGGA,320,323,3,23,18746,0,0
19199,ACGTCGAATCTAGGGA,320,323,3,22,18747,0,0
19200,ACGTCGAATCTAGGGT,320,323,3,22,18755,0,0
19201,TCGTCGAATCTAGGGA,320,323,3,24,18866,0,0
19202,ACGTCGAATCTAGGGA,320,323,3,25,18867,0,0
19203,ACGTCGACTCTAGGGA,320,323,3,22,18869,0,0
19204,ACGTCGAATCTAGGGA,320,323,3,21,18874,0,0
19205,ACGTCGAATGTAGGGA,320,323,3,22,18875,0,0
19206,ACGTCGAATCTAGGGA,320,323,3,24,18878,0,0
19207,ACGTCGAATGTAGGGA,320,323,3,23,18883,0,0
19208,ACGTCGAATCTAGGGA,320,321,1,28,18884,0,0
19209,ACGTCGAATCTAGGGA,320,323,3,21,18885,0,0
19210,ACGTCGAATCTAGGGA,321,346,25,20,16474,6,0
19211,TCGTCGAATCTAGGGA,321,323,2,23,16667,0,0
19212,ACGTCGAATCTAGGGA,321,332,11,24,16686,2,0
19213,ACGTCGAATCTAGGGA,321,346,25,27,16941,6,0
19214,ACGTCGACTCTAGGGA,321,332,11,21,17012,2,0
19215,ACGTCGAATCTAGGGA,321,328,7,26,17361,0,0
19216,ACGTCGAATCTAGGGA,321,329,8,24,17383,1,0
19217,ACGTCGAATCTAGGGA,321,325,4,20,17409,0,0
19218,ACGTCGAATCTAGGGA,321,347,26,18,17537,7,0
19219,ACGTCGAATCTTGGGA,321,324,3,18,17548,0,0
19220,ACGTCGAATCTAGGGA,321,324,3,23,17550,0,0
19221,ACGTCGAATCTAGGGA,321,331,10,19,17554,1,0
19222,ACGTCGAATCTAGGGA,321,346,25,26,17577,6,0
19223,ACGTCGAATGTAGGGA,321,322,1,22,17823,0,0
19224,ACGTCGAATCTAGGGA,321,334,13,25,17909,2,0
19225,ACGTCGAATCTAGGGA,321,337,16,26,17914,3,0
19226,ACGTCGAATCTAGGGA,321,347,26,26,17918,7,0
19227,ACGTCGGATCTAGGGA,321,327,6,22,17933,0,0
19228,ACGTCGAATCTAGGGA,321,342,21,25,18082,5,0
19229,ACGTCGAATCTAGGGA,321,329,8,24,18268,1,0
19230,ACGTCGAATCTAGGGA,321,330,9,25,18279,1,0
19231,ACGTCGAATCTAGGGA,321,354,33,22,18289,9,0
19232,ACGTCGAATCTAGGGA,321,335,14,24,18294,3,0
19233,ACGTCGAATGTAGGGA,321,379,58,25,18296,17,0
19234,ACGTTGAATCTAGGGA,321,329,8,29,18299,1,0
19235,ACGTCGAATCTAGGGA,321,326,5,23,18301,0,0
19236,ACGTCGAATCTAGGGA,321,329,8,21,18302,1,0
19237,ACGTCGAATCTAGGGA,321,321,0,28,18445,0,0
19238,ACGTCGAATCTAGGGA,321,331,10,23,18446,1,0
19239,ACGTCGAATCTAGGGA,321,323,2,24,18448,0,0
19240,ACGTCGAATCTAGGGA,321,333,12,19,18550,2,0
19241,ACGTCGAATCTAGGGA,321,338,17,26,18551,4,0
19242,ACGTCGAATGTAGGGA,321,332,11,23,18631,2,0
19243,ACGTCGAATCTAGGGA,321,325,4,26,18638,0,0
19244,ACGTCGACTCTAGGGA,321,331,10,24,18645,1,0
19245,ACGTCGAATCTTGGGA,321,332,11,26,18652,1,0
19246,ACGTCGAATCTAGGGA,321,321,0,23,18654,0,0
19247,ACGTCGAATCTAGGGA,321,347,26,25,18656,6,0
19248,ACGTTGAATCTAGGGA,321,324,3,29,18660,0,0
19249,ACGTCGAATCTAGGGA,321,324,3,30,18662,0,0
19250,ACGTCGAATCTAGGGA,321,324,3,26,18666,0,0
19251,ACGTCGACTCTAGGGA,321,324,3,25,18670,0,0
19252,ACGTCGAATCTAGGGA,321,322,1,28,18811,0,0
19253,ACGTCGAATCTAGGGA,321,324,3,24,18812,0,0
19254,ACGTCGATTCTGGGGA,321,324,3,22,18814,0,0
19255,ACGTCGAATCTGGGGA,321,324,3,23,18815,0,0
19256,ACGTTGAATCTAGCGA,321,324,3,28,18823,0,0
19257,ACGTCGAATCTAGGGA,321,324,3,21,18824,0,0
19258,ACGTGGAATCTTGGGA,321,323,2,26,18825,0,0
19259,ACGTCGAATCTAGGGA,321,324,3,19,18826,0,0
19260,ACGTCGATTCTGGGGA,321,324,3,23,18830,0,0
19261,ACGTCGAATCTAGGGA,321,321,0,30,18831,0,0
19262,ACGTCGCATCTAGGGA,321,323,2,22,18833,0,0
19263,ACGTCTACTCTAGCGA,321,324,3,24,18834,0,0
19264,ACGTCGATTCCGGGGA,321,324,3,22,18838,0,0
19265,ACGTCGAATCTAGGGA,321,321,0,25,18840,0,0
19266,ACGTCGAATCTAGGGA,321,324,3,24,18841,0,0
19267,ACGTCGATTCTGGGGA,321,324,3,22,18842,0,0
19268,ACGTCGAATGTAGGGA,321,322,1,23,18845,0,0
19269,ACGTCGAATCTAGGGA,321,324,3,24,18846,0,0
19270,ACGTCGAATCTAGGGA,321,321,0,23,18847,0,0
19271,ACGTCGAATCTAGGGA,321,324,3,26,18848,0,0
19272,ACATCGAATCTAGGGA,321,324,3,28,18849,0,0
19273,ACATCGAATCTAGGGA,321,324,3,28,18851,0,0
19274,ACGTCGAATCTAGGGA,321,324,3,23,18853,0,0
19275,TCGTCGAATCTAGGGA,321,324,3,26,18854,0,0
19276,ACGTCGAATCTAGGGA,321,324,3,26,18856,0,0
19277,ACGTCGAATCTAGGGA,321,324,3,30,18860,0,0
19278,ACGTCGAATCTAGGGA,321,323,2,22,18863,0,0
19279,ACGTCGAATCTAGGGA,321,322,1,23,18864,0,0
19280,ACGTCGAATCTAGGGA,322,330,8,28,17074,1,0
19281,ACGTCGATTCTGGGGA,322,341,19,21,17081,4,0
19282,ACGTCGAATCTAGGGA,322,324,2,21,17246,0,0
19283,ACGTCGAATCTAGGGA,322,323,1,28,17255,0,0
19284,ACGTCGAATCTAGGGA,322,322,0,24,17274,0,0
19285,ACGTCGAATCTAGGGA,322,322,0,26,17451,0,0
19286,ACGTCGAATCTAGGGT,322,326,4,21,17603,0,0
19287,ACGTCGAATCTAGGGA,322,331,9,26,17694,1,0
19288,ACGTCGAATCTAGGGA,322,324,2,24,17699,0,0
19289,ACGTCGAATCTAGGGA,322,325,3,25,17706,0,0
19290,ACGTCGAATCTAGGGA,322,331,9,19,17762,1,0
19291,ACGTCGACTCTAGGGA,322,333,11,23,17779,2,0
19292,ACGTCGAATCTAGGGA,322,339,17,20,17787,4,0
19293,ACGTCGAATCTAGGGA,322,332,10,28,17789,1,0
19294,ACGTCGAATCTAGGGA,322,328,6,21,17803,0,0
19295,ACGTCGACTCTAGGGA,322,342,20,24,18058,5,0
19296,ACGTTGAATCTAGGGA,322,339,17,28,18060,4,0
19297,ACGTCGAATCTAGGGA,322,324,2,22,18063,0,0
19298,ACGTCGAAAGTAGGGA,322,335,13,22,18064,2,0
19299,ACGTCGAATCTAGGGA,322,325,3,23,18134,0,0
19300,ACGTCGAATCTAGGGA,322,328,6,23,18139,0,0
19301,ACGTCGAATCTAGGGA,322,332,10,26,18144,1,0
19302,ACGTCGAATCTAGGGA,322,322,0,24,18154,0,0
19303,ACGTCGAATCTAGGGA,322,330,8,22,18166,1,0
19304,ACGTCGAATGTAGGGA,322,355,33,23,18168,9,0
19305,ACGTCGAATCTAGGGA,322,328,6,19,18184,0,0
19306,ACGTCGAATCTAGGGA,322,326,4,27,18185,0,0
19307,TCGTCGAATCTAGGGA,322,330,8,24,18316,1,0
19308,ACGTCGAATCTAGGGA,322,341,19,24,18326,4,0
19309,ACGTCGAATCTAGGGA,322,325,3,28,18334,0,0
19310,ACGTCGAAAGTAGGGA,322,325,3,24,18337,0,0
19311,ACGTCGAATCTAGGGT,322,333,11,22,18500,2,0
19312,ACGTCGAATCTAGGGA,322,334,12,26,18504,2,0
19313,TCGTCGAATCTAGGGA,322,332,10,25,18507,1,0
19314,ATGTCGAATCTAGGGA,322,334,12,24,18509,1,0
19315,ACGTCGAATCTTGGGA,322,334,12,19,18523,1,0
19316,ACGTCGAATCTAGGGA,322,331,9,24,18529,0,0
19317,ACGTCGAATCTAGGGA,322,325,3,27,18697,0,0
19318,ACGTCGAATCTAGGGA,322,325,3,20,18702,0,0
19319,ACGTCGAATCTAGGGA,322,325,3,19,18703,0,0
19320,ACGTCGAATCTAGGGA,322,325,3,26,18706,0,0
19321,ACGTCGAATCTAGGGA,322,324,2,27,18709,0,0
19322,ACGTCGAATCTAGGGA,322,324,2,24,18712,0,0
19323,ACGTCGAATCTAGGGA,322,323,1,26,18714,0,0
19324,ACGTCGAATCTAGGGA,322,324,2,25,18716,0,0
19325,ACGTCCAATCTAGGGA,322,325,3,21,18718,0,0
19326,ACGTCGAATCTAGGGA,322,325,3,25,18721,0,0
19327,ACGTCGAGTCTAGGGA,322,325,3,28,18723,0,0
19328,ACGTCGATTCTGGGGA,322,325,3,23,18725,0,0
19329,ACGTCGAATCTAGGGA,322,325,3,24,18727,0,0
19330,ACGTCGAATCTAGGGA,322,325,3,27,18728,0,0
19331,ACGTCGAATCTAGGGA,322,324,2,20,18886,0,0
19332,ATGTCGAATCTTGGGA,322,325,3,19,18887,0,0
19333,ACGTCGAATCTAGGGA,322,325,3,19,18894,0,0
19334,ACGTCGAATCTAGGGA,322,325,3,26,18895,0,0
19335,ACGTCCAATCTAGGGA,322,325,3,21,18897,0,0
19336,ACGTCGAGTCTAGGGA,322,325,3,28,18900,0,0
19337,ACGTCGAATCTAGGGA,322,323,1,26,18902,0,0
19338,ACGTCGAATCGAGGGA,322,323,1,28,18904,0,0
19339,ACGTCGAATCTTGGGA,323,326,3,17,16768,0,0
19340,ACGTCGAATCTAGGGA,323,326,3,23,16803,0,0
19341,ACGTCGCATCTAGGGA,323,325,2,25,17498,0,0
19342,ACGTCGAATCTAGGGA,323,326,3,21,17661,0,0
19343,ACGTCGAATCTAGGGA,323,325,2,22,17827,0,0
19344,ACGTCGAATCTAGGGA,323,344,21,22,18023,5,0
19345,ACGTCGATTCTGGGGA,323,332,9,22,18030,1,0
19346,ACGTCGAATCTAGGGA,323,343,20,29,18036,5,0
19347,ACGTTGAATCTAGGGA,323,326,3,28,18038,0,0
19348,ACGTTGAATCTAGGGA,323,333,10,27,18204,1,0
19349,ACGTCGAATCTAGGGA,323,328,5,24,18311,0,0
19350,ACGTCGATTCTGGGGA,323,346,23,22,18388,6,0
19351,ACGTCGAATCTAGGGA,323,336,13,23,18390,2,0
19352,ACGTCGAATCTAGGGA,323,329,6,22,18403,0,0
19353,TCGTCGAATCTAGGGA,323,335,12,25,18404,2,0
19354,ACGTCGAATCTAGGGA,323,327,4,25,18409,0,0
19355,ACGTCGAATCTAGGGA,323,331,8,22,18427,1,0
19356,ACGTCGAATCTAGGGA,323,324,1,25,18567,0,0
19357,ACATCGAATCTAGGGA,323,354,31,27,18568,8,0
19358,ACATCGAATCTAGGGA,323,327,4,27,18569,0,0
19359,ACGTTGAATCTAGGGA,323,324,1,28,18570,0,0
19360,ACGTCGAATCTAGGGA,323,323,0,21,18672,0,0
19361,TCGTCGAATCTAGGGA,323,335,12,24,18673,2,0
19362,ACGTCGAATCTAGGGA,323,332,9,25,18674,1,0
19363,ACGTTGAATCTAGGGA,323,324,1,27,18675,0,0
19364,ACGTCGACTCTAGGGA,323,325,2,22,18679,0,0
19365,ACGTCGAATCTAGGGA,323,330,7,25,18680,0,0
19366,ACGTCGAATCTAGGGA,323,326,3,21,18681,0,0
19367,ACGTCGAATCTAGGGA,323,326,3,25,18683,0,0
19368,ACGTCGAATCGAGGGA,323,326,3,21,18685,0,0
19369,ACGTCGAATCTAGGGA,323,326,3,27,18686,0,0
19370,ACGTCGAATCTAGGGA,323,326,3,29,18743,0,0
19371,ACGTCGATTCTGGGGA,323,326,3,22,18744,0,0
19372,ACGTCGAATGTAGGGA,323,326,3,22,18745,0,0
19373,ACGTCGAATCTAGGGA,323,326,3,23,18746,0,0
19374,ACGTCGAATCTAGGGA,323,325,2,22,18747,0,0
19375,ACGTCGAATCTAGGGT,323,326,3,22,18755,0,0
19376,ACGTCGAATCTAGGGA,323,326,3,25,18867,0,0
19377,ACGTCGACTCTAGGGA,323,326,3,22,18869,0,0
19378,ACGTCGAATCTAGGGA,323,326,3,21,18874,0,0
19379,ACGTCGAATGTAGGGA,323,325,2,22,18875,0,0
19380,ACGTCGAATCTAGGGA,323,326,3,24,18878,0,0
19381,ACGTCGAATCTAGGGA,323,326,3,28,18884,0,0
19382,ACGTCGAATCTAGGGA,323,326,3,22,18922,0,0
19383,ACGTCGAATCTAGGGA,323,323,0,29,18923,0,0
19384,ACGTCGAATCTAGGAA,323,326,3,25,18924,0,0
19385,ACATCGAATCTAGGGA,323,326,3,27,18925,0,0
19386,ACGTCGAATCTAGGGA,323,325,2,27,18929,0,0
19387,ACGTCGAATCTAGGGA,323,326,3,20,18932,0,0
19388,ACGTCGAAAGTAGGGA,323,326,3,22,18933,0,0
19389,ACGTCGAATCTAGGGA,323,324,1,21,18935,0,0
19390,ACGTCGAATCTAGGGA,323,324,1,22,18937,0,0
19391,ACGTCGACTCTAGGGA,323,323,0,25,18941,0,0
19392,ACGTTGAATCTAGGGA,323,326,3,29,18942,0,0
19393,ACGTCGAATCTAGGGA,323,326,3,23,18943,0,0
19394,TCGTCGAATCTAGGGA,323,326,3,26,18945,0,0
19395,ACGTCGAATCTAGGGT,323,326,3,22,18947,0,0
19396,ACGTCGAATCTAGGGA,323,326,3,28,18958,0,0
19397,TCGTCGAATCTAGGGA,323,326,3,25,18960,0,0
19398,ACGTCGAATCTAGGGA,324,358,34,20,16474,9,0
19399,TCGTCGAATCTAGGGA,324,354,30,23,16667,8,0
19400,ACGTCGAATCTAGGGA,324,346,22,24,16686,5,0
19401,ACGTCGAATCTAGGGA,324,334,10,27,16941,1,0
19402,ACGTCGAATCTAGGGA,324,333,9,26,17361,1,0
19403,ACGTCGAATCTAGGGA,324,329,5,24,17383,0,0
19404,ACGTCGAATCTTGGGA,324,332,8,18,17548,1,0
19405,ACGTCGAATCTAGGGA,324,335,11,23,17550,2,0
19406,ACGTCGAATCTAGGGA,324,336,12,19,17554,2,0
19407,ACGTCGAATCTAGGGA,324,328,4,26,17577,0,0
19408,ACGTCGAATGTAGGGA,324,328,4,22,17823,0,0
19409,ACGTCGAATCTAGGGA,324,331,7,25,17909,0,0
19410,ACGTCGAATCTAGGGA,324,331,7,26,17918,0,0
19411,ACGTCGGATCTAGGGA,324,334,10,22,17933,1,0
19412,ACGTCGAATCTAGGGA,324,326,2,25,18082,0,0
19413,AGGTCGAATCTAGGGA,324,326,2,24,18268,0,0
19414,ACGTCGAATCTAGGGA,324,338,14,25,18279,3,0
19415,ACGTCGAATGTAGGGA,324,341,17,25,18296,4,0
19416,ACGTCGAATCTAGGGA,324,346,22,23,18301,5,0
19417,ACGTCGAATCTAGGGA,324,326,2,23,18446,0,0
19418,ACGTCGAATCTAGGGA,324,331,7,24,18448,0,0
19419,ACGTCGAATGTAGGGA,324,331,7,23,18631,0,0
19420,ACGTCGAATCTAGGGA,324,334,10,26,18638,1,0
19421,ACGTCGACTCTAGGGA,324,335,11,24,18645,2,0
19422,ACGTTGAATCTAGGGA,324,324,0,29,18660,0,0
19423,ACGTCGAATCTAGGGA,324,325,1,30,18662,0,0
19424,ACCTCGAATCTAGGGA,324,334,10,26,18666,1,0
19425,ACGTCGACTCTAGGGA,324,327,3,25,18670,0,0
19426,ACGTCGAATCTAGGGA,324,336,12,24,18812,2,0
19427,ACGTCGAATCTAGGGA,324,347,23,23,18815,6,0
19428,ACGTTGAATCTAGGGA,324,329,5,28,18823,0,0
19429,ACGTCGAATCTTGGGA,324,325,1,26,18825,0,0
19430,ACGTCGATTCTGGGGA,324,334,10,23,18830,1,0
19431,ACGTCGAATCTAGGGA,324,330,6,30,18831,0,0
19432,ACGTCGCATCTAGGGA,324,324,0,22,18833,0,0
19433,ACGGCTACTCTAGGGA,324,339,15,24,18834,2,0
19434,ACGTCGATTCCGGGGA,324,324,0,22,18838,0,0
19435,ACGTCGAATCTAGGGA,324,326,2,25,18840,0,0
19436,ACGTCGAATCTAGGGA,324,333,9,24,18841,0,0
19437,ACGTCGATTCTGGGGA,324,333,9,22,18842,0,0
19438,ACGTCGAATGTAGGGA,324,327,3,23,18845,0,0
19439,ACGTCGAATCTAGGGA,324,328,4,24,18846,0,0
19440,ACGTCGAATCTAGGGA,324,326,2,23,18847,0,0
19441,ACGTCGAATCTAGGGA,324,336,12,23,18853,1,0
19442,TCGTCGAATCTAGGGA,324,334,10,26,18854,1,0
19443,ACGTCGAATCTAGGGA,324,332,8,26,18856,0,0
19444,ACGTCGAATCTAGGGA,324,345,21,30,18860,4,0
19445,ACGTCGAATCTAGGGA,324,354,30,22,18863,7,0
19446,ACGTCGAATGTAGGGA,324,325,1,23,18981,0,0
19447,ACGTCGAATCTAGGGA,324,325,1,26,18985,0,0
19448,ACGTCTACTCTAGGGA,324,326,2,24,18994,0,0
19449,ACGTCGAATCTAGGGA,324,326,2,23,18995,0,0
19450,ACGTCGAATCTAGGGA,324,331,7,25,18997,0,0
19451,ACGTCGAATCTAGGGA,324,326,2,24,19002,0,0
19452,ACGTCGAATCTAGGGA,324,325,1,24,19005,0,0
19453,TCGTCGAATCTAGGGA,324,324,0,26,19007,0,0
19454,ACGTCGAATCTAGGGA,324,329,5,22,19011,0,0
19455,ACGTCGAATCTAGGGA,324,327,3,23,19012,0,0
19456,ACATCGAATCTAGGGA,324,327,3,28,19014,0,0
19457,ACGTCGAATCTAGGGA,324,327,3,22,19017,0,0
19458,ACGTCGACTCTAGGGA,324,327,3,23,19021,0,0
19459,ACGTCGAATCTAGGGA,324,327,3,26,19024,0,0
19460,ACGTCGAATCTAGGGA,324,327,3,23,19025,0,0
19461,ACGTCGAATCTAGGGA,325,329,4,28,17074,0,0
19462,ACGTCGATTCTGGGGA,325,336,11,21,17081,2,0
19463,ACGTCGAATCTAGGGA,325,342,17,21,17246,4,0
19464,ACGTCGAATCTAGGGA,325,325,0,28,17255,0,0
19465,ACGTCGAATCTAGGGA,325,339,14,24,17274,3,0
19466,ACGTCGAATCTAGGGA,325,333,8,26,17451,1,0
19467,ACGTCGAATCTAGGGT,325,326,1,21,17603,0,0
19468,ACGTCGAATCTAGGGA,325,334,9,26,17694,1,0
19469,ACGTCGAATCTAGGGA,325,325,0,24,17699,0,0
19470,ACGTCGAATCTAGGGA,325,335,10,19,17762,1,0
19471,ACGTCGACTCTAGGGA,325,326,1,23,17779,0,0
19472,ACGTCGAATCTAGGGA,325,342,17,20,17787,4,0
19473,ACGTCGAAAGTAGGGA,325,338,13,22,18064,2,0
19474,ACGTCGAATCTAGGGA,325,327,2,26,18144,0,0
19475,ACGTCGAATCTAGGGA,325,328,3,19,18184,0,0
19476,ACGTCGAATCTAGGGA,325,325,0,27,18185,0,0
19477,ACGTCGAATCTAGGGA,325,328,3,24,18326,0,0
19478,ACGTCGAATCTAGGGA,325,328,3,28,18334,0,0
19479,ACGTCGAAAGTAGGGA,325,328,3,24,18337,0,0
19480,ACGTCGAATCTAGGGT,325,326,1,22,18500,0,0
19481,TCGTCGAATCTAGGGA,325,328,3,25,18507,0,0
19482,ACGTCGAATCTTGGGA,325,325,0,19,18523,0,0
19483,ACGTCGAATCTAGGGA,325,328,3,24,18529,0,0
19484,ACGTCGAATCTAGGGA,325,327,2,27,18697,0,0
19485,ACGTCGAATCTAGGGA,325,328,3,20,18702,0,0
19486,ACGTCGAATCTAGGGA,325,326,1,19,18703,0,0
19487,ACGTCGAATCTAGGGA,325,326,1,24,18712,0,0
19488,ACGTCGAATCTAGGGA,325,328,3,26,18714,0,0
19489,ACGTCGAATCTAGGGA,325,328,3,25,18716,0,0
19490,ACGTCGAATCTAGGGA,325,328,3,25,18721,0,0
19491,ACGTCGAGTCTAGGGA,325,328,3,28,18723,0,0
19492,ACGTCGATTCTGGGGA,325,328,3,23,18725,0,0
19493,ACGTCGAATCTAGGGA,325,325,0,24,18727,0,0
19494,ACGTCGAATCTAGGGA,325,327,2,27,18728,0,0
19495,ACGTCGAATCTAGGGA,325,325,0,20,18886,0,0
19496,ACGTCGAATCTAGGGA,325,325,0,19,18894,0,0
19497,ACGTCAAATCTAGGGA,325,328,3,26,18895,0,0
19498,ACGTCCTATCTAGGGA,325,325,0,21,18897,0,0
19499,ACGTCGAGTCTAGGGA,325,328,3,28,18900,0,0
19500,ACGTCGAATCTAGGGA,325,325,0,25,19035,0,0
19501,ACGTCGAATCTAGGGA,325,328,3,21,19038,0,0
19502,ACGTCGAATGTAGGGA,325,328,3,22,19039,0,0
19503,ACGTCGAATCTAGGGA,326,328,2,23,16803,0,0
19504,ACGTCGAATCTAGGGA,326,330,4,21,17661,0,0
19505,ACGTCGAATCTAGGGA,326,344,18,22,18023,4,0
19506,ACGTCGATTCTGGGGA,326,346,20,22,18030,5,0
19507,ACGTCGAATCTAGGGA,326,332,6,29,18036,0,0
19508,ACGTTGAATCTAGGGA,326,334,8,28,18038,1,0
19509,ACGTTGAATCTAGGGA,326,331,5,27,18204,0,0
19510,ACGTCGAATCTAGGGA,326,334,8,24,18311,1,0
19511,ACGTCGATTCTGGGGA,326,328,2,22,18388,0,0
19512,ACGTCGAATCTAGGGA,326,351,25,23,18390,6,0
19513,ACGTCGAATCTAGGGA,326,341,15,22,18403,3,0
19514,TCGTCGAATCTAGGGA,326,330,4,25,18404,0,0
19515,ACGTCGAATCTAGGGA,326,330,4,25,18409,0,0
19516,ACGTCGAATCTAGGGA,326,332,6,25,18567,0,0
19517,ACATCGAATCTAGGGA,326,327,1,27,18568,0,0
19518,ACATCGAATCTAGGGA,326,332,6,27,18569,0,0
19519,ACGTTGAATCTAGGGC,326,327,1,28,18570,0,0
19520,TCGTCGAATCTAGGGA,326,329,3,24,18673,0,0
19521,ACGTCGAATCTAGGGA,326,331,5,25,18674,0,0
19522,ACGTTGAATCTAGGGA,326,356,30,27,18675,8,0
19523,ACGTCGAATCTAGGGA,326,328,2,25,18680,0,0
19524,ACGTCGAATCTAGGGA,326,328,2,21,18681,0,0
19525,ACGTCGAATCTAGGGA,326,350,24,25,18683,6,0
19526,ACGTCGAATCGAGGGA,326,330,4,21,18685,0,0
19527,ACGTCGAATCTAGGGA,326,330,4,29,18743,0,0
19528,ACGTCGAATGTAGGGA,326,335,9,22,18745,1,0
19529,ACGTCGAATCTAGGGA,326,326,0,22,18747,0,0
19530,ACGTCGACTCTAGGGA,326,326,0,22,18869,0,0
19531,ACGTCGAATCTAGGGA,326,329,3,21,18874,0,0
19532,ACGTCGAATCTAGGGA,326,331,5,24,18878,0,0
19533,ACGTCGAATCTAGGGA,326,330,4,22,18922,0,0
19534,ACGTCGAATCTAGGGA,326,329,3,29,18923,0,0
19535,ACATCGAATCTAGGGA,326,329,3,27,18925,0,0
19536,ACGTCGAATCTAGGGA,326,329,3,27,18929,0,0
19537,ACGTCGAATCTAGGGA,326,329,3,20,18932,0,0
19538,ACGTCGAAAGTAGGGA,326,329,3,22,18933,0,0
19539,ACGTCGAATCTAGGGA,326,329,3,22,18937,0,0
19540,ACGTCGACTCTAGGGA,326,329,3,25,18941,0,0
19541,ACGTTGAATCTAGGGA,326,327,1,29,18942,0,0
19542,ACGTCGAATCTAGGGA,326,328,2,23,18943,0,0
19543,TCGTCGAATCTAGGGA,326,329,3,26,18945,0,0
19544,ACGTCGAATCTAGGGT,326,327,1,22,18947,0,0
19545,TCGTCGAATCTAGGGA,326,329,3,25,18960,0,0
19546,ACGTCGAATCTAGGGA,326,327,1,19,19040,0,0
19547,ACGTCGAATCTAGGGA,326,329,3,29,19094,0,0
19548,ACGTCGAATCTAGGGA,326,329,3,25,19095,0,0
19549,ACATCGAATCTAGGGA,326,329,3,27,19096,0,0
19550,ACGTCGAATCTAGGGA,326,329,3,22,19098,0,0
19551,ACGTCGAATCTAGGGT,326,329,3,22,19099,0,0
19552,ACGTCGAATCTAGGGA,326,329,3,25,19101,0,0
19553,ACGTCGAATCTATGGA,326,329,3,20,19103,0,0
19554,ACGTCGAAAGCAGGGA,326,329,3,22,19104,0,0
19555,ACGTCGACTCTAGGGA,326,329,3,24,19105,0,0
19556,ACGTCGAATCTAGGGA,326,329,3,21,19106,0,0
19557,ACGTCGAATCTAGGGA,326,329,3,29,19107,0,0
19558,ACGTCGAATCTAGGGA,326,327,1,22,19108,0,0
19559,ACGTTGAATCTAGGGA,326,329,3,29,19111,0,0
19560,ACGTTGAATCTAGGGA,326,329,3,24,19114,0,0
19561,ACGTCGAATCTAGGGA,326,326,0,24,19115,0,0
19562,ACGTCGAATCTAGGGA,326,329,3,27,19116,0,0
19563,ACGTCGAATCTAGGGA,326,329,3,26,19119,0,0
19564,ACGTCGAATCTAGGGA,326,329,3,28,19123,0,0
19565,ACGTCGAATCTAGGGT,326,329,3,23,19124,0,0
19566,ACGTCGAAAGTAGGGA,326,329,3,25,19130,0,0
19567,ACGTCGAATCTAGGGA,326,329,3,22,19131,0,0
19568,TCGTCGAATCTAGGGA,326,329,3,26,19134,0,0
19569,ACGTCGAATCTAGGGA,326,329,3,25,19135,0,0
19570,ACGTCGAATCTAGGGA,326,329,3,26,19137,0,0
19571,ACGTCGAATCTTGGGA,326,329,3,20,19138,0,0
19572,ACGTCGAATCTAGGGA,326,327,1,25,19139,0,0
19573,ACGTCGAATCTAGGGA,326,329,3,21,19140,0,0
19574,ACGTCGAATCTAGGGA,326,326,0,25,19147,0,0
19575,ACGTCGAATCTAGGGA,327,350,23,20,16474,6,0
19576,TCGTCGAATCTAGGGA,327,327,0,23,16667,0,0
19577,ACGTCGAATCTTGGGA,327,330,3,18,17548,0,0
19578,ACGTCGAATCTAGGGA,327,328,1,23,17550,0,0
19579,ACGTCGAATCTAGGGA,327,329,2,19,17554,0,0
19580,ACGTCGAATCTAGGGA,327,330,3,26,17577,0,0
19581,ACGTCGAATGTAGGGA,327,329,2,22,17823,0,0
19582,ACGTCGAATCTAGGGA,327,330,3,26,17918,0,0
19583,ACGTCGAATCTAGGGA,327,353,26,25,18082,7,0
19584,ACGTCGAATCTAGGGA,327,330,3,25,18279,0,0
19585,ACGTCGAATGTAGGGA,327,339,12,25,18296,2,0
19586,ACGTCGAATCTAGGGA,327,342,15,23,18446,3,0
19587,ACGTCGAATGTAGGGA,327,346,19,23,18631,4,0
19588,ACGTTGAATCTAGGGA,327,361,34,29,18660,9,0
19589,ACGTCGAATCTAGGGA,327,333,6,30,18662,0,0
19590,ACGTCGAATCTAGGGA,327,361,34,26,18666,9,0
19591,ACGTCGACTCTAGGGA,327,330,3,25,18670,0,0
19592,ACGTCGAATCTAGGGA,327,342,15,24,18812,3,0
19593,ACGTCGAATCTTGGGA,327,333,6,26,18825,0,0
19594,ACGTCGATTCTGGGGA,327,358,31,23,18830,8,0
19595,ACGTCGCATCTAGGGA,327,333,6,22,18833,0,0
19596,ACGTCTACTCTAGGGA,327,328,1,24,18834,0,0
19597,ACGTCGAATCTAGGGA,327,356,29,25,18840,8,0
19598,ACGTCGAATCTAGGGA,327,346,19,24,18841,4,0
19599,ACGTCGATTCTGGGGA,327,327,0,22,18842,0,0
19600,ACGTCGAATGTAGGGA,327,332,5,23,18845,0,0
19601,ACGTCGAATCTAGGGA,327,331,4,24,18846,0,0
19602,ACGTCGAATCTAGGGA,327,349,22,23,18853,5,0
19603,TCGTCGAATCTAGGGA,327,339,12,26,18854,2,0
19604,ACGTCGAATCTAGGGA,327,357,30,30,18860,8,0
19605,ACGTCGAATCTAGGGA,327,337,10,22,18863,1,0
19606,ACGTCGAATGTAGGGA,327,361,34,23,18981,9,0
19607,ACGTCGAATCTAGGGA,327,359,32,26,18985,9,0
19608,ACGTCTACTCAAGGGA,327,328,1,24,18994,0,0
19609,ACGTCGAATCTAGGGA,327,333,6,25,18997,0,0
19610,ACGTCGAATCTAGGGA,327,356,29,24,19002,8,0
19611,ACGTCGAATCTAGGGA,327,342,15,24,19005,3,0
19612,TCGTCGAATCTAGGGA,327,328,1,26,19007,0,0
19613,ACGTCGAATCTAGGGA,327,338,11,23,19012,1,0
19614,ACATCGAATCTAGGGA,327,333,6,28,19014,0,0
19615,ACGTCGAATCTAGGGA,327,345,18,22,19017,3,0
19616,ACGTCGACTCTAGGGA,327,329,2,23,19021,0,0
19617,ACGTCGAATCTAGGGA,327,330,3,23,19025,0,0
19618,ACGTCGAATGTAGGGA,327,333,6,23,19158,0,0
19619,ACGTCGAATCTTGGGA,327,329,2,18,19159,0,0
19620,ACGTCGAATCTAGGGA,327,332,5,24,19160,0,0
19621,ACGTCGAATCTAGGGA,327,330,3,26,19161,0,0
19622,ACGTCGAATCTAGGGA,327,334,7,22,19162,0,0
19623,ACGTCGAATCTTGGGA,327,346,19,26,19164,4,0
19624,ACGTTGAATCTAGGGA,327,333,6,28,19170,0,0
19625,TCGTCGAATCTAGGGA,327,328,1,26,19176,0,0
19626,ACGTCGAATCTAGGGA,327,333,6,26,19177,0,0
19627,ACGTCGAATCTAGGGA,327,353,26,29,19178,6,0
19628,ACGTCGAATCTAGGGA,328,330,2,28,17074,0,0
19629,ATGTCGAATCTAGGGA,328,341,13,21,17246,2,0
19630,ACGTCGAATCTAGGGA,328,352,24,28,17255,6,0
19631,ACGTCGAATCTAGGGA,328,331,3,24,17274,0,0
19632,ACGTCGAATCTAGGGA,328,331,3,26,17451,0,0
19633,ACGTCGAATCTAGGGT,328,331,3,21,17603,0,0
19634,ACGTCGAATCTAGGGA,328,331,3,24,17699,0,0
19635,ACTTCGAATCTAGGGA,328,331,3,19,17762,0,0
19636,ACGTCGAATCTAGGGA,328,331,3,20,17787,0,0
19637,ACGTCGAAAGTAGGGA,328,331,3,22,18064,0,0
19638,ACGTCGAATCTAGGGA,328,331,3,19,18184,0,0
19639,ACGTCGAATCTAGGGA,328,328,0,27,18185,0,0
19640,ACGTCGAATCTAGGGA,328,329,1,24,18326,0,0
19641,ACGTCGAATCTAGGGA,328,328,0,28,18334,0,0
19642,ACGTCGAAAGTAGGGA,328,328,0,24,18337,0,0
19643,ACGTCGAATCTAGGGT,328,329,1,22,18500,0,0
19644,TCGTCGAATCTAGGGA,328,331,3,25,18507,0,0
19645,ACGTCGAATCTTGGGA,328,331,3,19,18523,0,0
19646,ACGTCGAATCTAGGGA,328,330,2,24,18529,0,0
19647,ACGTCGAATCTAGGGA,328,331,3,20,18702,0,0
19648,ACGTCGAATCTAGGGA,328,331,3,19,18703,0,0
19649,ACGTCGAATCTAGGGA,328,331,3,24,18712,0,0
19650,ACGTCGAATCTAGGGA,328,331,3,25,18716,0,0
19651,ACGTCGAATCTAGGGA,328,328,0,25,18721,0,0
19652,ACGTCGAGTCTAGGGA,328,331,3,28,18723,0,0
19653,ACGTCGATTCTGGGGA,328,331,3,23,18725,0,0
19654,ACGTCGAATCTAGGGA,328,331,3,24,18727,0,0
19655,ACGTCGAATCTAGGGA,328,331,3,27,18728,0,0
19656,ACGTCGAATCTAGGGA,328,328,0,20,18886,0,0
19657,ACGTCGAATCTAGGGA,328,331,3,19,18894,0,0
19658,ACGTCGAATCTAGGGA,328,331,3,26,18895,0,0
19659,ACGTCCAATCTAGGGA,328,331,3,21,18897,0,0
19660,ACGTCGAATCTAGGGA,328,331,3,25,19035,0,0
19661,ACGTCGAATCCAGGGA,328,331,3,27,19149,0,0
19662,ACGTCGAATCTAGGGA,328,331,3,28,19153,0,0
19663,ACGTCGAGTCTAGGGA,328,328,0,29,19154,0,0
19664,ACGTAGATTCTGGGGA,328,331,3,24,19155,0,0
19665,ACGTCGAATCTAGGGA,328,331,3,21,19210,0,0
19666,ACGTCGAATCTAGGGA,328,331,3,25,19212,0,0
19667,ACGTCGAATCTAGGGA,328,331,3,28,19213,0,0
19668,ACGTCGACTCTAGGGA,328,331,3,22,19214,0,0
19669,ACGTCGAATCTAGGGA,328,331,3,25,19216,0,0
19670,ACGTCGAATCTAGGGA,328,331,3,19,19218,0,0
19671,ACGTCGAATCTAGGGA,328,331,3,20,19221,0,0
19672,ACATCGAATCTAGGGA,328,330,2,27,19222,0,0
19673,ACGTCGAATCTAGGGA,328,331,3,26,19224,0,0
19674,ACGTCGAATCTATGGA,328,331,3,27,19225,0,0
19675,ACGTCGAATCTAGGGA,328,329,1,27,19226,0,0
19676,ACGTCGAATCTAGGGA,328,331,3,26,19228,0,0
19677,ACGTCGAATCTAGGGA,328,331,3,25,19229,0,0
19678,ACGTCGAATCTAGGGA,328,330,2,26,19230,0,0
19679,ACGTCGAATCTAGGGA,328,331,3,23,19231,0,0
19680,ACGTCGAATCTAGGCA,328,331,3,25,19232,0,0
19681,ACGTCGAATGTAGGGA,328,330,2,26,19233,0,0
19682,ACGTTGAATCTAGGGA,328,331,3,30,19234,0,0
19683,ACGTCGAATCTAGGGA,328,331,3,22,19236,0,0
19684,ACGTCGAATCTAGGGA,328,330,2,24,19238,0,0
19685,ACGTCGAATCTAGGGA,328,331,3,20,19240,0,0
19686,ACGTCGAATCTAGGGA,328,328,0,27,19241,0,0
19687,ACGTCGAATGTAGGGA,328,331,3,24,19242,0,0
19688,ACGTCGACTCTAGGGA,328,331,3,25,19244,0,0
19689,ACGTCGAATCTAGGGA,329,335,6,23,16803,0,0
19690,ACGTCGAATCTAGGGA,329,333,4,21,17661,0,0
19691,ACGTCGAATCTAGGGA,329,339,10,22,18023,1,0
19692,ACGTCGATTCTGGGGA,329,334,5,22,18030,0,0
19693,ACGTCGAATCTAGGGA,329,330,1,29,18036,0,0
19694,ACGTTGAATTTAGGGA,329,329,0,28,18038,0,0
19695,ACGTTGAATCTAGGGA,329,335,6,27,18204,0,0
19696,ACGTCGAATCTAGGGA,329,342,13,24,18311,2,0
19697,ACGTCGATTCTGGGGA,329,337,8,22,18388,1,0
19698,ACGTCGAATCTAGGGA,329,329,0,23,18390,0,0
19699,TCGTCGAATCTAGGGA,329,329,0,25,18404,0,0
19700,ACGTCGAATCTAGGGA,329,331,2,25,18409,0,0
19701,ACGTCGAATCTAGGGA,329,333,4,25,18567,0,0
19702,ACATCGAATCTAGGGA,329,341,12,27,18568,2,0
19703,ACGTTGAATCTAGGGA,329,340,11,28,18570,2,0
19704,TCGTCGAATCTAGGGA,329,331,2,24,18673,0,0
19705,ACGTTGAATCTAGGGA,329,339,10,27,18675,1,0
19706,ACGTCGAATCTAGGGA,329,333,4,25,18680,0,0
19707,ACGTCGAATCTAGGGA,329,334,5,21,18681,0,0
19708,ACGTCGAATCGAGGGA,329,338,9,21,18685,1,0
19709,ACGTCGAATCTAGGGA,329,334,5,29,18743,0,0
19710,ACGTCGAATGTAGGGA,329,335,6,22,18745,0,0
19711,ACGTCGAATCTAGGGA,329,332,3,22,18747,0,0
19712,ACGTCGAATCTAGGGA,329,330,1,27,18929,0,0
19713,ACGTCGAATCTAGGGA,329,335,6,20,18932,0,0
19714,ACGTCGAATCTAGGGA,329,339,10,22,18937,1,0
19715,ACGTCGACTCTAGGGA,329,329,0,25,18941,0,0
19716,ACGTTGAATCTAGGGA,329,333,4,29,18942,0,0
19717,AGGTCGAATCTAGGGA,329,330,1,23,18943,0,0
19718,TCGTCGAATCTATGGA,329,333,4,26,18945,0,0
19719,TCGTCGAATCTAGGGA,329,338,9,25,18960,1,0
19720,ACGTCGAATCTAGGGA,329,349,20,19,19040,5,0
19721,ACGTCGAATCTAGGGA,329,329,0,29,19094,0,0
19722,ACGTCGAATCTAGGGA,329,329,0,25,19095,0,0
19723,ACATCGAATCTAGGGA,329,336,7,27,19096,0,0
19724,ACGTCGAATCTAGGGT,329,337,8,22,19099,1,0
19725,ACGTCGAATCTAGGGA,329,350,21,25,19101,5,0
19726,ACGTCGAAAGCAGGGA,329,329,0,22,19104,0,0
19727,ACGTCGACTCTAGGGA,329,333,4,24,19105,0,0
19728,ACGTCGAATCTAGGGA,329,332,3,21,19106,0,0
19729,ACGTCGAATCTAGGGA,329,329,0,29,19107,0,0
19730,ACGTCGAATCTAGGGA,329,329,0,22,19108,0,0
19731,ACGTTGAATCTAGGGA,329,330,1,29,19111,0,0
19732,ACGTTGAATCTAGGGA,329,336,7,24,19114,0,0
19733,ACGTCGAATCTAGGGA,329,330,1,24,19115,0,0
19734,ACGTCGAATCTAGGGA,329,359,30,27,19116,8,0
19735,ACGTCGAATCTAGGGA,329,357,28,28,19123,7,0
19736,ACGTCGAATCTAGGGT,329,331,2,23,19124,0,0
19737,ACGTCGAAAGTAGGGA,329,333,4,25,19130,0,0
19738,ACGTCGAATCTAGGGA,329,330,1,22,19131,0,0
19739,ACGTCGAATCTAGGGA,329,343,14,25,19135,3,0
19740,ACGTCGAATCTAGGGA,329,331,2,26,19137,0,0
19741,ACGTCGAATCTTGGGA,329,338,9,20,19138,1,0
19742,ACGTCGAATCTAGGGA,329,333,4,25,19139,0,0
19743,ACGTCGAATCTAGGGA,329,335,6,21,19140,0,0
19744,ACGTCGAATCTAGGGA,329,392,63,25,19147,19,0
19745,ACGTCGAATCTAGGGA,329,340,11,29,19280,2,0
19746,ACGTCGCTTCTGGGGA,329,337,8,22,19281,1,0
19747,ACGTCGAATCTAGGGA,329,337,8,27,19287,1,0
19748,ACGTCGAATCTAGGGA,329,345,16,20,19290,3,0
19749,ACGTCGACTCTAGGGA,329,331,2,24,19291,0,0
19750,ACGTCGAATCTAGGGA,329,336,7,21,19292,0,0
19751,ACGTCGAATCTAGGGA,329,332,3,29,19293,0,0
19752,ACGTCGACTCTAGGGA,329,330,1,25,19295,0,0
19753,ACGTTGAATCTAGGGA,329,341,12,29,19296,2,0
19754,ACGTCGAAAGTAGGGA,329,338,9,23,19298,1,0
19755,ACGTCGAATCTAGGGA,329,332,3,27,19301,0,0
19756,ACGTCGAATCTAGGGA,329,329,0,23,19303,0,0
19757,ACGTCGAATGTAGGGA,329,329,0,24,19304,0,0
19758,TCGTCGAATCTAGGGA,329,367,38,25,19307,11,0
19759,ACGTCGAATCTAGGGA,329,334,5,25,19308,0,0
19760,ACGTCGAATCTAGGGT,329,329,0,23,19311,0,0
19761,ACGTCGAATCTAGGGA,329,338,9,27,19312,1,0
19762,ACGTCGAATTTAGGGA,330,334,4,20,16474,0,0
19763,TCGTCGAATCTAGGGA,330,357,27,23,16667,8,0
19764,ACGTCGAATCTTGGGA,330,338,8,18,17548,1,0
19765,ACGTCGAATCTAGGGA,330,333,3,23,17550,0,0
19766,ACGTCGAATCTAGGGA,330,344,14,19,17554,3,0
19767,ACGTCGAATCTAGGGA,330,336,6,26,17577,0,0
19768,ACGTCGAATGTAGGGA,330,345,15,22,17823,3,0
19769,ACGTCGAATCTAGGGA,330,330,0,26,17918,0,0
19770,ACGTCGAATCTAGGGA,330,349,19,25,18082,4,0
19771,ACGTCGAATCTAGGGA,330,358,28,25,18279,7,0
19772,ACGTCGAATGTAGGGA,330,332,2,25,18296,0,0
19773,ACGTCGAATCTAGGGA,330,330,0,23,18446,0,0
19774,ACGTCGAATGTAGGGA,330,331,1,23,18631,0,0
19775,ACGGTGAATCTAGGGA,330,331,1,29,18660,0,0
19776,ACGTCGAATCTAGGGA,330,336,6,30,18662,0,0
19777,ACGTCGAATCTAGGGA,330,336,6,26,18666,0,0
19778,ACGTCGACTCTAGAGA,330,400,70,25,18670,21,0
19779,ACGTCGAATCTAGGGA,330,342,12,24,18812,2,0
19780,ACGTCGAATCTTGGGA,330,333,3,26,18825,0,0
19781,ACGTCGATTCTGGGGA,330,331,1,23,18830,0,0
19782,CCGTCGCATCTAGGGA,330,341,11,22,18833,2,0
19783,ACGTCTACTCTAGGGA,330,337,7,24,18834,0,0
19784,ACGTCGAATCTAGGGA,330,333,3,25,18840,0,0
19785,ACGTCGATTCTGGGGA,330,346,16,22,18842,3,0
19786,ACGTCGAATGTAGGGA,330,330,0,23,18845,0,0
19787,ACGTCGAATCTAGGGA,330,340,10,23,18853,1,0
19788,TCGTCGAATCTAGGGA,330,332,2,26,18854,0,0
19789,ACGTCGAATCTAGGGA,330,333,3,26,18985,0,0
19790,ACGTCTACTCTAGGGA,330,331,1,24,18994,0,0
19791,ACGTCGAATCTAGGGA,330,339,9,25,18997,1,0
19792,ACGTCGAATCTAGGGA,330,333,3,24,19002,0,0
19793,ACGTCGAATCTAGGGA,330,333,3,24,19005,0,0
19794,TCGTCGAATCTAGGGA,330,333,3,26,19007,0,0
19795,ACGTCGAATCTAGGGA,330,333,3,23,19012,0,0
19796,ACATCGAATCTAGGGA,330,333,3,28,19014,0,0
19797,ACGTCGAATCTAGGGA,330,333,3,22,19017,0,0
19798,ACGTCGACTCTAGGGA,330,333,3,23,19021,0,0
19799,ACGTCGAATGTAGGGA,330,333,3,23,19158,0,0
19800,ACGTCGAATGTTGGGA,330,333,3,18,19159,0,0
19801,ACGTCGAATCTAGGGA,330,333,3,24,19160,0,0
19802,ACGTCGAATCTAGGGA,330,333,3,22,19162,0,0
19803,ACGTTGAATCTAGGGA,330,333,3,28,19170,0,0
19804,TCGTCGAATCTAGGGA,330,333,3,26,19176,0,0
19805,ACGTCGAATCTAGGGA,330,333,3,29,19178,0,0
19806,ACGTCGAATCTTGGGA,330,331,1,27,19245,0,0
19807,ACGTCGAATCTAGGGA,330,330,0,26,19247,0,0
19808,ACGTCGAATCTAGGGA,330,333,3,23,19344,0,0
19809,ACGTCGATTCTGGGGA,330,333,3,23,19345,0,0
19810,ACGTCGAATCTAGGGA,330,333,3,30,19346,0,0
19811,ACGTTGAATCTAGGGA,330,333,3,28,19348,0,0
19812,ACGTCGATTCTGGGGA,330,330,0,23,19350,0,0
19813,ACGTCGAATCTAGGGA,330,332,2,24,19351,0,0
19814,TCGTCGAATCTAGGGA,330,332,2,26,19353,0,0
19815,ACGTCGAATCTAGGGA,330,333,3,23,19355,0,0
19816,ACATCGAATCTAGGGA,330,333,3,28,19357,0,0
19817,TCGTCGAATCTAGGGA,330,333,3,25,19361,0,0
19818,ACGTCGAATCTAGGGA,330,333,3,26,19362,0,0
19819,ACGTCGAATCTAGGGA,331,355,24,28,17074,6,0
19820,ACGTCGAATCTAGGGA,331,338,7,21,17246,0,0
19821,ACGTCGAATCTAGGGA,331,333,2,28,17255,0,0
19822,ACGTCGAATCTAGGGA,331,363,32,26,17451,9,0
19823,ACGTCGAATCTAGGGT,331,331,0,21,17603,0,0
19824,ACGTCGAATCTAGGGA,331,332,1,24,17699,0,0
19825,ACGTCGAATCTAGGGA,331,333,2,19,17762,0,0
19826,ACGTCGAATCTAGGGA,331,340,9,20,17787,1,0
19827,ACGTCGAATCTAGGGA,331,331,0,19,18184,0,0
19828,ACGTCGAATCTAGGGA,331,341,10,27,18185,1,0
19829,ACGTCGAATCTAGGGA,331,347,16,24,18326,3,0
19830,ACGTCGAATCTAGGGT,331,333,2,22,18500,0,0
19831,TCGTCGAATCTAGGGA,331,339,8,25,18507,1,0
19832,ACGTCGAATCTTGGGA,331,337,6,19,18523,0,0
19833,ACGTCGAATCTAGGGA,331,342,11,24,18529,2,0
19834,ACGTCGCATCTAGGGA,331,346,15,20,18702,3,0
19835,ACGTCGAATCTAGGGA,331,340,9,19,18703,1,0
19836,ACGTCGAATCTAGGGA,331,336,5,25,18716,0,0
19837,ACGTCGAATCTAGGGA,331,333,2,25,18721,0,0
19838,ACGTCGAGTCTAGGGA,331,333,2,28,18723,0,0
19839,ACGTCGATTCTGGGGA,331,342,11,23,18725,2,0
19840,ACGTCGAATCTAGGGA,331,334,3,24,18727,0,0
19841,ACGTCGAATCTAGGGA,331,343,12,27,18728,2,0
19842,ACGTCGAATCTAGGGA,331,338,7,19,18894,0,0
19843,ACGTCGAATCTAGGGA,331,338,7,26,18895,0,0
19844,ACGTCCAATCTAGGGA,331,332,1,21,18897,0,0
19845,ACGTCGAGTCTAGGGA,331,335,4,29,19154,0,0
19846,ACGTCGATTCTGGGGA,331,353,22,24,19155,5,0
19847,ACGTCGAATCTAGGGA,331,350,19,21,19210,4,0
19848,ACGTCGAATCTAGGGT,331,340,9,25,19212,1,0
19849,ACGTCGAATCTAGGGA,331,383,52,28,19213,15,0
19850,ACGTCGACTCTAGGGA,331,343,12,22,19214,2,0
19851,ACGTCGAATCTAGGGA,331,337,6,19,19218,0,0
19852,ACGTCGAATCTAGGGA,331,339,8,27,19222,1,0
19853,ACGTCGAATCTAGGGC,331,335,4,26,19224,0,0
19854,ACGTCGAATCTAGGGA,331,333,2,27,19225,0,0
19855,ACGTCGAATCTAGGGA,331,347,16,27,19226,3,0
19856,ACGTCGAATCTAGGGA,331,334,3,26,19228,0,0
19857,ACGTCGAATCTAGGGA,331,365,34,23,19231,9,0
19858,ACGTCGAATCTAGGGA,331,337,6,25,19232,0,0
19859,ACGTCGAATGTAGGGA,331,333,2,26,19233,0,0
19860,ACGTCGAATCTAGGGA,331,331,0,20,19240,0,0
19861,ACGTCGAATCTAGGGA,331,337,6,27,19241,0,0
19862,ACGTCGAATGTAGGGA,331,349,18,24,19242,4,0
19863,TCGTCGAATCTAGGGA,331,349,18,26,19313,4,0
19864,ATGTCGAATCTAGGGA,331,357,26,25,19314,7,0
19865,ACGTCGAATCTTGGGA,331,334,3,20,19315,0,0
19866,ACGTCGAATCTAGGGA,331,337,6,21,19398,0,0
19867,TCGTCGAATCTAGGGA,331,334,3,24,19399,0,0
19868,ACGTCGAATCTAGGGA,331,333,2,25,19400,0,0
19869,ACGTCGAATCTAGGGA,331,334,3,28,19401,0,0
19870,ACGTCGAATCTAGGGA,331,334,3,27,19402,0,0
19871,ACGTCGAATCTTGGGA,331,342,11,19,19404,2,0
19872,ACGTCGAATCTAGGGA,331,338,7,24,19405,0,0
19873,ACGTCGAATCTAGGGA,331,361,30,20,19406,8,0
19874,ACGTCGGATCTAGGGA,331,335,4,23,19411,0,0
19875,ACGTCGAATCTAGGGA,331,336,5,26,19414,0,0
19876,ACGTCGAATGTAGGGA,331,342,11,26,19415,2,0
19877,ACGTCGAATCTAGGGA,331,337,6,24,19416,0,0
19878,ACGTCGAATCTAGGGA,331,335,4,27,19420,0,0
19879,ACGTCGACTCTAGGGA,331,344,13,25,19421,2,0
19880,ACCTCGAATCTAGGGA,331,332,1,27,19424,0,0
19881,ACGTCGAATCTAGGGA,331,342,11,25,19426,2,0
19882,ACGTCGAATCTAGGGA,331,348,17,24,19427,4,0
19883,ACGTCGATTCTGGGGA,331,337,6,24,19430,0,0
19884,ACGTCGAATCTAGGGA,332,336,4,21,17661,0,0
19885,ACGTCGAATCTAGGGA,332,334,2,22,18023,0,0
19886,ACGTCGATTCTAGGGA,332,351,19,22,18030,4,0
19887,ACGTCGAATCTAGGGA,332,334,2,29,18036,0,0
19888,ACGTTGAATCTAGGGA,332,335,3,28,18038,0,0
19889,ACGTTGAATCTAGGGA,332,332,0,27,18204,0,0
19890,ACGTCGATTCTGGGGA,332,335,3,22,18388,0,0
19891,ACGTCGAATCTAGGGA,332,334,2,23,18390,0,0
19892,TCGTCGAATCTAGGGA,332,335,3,25,18404,0,0
19893,ACATCGAATCTAGGGA,332,335,3,27,18568,0,0
19894,ACGTTGAATCTAGGGA,332,335,3,28,18570,0,0
19895,TCGTCGAATCTAGGGA,332,335,3,24,18673,0,0
19896,ACGTCGAATCTAGGGA,332,335,3,27,18675,0,0
19897,ACGTCGAATCTAGGGA,332,335,3,25,18680,0,0
19898,ACGTCGAATCTAGGGA,332,335,3,21,18681,0,0
19899,ACGTCGAATCGAGGGA,332,335,3,21,18685,0,0
19900,ACGTCGAATCTAGGGA,332,335,3,27,18929,0,0
19901,ACGTCGAATCTAGGGA,332,335,3,20,18932,0,0
19902,ACGTCGAATCTAGGGA,332,335,3,23,18943,0,0
19903,TCGTCGAATCTAGGGA,332,335,3,26,18945,0,0
19904,ACGTCGAATCTAGGGA,332,335,3,29,19094,0,0
19905,ACATCGAATCTAGGGA,332,335,3,27,19096,0,0
19906,ACGTCGAATCTAGGGT,332,335,3,22,19099,0,0
19907,ACGTCGAATCTAGGGA,332,335,3,25,19101,0,0
19908,ACGTCGAAAGCAGGGA,332,335,3,22,19104,0,0
19909,ACGTCGAATCTAGGGA,332,335,3,21,19106,0,0
19910,ACGTCGAATCTAGGGA,332,335,3,29,19107,0,0
19911,ACGTTGAATCTAGGGA,332,334,2,29,19111,0,0
19912,ACGTTGAATCTAGGGA,332,335,3,24,19114,0,0
19913,ACGTCGAATCTAGGGA,332,335,3,24,19115,0,0
19914,ACGTCGAATCTAGGGA,332,335,3,27,19116,0,0
19915,ACGTCGAATCTAGGGA,332,335,3,28,19123,0,0
19916,ACGTCGAAAGTAGGGA,332,335,3,25,19130,0,0
19917,ACGTCGAATCTAGGGA,332,332,0,22,19131,0,0
19918,ACGTCGAATCTTGGGA,332,335,3,20,19138,0,0
19919,ACGTCGAATCTAGGGA,332,335,3,25,19147,0,0
19920,ACGTCGATTCTGGGGA,332,335,3,22,19281,0,0
19921,ACGTCGACTCTAGGGA,332,335,3,24,19291,0,0
19922,ACGTCGAATCTAGGGA,332,335,3,21,19292,0,0
19923,ACGTCGACTCTAGGGA,332,333,1,25,19295,0,0
19924,ACGTTGAATCTAGGGA,332,334,2,29,19296,0,0
19925,ACGTCGAAAGTAGGGA,332,335,3,23,19298,0,0
19926,ACGTCGAATGTAGGGA,332,335,3,24,19304,0,0
19927,ACGTCGAATCTAGGGA,332,335,3,25,19308,0,0
19928,ACGTCGAATCTAGGGT,332,334,2,23,19311,0,0
19929,ACGTCGAATCTAGGGA,332,333,1,27,19312,0,0
19930,ACGTCGATTCTGGGGA,332,335,3,22,19462,0,0
19931,ACGTCGAATCTAGGGA,332,332,0,22,19463,0,0
19932,ACGTCGAATCTAGGGA,332,335,3,25,19465,0,0
19933,ACGTCGAATCTAGGGA,332,332,0,27,19466,0,0
19934,ACGTCGAATCTAGGGA,332,335,3,27,19468,0,0
19935,ACGTCGAATCTAGTGA,332,335,3,20,19470,0,0
19936,ACGTCGAATCTAGGGA,332,333,1,21,19472,0,0
19937,ACGTCGAATCTAGGGA,333,358,25,20,16474,6,0
19938,TCGTCGAATCTAGGGA,333,335,2,23,16667,0,0
19939,ACGTCGAATCTTGGGA,333,333,0,18,17548,0,0
19940,ACGTCGAATCTAGGGA,333,336,3,19,17554,0,0
19941,ACGTCGAATCTAGGGA,333,342,9,25,18279,1,0
19942,ACGTCGAATCTAGGGA,333,350,17,23,18446,4,0
19943,ACGTCGAATGTAGGGA,333,357,24,23,18631,6,0
19944,ACGTTGAATCTAGGGA,333,339,6,29,18660,0,0
19945,ACGTCGAATCTAGGGA,333,334,1,26,18666,0,0
19946,ACGTCGACTCTAGGGA,333,336,3,25,18670,0,0
19947,ACGTCGAATCTAGGGA,333,338,5,24,18812,0,0
19948,ACGTCGAATCTTGGGA,333,340,7,26,18825,0,0
19949,ACGTCGATTCTGGGGA,333,339,6,23,18830,0,0
19950,ACGTCTACTCTAGGGA,333,351,18,24,18834,4,0
19951,ACGTCGAATCTAGGTA,333,334,1,25,18840,0,0
19952,ACGTCGATTCTGGGGA,333,338,5,22,18842,0,0
19953,ACGTCGAATGTAGGGA,333,356,23,23,18845,6,0
19954,TCGTCGAATCTAGGGA,333,358,25,26,18854,6,0
19955,ACGTCGAATCTAGGGA,333,341,8,26,18985,1,0
19956,ACGTCGAATCTAGGGA,333,340,7,24,19005,0,0
19957,TCGTCGAATCTAGGGA,333,338,5,26,19007,0,0
19958,ACATCGAATCTAGGGA,333,333,0,28,19014,0,0
19959,ACGTCGAATCTTGGGA,333,354,21,22,19017,5,0
19960,ACGTCGACTCTAGGGA,333,338,5,23,19021,0,0
19961,ACGTCGAATCTTGGGA,333,334,1,18,19159,0,0
19962,ACGGCGAATCTAGGGA,333,342,9,24,19160,1,0
19963,ACGTTGAATCTAGGGA,333,340,7,28,19170,0,0
19964,TCGTCGAATCTAGGGA,333,334,1,26,19176,0,0
19965,ACGTCGAATCTAGGGA,333,333,0,29,19178,0,0
19966,ACGTCGAATCTAGGGA,333,346,13,26,19247,2,0
19967,ACGTCGAATCTAGGGA,333,336,3,23,19344,0,0
19968,ACGTCGAATCTAGGGA,333,334,1,30,19346,0,0
19969,ACGTCGATTCTGGGGA,333,339,6,23,19350,0,0
19970,ACGTCGAATCTAGGGA,333,336,3,24,19351,0,0
19971,TCGTCGAATCTAGGGA,333,367,34,26,19353,9,0
19972,ACATCGAATCTAGGGA,333,336,3,28,19357,0,0
19973,TCGACGAATCTAGGGA,333,337,4,25,19361,0,0
19974,ACGGCTACTCTAGGGA,333,337,4,25,19433,0,0
19975,ACGTCGAATCTAGGGA,333,341,8,24,19441,1,0
19976,TCGTCGAGTCTAGGGA,333,333,0,27,19442,0,0
19977,ACGTCGTATCTAGGGA,333,336,3,31,19444,0,0
19978,ACGTCGAATCTAGGGA,333,335,2,23,19445,0,0
19979,ACGTCGAATCTAGGGA,333,355,22,23,19505,5,0
19980,ACGTCGATTCTGGGGA,333,348,15,23,19506,3,0
19981,ACGTTGAATCTAGGGA,333,342,9,29,19508,1,0
19982,ACGTCGAATCTAGGGA,333,335,2,25,19510,0,0
19983,ACGTCGAATCTAGGGA,333,351,18,24,19512,4,0
19984,ACGTCGAATCTAGGGA,333,340,7,23,19513,0,0
19985,ACGTTGAATCTAGGGA,333,343,10,28,19522,1,0
19986,ACGTCGAATCTAGGGA,333,333,0,26,19525,0,0
19987,ACGTCGAATGTAGGGA,333,342,9,23,19528,1,0
19988,ACGTCGAATCTAGGGA,334,352,18,28,17074,5,0
19989,ACGTCGAATCTAGGGA,334,340,6,21,17246,1,0
19990,ACGTCGAATCTAGGGA,334,359,25,28,17255,7,0
19991,ACGTCGAATCTAGGGA,334,375,41,26,17451,12,0
19992,ACGTCGAATCTAGGGT,334,340,6,21,17603,1,0
19993,ACGTCGAATCTAGGGA,334,365,31,24,17699,9,0
19994,ACGTCGAATCTAGGGA,334,342,8,20,17787,1,0
19995,ACGTCGAATCTAGGGA,334,334,0,19,18184,0,0
19996,ACGTCGAATCTAGGGA,334,362,28,27,18185,8,0
19997,ACGTCGAATCTAGGGA,334,336,2,24,18326,0,0
19998,TCGTCGAATCTAGGGA,334,364,30,25,18507,9,0
19999,ACGTCGAATCTAGGGA,334,335,1,24,18529,0,0
20000,ACGTCGAATCTAGGGA,334,335,1,20,18702,0,0
20001,ACGTCGAATCTAGGGA,334,342,8,19,18703,1,0
20002,ACGTCGAATCTAGGGA,334,335,1,25,18716,0,0
20003,ACGTCGAGTCTAGGGA,334,351,17,28,18723,4,0
20004,ACGTCGAATCTAGGGA,334,395,61,24,18727,18,0
20005,ACGTCGAATCTAGGGA,334,336,2,26,18895,0,0
20006,ACGTCGAGTCTAGGGA,334,335,1,29,19154,0,0
20007,ACGTCGAATCTAGGGA,334,335,1,21,19210,0,0
20008,ACGTCGAATCTAGGGA,334,337,3,28,19213,0,0
20009,ACGTCGAATCTAGGGA,334,336,2,19,19218,0,0
20010,ACGTCGAATCTATGGA,334,347,13,27,19222,2,0
20011,ACGTCGAATCTAGGGA,334,337,3,27,19225,0,0
20012,ACGTCGAATCTAGGGA,334,336,2,27,19226,0,0
20013,ACGTCGAATCTAGGGA,334,334,0,26,19228,0,0
20014,ACGTCGAATCTAGGGA,334,343,9,23,19231,1,0
20015,ACGTCGAATCTAGGGA,334,336,2,25,19232,0,0
20016,ACGTCGAATGTAGGGA,334,334,0,26,19233,0,0
20017,ACGTCGAATCTAGGGA,334,336,2,27,19241,0,0
20018,ACGTCGAATCTAGGGA,334,342,8,21,19398,1,0
20019,TCGTCGAATCTAGGGA,334,337,3,24,19399,0,0
20020,ACGTCGAATCTAGGGA,334,347,13,25,19400,2,0
20021,ACGTCGAATCTAGGGA,334,334,0,24,19405,0,0
20022,ACGTCGAATCTAGGGA,334,350,16,20,19406,3,0
20023,ACGTCGAATCTAGGGA,334,350,16,26,19414,3,0
20024,ACGTCGAATGTAGGGA,334,348,14,26,19415,3,0
20025,ACGTCGAATCTAGGGA,334,334,0,24,19416,0,0
20026,ACGTCGACTCTAGGGA,334,359,25,25,19421,6,0
20027,ACGTCGAATCTAGGGA,334,344,10,25,19426,1,0
20028,ACGTCGAATCTAGGGA,334,339,5,24,19427,0,0
20029,ACGTCGAAAGTAGGGA,334,339,5,23,19473,0,0
20030,ACGTCGAATCTAGGGA,334,362,28,21,19575,7,0
20031,ACGTCGAATCTAGGGA,334,338,4,26,19583,0,0
20032,ACGTCGAATGTAGGGA,334,352,18,26,19585,4,0
20033,ACGTCGAATCTAGGGA,334,359,25,24,19586,6,0
20034,ACGTCGAATGTAGGGA,334,336,2,24,19587,0,0
20035,ACGTTGAATCTAGGGA,334,356,22,30,19588,5,0
20036,ACGTCGAATCTAGGGA,334,338,4,27,19590,0,0
20037,ACGTCGAATCTAGGGA,334,337,3,25,19592,0,0
20038,ACGTCGATTCTGGGGA,334,337,3,24,19594,0,0
20039,ACGTCGAATCTAGGGA,334,334,0,26,19597,0,0
20040,ACGTCGAATCTAGGGA,334,337,3,25,19598,0,0
20041,ACGTCGAATCTAGGGA,334,335,1,24,19602,0,0
20042,TCGTCGAATCTAGGGA,334,337,3,27,19603,0,0
20043,ACGTCGAATCTAGGGA,334,337,3,31,19604,0,0
20044,ACGTCGAATCTAGGGA,334,336,2,23,19605,0,0
20045,ACGTCGAATGTAGGGA,334,335,1,24,19606,0,0
20046,ACGTCGAATCTAGGGA,334,337,3,27,19607,0,0
20047,ACGTCGAATCTAGGGA,334,337,3,25,19610,0,0
20048,ACGTCGAATCTAGGGA,335,336,1,21,17661,0,0
20049,ACGTCGAATCTAGGGA,335,338,3,22,18023,0,0
20050,ACGTCGATTCTGGGGA,335,377,42,22,18030,12,0
20051,ACGTTGAATCTAGGGA,335,341,6,28,18038,0,0
20052,ACGTTGAATCTAGGGA,335,341,6,27,18204,0,0
20053,ACGTCGATTCTGGGGA,335,337,2,22,18388,0,0
20054,TCGTCGAATCTAGGGA,335,341,6,25,18404,0,0
20055,ACATCGAATCTAGGGA,335,339,4,27,18568,0,0
20056,ACGTTGAATCTAGGGA,335,349,14,28,18570,3,0
20057,ACGTTGAATCTAGGGA,335,346,11,27,18675,2,0
20058,ACGTCGAATCTAGGGA,335,341,6,25,18680,0,0
20059,ACGTCGAATCTAGGGA,335,356,21,21,18681,5,0
20060,ACGTCGAATCTAGGGA,335,335,0,27,18929,0,0
20061,ACGTCGAATCTAGGGA,335,335,0,20,18932,0,0
20062,ACGTCGAATCTAGGGA,335,361,26,23,18943,7,0
20063,TCGTCGAATCTAGGGA,335,346,11,26,18945,2,0
20064,ACATCGAATCTAGGGA,335,337,2,27,19096,0,0
20065,ACGTCGAATCTAGGGT,335,337,2,22,19099,0,0
20066,ACGTCGAATCTAGGGA,335,338,3,25,19101,0,0
20067,ACGTCGAAAGCAGGGA,335,374,39,22,19104,11,0
20068,ACGTCGAATCTAGGGA,335,341,6,21,19106,0,0
20069,ACGTTGAATCTAGGGA,335,337,2,29,19111,0,0
20070,ACGTTGAATCTAGGGA,335,339,4,24,19114,0,0
20071,ACGTCGAATCTAGGGA,335,374,39,24,19115,11,0
20072,ACGTCGAATCTAGGGA,335,338,3,28,19123,0,0
20073,ACGTCGAAAGTAGGGA,335,338,3,25,19130,0,0
20074,ACGTCGAATCTAGGGA,335,338,3,22,19131,0,0
20075,ACGTCGAATCTAGGGA,335,337,2,25,19147,0,0
20076,ACGTCGATTCTGGGGA,335,337,2,22,19281,0,0
20077,ACGTCGAATCTAGGGA,335,338,3,21,19292,0,0
20078,ACGTCGACTCTAGGGA,335,336,1,25,19295,0,0
20079,ACGTTGAATCTAGGGA,335,337,2,29,19296,0,0
20080,ACGTCGAATGTAGGGA,335,338,3,24,19304,0,0
20081,ACGTCGAATCTAGGGA,335,338,3,25,19308,0,0
20082,ACGTCGATTCTGGGGA,335,335,0,22,19462,0,0
20083,ACGTCGAATCTAGGGA,335,338,3,22,19463,0,0
20084,ACGTCGAATCTAGGGA,335,338,3,25,19465,0,0
20085,ACGTCGAATCTAGGGA,335,338,3,21,19472,0,0
20086,ACGTCGAATCTAGGGA,335,338,3,25,19611,0,0
20087,ATGTCGAATCTAGGGA,335,338,3,22,19629,0,0
20088,ACGTCGAATCTAGGGA,335,337,2,29,19630,0,0
20089,TCGTCGAATCTAGGGA,335,338,3,24,19763,0,0
20090,TCGTCGAATCTAGGGA,336,344,8,23,16667,1,0
20091,ACGTCGAATCTTGGGA,336,352,16,18,17548,3,0
20092,ACGTCGAATCTAGGGA,336,350,14,19,17554,3,0
20093,ACGTCGAATCTAGGGA,336,352,16,25,18279,3,0
20094,ACGTCGAATCTAGGGA,336,336,0,23,18446,0,0
20095,ACGTTGAATCTAGGAA,336,348,12,29,18660,2,0
20096,ACGTCGAATCTAGGGA,336,339,3,26,18666,0,0
20097,ACGTCGACTCTAGGGA,336,341,5,25,18670,0,0
20098,GCGTCGAATCTAGGGA,336,354,18,24,18812,4,0
20099,ACGTCGAATCTTGGGA,336,336,0,26,18825,0,0
20100,ACGTCGATTCTGGGGA,336,345,9,23,18830,1,0
20101,ACGTCTACTCTAGGGA,336,336,0,24,18834,0,0
20102,ACGTCGAATCTAGGGA,336,343,7,25,18840,0,0
20103,ACGTCGATTCTGGGGA,336,346,10,22,18842,1,0
20104,ACGTCGAATGTAGGGA,336,336,0,23,18845,0,0
20105,TCGTCGAATCTAGGGA,336,351,15,26,18854,3,0
20106,ACGTCGAATCTAGGGA,336,346,10,24,19005,1,0
20107,ACATCGAATCTAGGGA,336,336,0,28,19014,0,0
20108,ACGTCGACTCTAGGGA,336,361,25,23,19021,6,0
20109,ACGTCGAATCTTGGGA,336,341,5,18,19159,0,0
20110,ACGTCGAATCTAGGGA,336,350,14,24,19160,3,0
20111,ACGTTGAATCTAGGGA,336,338,2,28,19170,0,0
20112,TCGTCGAATCTAGGGA,336,338,2,26,19176,0,0
20113,ACGTCGAATCTAGGGA,336,355,19,29,19178,4,0
20114,ACGTCGAATCTAGGGA,336,344,8,26,19247,1,0
20115,ACGTCGAATCTAGGGA,336,346,10,23,19344,1,0
20116,ACGTCGAATCTAGGGA,336,344,8,30,19346,1,0
20117,ACGTCGATTCTGGGGA,336,337,1,23,19350,0,0
20118,ACATCGAATCTAGGGA,336,366,30,28,19357,8,0
20119,ACGGCTACTCTAGGGA,336,369,33,25,19433,9,0
20120,ACGTCGAATCTAGGGA,336,348,12,31,19444,2,0
20121,ACGTCGAATCTAGGGA,336,338,2,23,19445,0,0
20122,ACGTCGAATCTAGGGA,336,344,8,23,19505,1,0
20123,ACGTCGATTCTGGGGA,336,349,13,23,19506,2,0
20124,ACGTCGAATCTAGGGA,336,384,48,24,19512,14,0
20125,TCGTCGAATCTAGGGA,336,337,1,23,19513,0,0
20126,ACGTTGAATCTAGGGA,336,341,5,28,19522,0,0
20127,ACGTCGAATCTAGGGA,336,339,3,26,19525,0,0
20128,ACGTCGAATCTAGGGA,336,341,5,24,19613,0,0
20129,ACGTCGAATCTAGGGA,336,347,11,23,19615,2,0
20130,ACGTCGAATCTTGGGA,336,374,38,27,19623,11,0
20131,ACGTCGAATCTAGGGA,336,337,1,30,19627,0,0
20132,ACGTCGAATCTAGGGA,336,339,3,23,19691,0,0
20133,ACGTCGAATCTAGGGA,336,343,7,25,19696,0,0
20134,ACGTCGATTCTGGGGA,336,336,0,23,19697,0,0
20135,ACATCGAATCTAGGGA,336,340,4,28,19702,0,0
20136,ACGTTGAATCTAGGGA,336,340,4,29,19703,0,0
20137,ACGTTGAATCTAGGGA,336,343,7,28,19705,0,0
20138,ACGTCGAATCGAGGGA,336,339,3,22,19708,0,0
20139,ACGTCGAATCTAGGGA,336,339,3,23,19714,0,0
20140,TCGTCGAATCTAGGGA,336,339,3,26,19719,0,0
20141,ACGTCGAATCTAGGGA,336,339,3,20,19720,0,0
20142,ACGTCGAATCTAGGGT,336,337,1,23,19724,0,0
20143,ACGTCGAATCTAGGGA,336,339,3,26,19725,0,0
20144,ACGTCGAAGCTAGGGA,336,339,3,28,19734,0,0
20145,ACGTCGAATCTAGGGA,336,339,3,29,19735,0,0
20146,ACGTCGAATTTAGGGA,336,339,3,26,19739,0,0
20147,ACGTCGAATCTTGGGA,336,339,3,21,19741,0,0
20148,ACGTCGAATCTAGGGA,336,339,3,26,19744,0,0
20149,ACGTCGAATCTAGGGA,336,339,3,30,19745,0,0
20150,ACGTCGCTTCTGGGGA,336,339,3,23,19746,0,0
20151,ACGTCGAATCTAGGGA,336,339,3,28,19747,0,0
20152,ACGTCGAATCTAGGGA,336,339,3,21,19748,0,0
20153,ACGTTGAATCTAGGGA,336,339,3,30,19753,0,0
20154,ACGTCGAAAGTAGGGA,336,339,3,24,19754,0,0
20155,TCGTCGAATCTAGGGA,336,339,3,26,19758,0,0
20156,ACGTCGAATCTAGGGA,336,339,3,28,19761,0,0
20157,ACGTCGAATCTAGGGA,337,343,6,28,17074,0,0
20158,ACGTCGAATCTAGGGA,337,337,0,21,17246,0,0
20159,ACGTCGAATCTAGGGA,337,349,12,28,17255,2,0
20160,ACGTCGAATCTAGGGT,337,369,32,21,17603,9,0
20161,ACGTCGAATCTAGGGA,337,337,0,24,17699,0,0
20162,ACGTCGAATCTAGGGA,337,337,0,27,18185,0,0
20163,TCGTCGAATCCAGGGA,337,338,1,25,18507,0,0
20164,ACGTCGAATCTAGGGA,337,350,13,20,18702,2,0
20165,ACGTCGAATCTAGGGA,337,345,8,25,18716,1,0
20166,ACGTCGAATCTAGGGA,337,358,21,24,18727,5,0
20167,ACGTCGAGTCTAGGGA,337,341,4,29,19154,0,0
20168,ACGTCGAATCTAGGGA,337,346,9,21,19210,1,0
20169,ACGTCGAATCTAGGGA,337,339,2,28,19213,0,0
20170,ACGTCGAATCTAGGGA,337,345,8,19,19218,1,0
20171,ACGTCGAATCTAGGGA,337,344,7,27,19222,0,0
20172,ACGTCGAATCTAGGGA,337,344,7,27,19226,0,0
20173,ACGTCGAATCTAGGGA,337,350,13,26,19228,2,0
20174,ACGTCGAATCTAGGGA,337,338,1,23,19231,0,0
20175,ACGTCGAATGTAGGGA,337,344,7,26,19233,0,0
20176,ACGTCGAATCTAGGGA,337,341,4,27,19241,0,0
20177,ACGTCGAATCTAGGGA,337,344,7,21,19398,0,0
20178,TCGTCGAATCTAGGGA,337,352,15,24,19399,3,0
20179,ACGTCGAATCTAGGGA,337,341,4,25,19400,0,0
20180,ACGTCGAATCTAGGGA,337,338,1,26,19414,0,0
20181,ACGTCGAATGTAGGGA,337,354,17,26,19415,4,0
20182,ACGTCGAATCTAGGGA,337,342,5,24,19416,0,0
20183,ACGTCGAATCTAGGGA,337,338,1,24,19427,0,0
20184,ACGTCGAAAGTAGGGA,337,372,35,23,19473,10,0
20185,ACGTCGAATCTAGGGA,337,338,1,21,19575,0,0
20186,ACGTCGAATCTAGGGA,337,372,35,26,19583,10,0
20187,ACGTCGAATGTAGGGA,337,343,6,26,19585,0,0
20188,ACGTCGAATCTAGGGA,337,365,28,24,19586,7,0
20189,ACGTCGAATGTAGGGA,337,345,8,24,19587,1,0
20190,ACGTTGAATCTAGGGA,337,337,0,30,19588,0,0
20191,ACGTCGAATCTAGGGA,337,360,23,27,19590,6,0
20192,ACGTCGAATCTAGGGA,337,344,7,25,19592,0,0
20193,ACGTCGATTCTGGGGA,337,339,2,24,19594,0,0
20194,ACGTCGAATCTAGGGA,337,338,1,26,19597,0,0
20195,ACGTCGAATCTAGGGA,337,348,11,25,19598,2,0
20196,ACGTCGAATCTAGGGA,337,339,2,24,19602,0,0
20197,TCGTCGAATCTAGGGA,337,345,8,27,19603,1,0
20198,ACGTCGAATCTAGGGA,337,365,28,31,19604,7,0
20199,GCGTCGAATGTAGGGA,337,339,2,24,19606,0,0
20200,ACGTCGAATCTAGGGA,337,342,5,27,19607,0,0
20201,ACGTCGAATCTAGGGA,337,341,4,25,19610,0,0
20202,ACGTCGAATCTTGGGA,337,339,2,19,19764,0,0
20203,ACGTCGAATCTAGGGA,337,340,3,20,19766,0,0
20204,ACGTCGAATGTAGGGA,337,340,3,23,19768,0,0
20205,ACGTCGAATCTAGGGA,337,340,3,26,19770,0,0
20206,ACGTCGAATCTAGGGA,337,340,3,26,19771,0,0
20207,ACGTCGACTCTAGAGA,337,338,1,26,19778,0,0
20208,ACGTCGAATCTAGGGA,337,340,3,25,19779,0,0
20209,GCGTCGCATCTAGGGA,337,340,3,23,19782,0,0
20210,ACGTCGATTCTGGGGA,337,337,0,23,19785,0,0
20211,ACGTCGAATCTAGGGA,337,340,3,24,19787,0,0
20212,ACGTCGAATCTAGGGA,338,347,9,22,18023,1,0
20213,ACGTCGATTCTGGGGA,338,343,5,22,18030,0,0
20214,ACGTCGATTCTGGGGA,338,358,20,22,18388,5,0
20215,ACATCGAATCTAGGGA,338,354,16,27,18568,3,0
20216,ACGTCGAATCTAGGGA,338,356,18,25,18680,4,0
20217,ACGTCGAATCTAGGGA,338,341,3,21,18681,0,0
20218,ACGTCGAATCTAGGGA,338,361,23,20,18932,6,0
20219,TCGTCGAATCTAGGGA,338,351,13,26,18945,2,0
20220,ACATCGAATCTAGGGA,338,341,3,27,19096,0,0
20221,ACGTCGAATCTAGGGT,338,341,3,22,19099,0,0
20222,ACGTCGAATCTAGGGA,338,341,3,25,19101,0,0
20223,ACGTCGAAAGCAGGGA,338,338,0,22,19104,0,0
20224,ACGTTGAATCTAGGGA,338,341,3,24,19114,0,0
20225,ACGTCGAATCTAGGGA,338,341,3,24,19115,0,0
20226,ACGTCGAATCTAGGGA,338,341,3,28,19123,0,0
20227,ACGTCGAAAGTAGGGA,338,338,0,25,19130,0,0
20228,ACGTCGAATCTAGGGA,338,341,3,22,19131,0,0
20229,ACGTCGATTCTGGGGA,338,341,3,22,19281,0,0
20230,ACGTCGAATCTAGGGA,338,341,3,21,19292,0,0
20231,ACGTCGACTCTAGGGA,338,341,3,25,19295,0,0
20232,ACGTTGAATCTAGGGA,338,338,0,29,19296,0,0
20233,ACGTCGAATGTAGGGA,338,341,3,24,19304,0,0
20234,ACGTCGAATCTAGGGA,338,338,0,25,19308,0,0
20235,ACGTCGAATCTAGGGA,338,341,3,22,19463,0,0
20236,ACGTCGAATCTAGGGA,338,340,2,25,19465,0,0
20237,ACGTCGAATCTAGGGA,338,341,3,21,19472,0,0
20238,ACGTCGAATCTAGGGA,338,338,0,25,19611,0,0
20239,ATGTCGAATCTAGGGA,338,341,3,22,19629,0,0
20240,ACGTCGAATCTAGGGA,338,341,3,29,19630,0,0
20241,TCGTCGAATCTAGGGA,338,340,2,24,19763,0,0
20242,ACGTCGAATCTAGGGA,338,341,3,26,19791,0,0
20243,ACGTCGAATCTAGGGA,338,341,3,29,19819,0,0
20244,ACGTCGAATCTAGGGA,338,341,3,27,19822,0,0
20245,ACGTAGAATCTAGGGA,338,341,3,21,19826,0,0
20246,ACGTCGAATCTAGGGA,338,341,3,28,19828,0,0
20247,ACGTCGAATCTAGGGA,338,341,3,25,19829,0,0
20248,TCGTCGAATCTAGGGA,338,341,3,26,19831,0,0
20249,ACGTCGAATCTAGGGA,338,338,0,25,19833,0,0
20250,ACGTCCCATCTAGGGA,338,340,2,21,19834,0,0
20251,ACGTCGAATCTAGGGA,338,341,3,20,19835,0,0
20252,ACGTCGATTCTGGGGA,338,341,3,24,19839,0,0
20253,ACGTCGAATCTAGGGA,338,341,3,28,19841,0,0
20254,ACGTCGATTCTGGGGA,338,341,3,25,19846,0,0
20255,ACGTCGAATCTAGGGA,338,338,0,22,19847,0,0
20256,ACGTCGAATCTAGGGT,338,341,3,26,19848,0,0
20257,ACGTCGAATCTAGGGA,338,340,2,29,19849,0,0
20258,ACGTCGACTCTAGGGA,338,341,3,23,19850,0,0
20259,ACGTCGAATCTAGGGA,338,341,3,28,19852,0,0
20260,ACGTCGAATCTAGGGA,338,338,0,28,19855,0,0
20261,ACGTCGAATCTAGGGA,338,341,3,24,19857,0,0
20262,ACGTCGAATGTAGGGA,338,340,2,25,19862,0,0
20263,TCGTCGAATCTAGGGA,338,339,1,27,19863,0,0
20264,ATGTCGAATCTAGGGA,338,341,3,26,19864,0,0
20265,ACGTCGAATCTTGGGA,338,341,3,20,19871,0,0
20266,ACGTCGAATCTAGGGA,338,341,3,21,19873,0,0
20267,ACGTCGAATGTAGGGA,338,341,3,27,19876,0,0
20268,ACGTCGACTCTAGGGA,338,339,1,26,19879,0,0
20269,ACGTCGAATCTAGGGA,338,339,1,26,19881,0,0
20270,ACGTCGAATCTAGGGA,338,341,3,25,19882,0,0
20271,TCGTCGAATCTAGGGA,339,340,1,23,16667,0,0
20272,ACGTCGTATCTTGGGA,339,341,2,18,17548,0,0
20273,ACGTCGAATCTAGGGA,339,347,8,19,17554,1,0
20274,ACGTCGAATCTAGGGA,339,343,4,25,18279,0,0
20275,ACGTCGAATCTAGGGA,339,342,3,23,18446,0,0
20276,ACGTTGAATCTAGGGA,339,349,10,29,18660,1,0
20277,ACGTCGAATCTAGGGA,339,343,4,26,18666,0,0
20278,ACGTCGACTCTAGGGA,339,340,1,25,18670,0,0
20279,ACGTCGAATCTAGGGA,339,351,12,24,18812,2,0
20280,ACGTCGAATCTTGGGA,339,344,5,26,18825,0,0
20281,ACGTCGATTCTGGGGA,339,345,6,23,18830,0,0
20282,ACGTCTACTCTAGGGA,339,340,1,24,18834,0,0
20283,ACGTCGAATCTAGGGA,339,346,7,25,18840,0,0
20284,ACGTCGAATCTAGGGA,339,340,1,24,19005,0,0
20285,ACATCGAATCTAGGGA,339,349,10,28,19014,1,0
20286,ACGTCGAATCTAGGGA,339,340,1,24,19160,0,0
20287,ACGTTGAATCTAGGGA,339,347,8,28,19170,1,0
20288,TCGTCGAATCTAGGGA,339,339,0,26,19176,0,0
20289,ACGCCGAATCTAGGGA,339,342,3,26,19247,0,0
20290,ACGTCGAATCTAGGGA,339,356,17,23,19344,4,0
20291,ACGTCGAATCTAGGGA,339,344,5,30,19346,0,0
20292,ACGTCGATTCTGGGGA,339,355,16,23,19350,3,0
20293,ACATCGAATCTAGGGA,339,357,18,28,19357,4,0
20294,ACGTCGAATCTAGGGA,339,340,1,31,19444,0,0
20295,ACGTCGAATCTAGGGA,339,346,7,23,19445,0,0
20296,ACGTCGAATCTAGGGA,339,357,18,23,19505,4,0
20297,ACGTCGATTCTGGGGA,339,342,3,23,19506,0,0
20298,ACGTCGAATCTAGGGA,339,358,19,24,19512,4,0
20299,ACGTCGAATCTAGGGA,339,363,24,23,19513,6,0
20300,ACGTTGAATCTAGGGA,339,349,10,28,19522,1,0
20301,ACGTCGAATCTAGGGA,339,341,2,26,19525,0,0
20302,ACGTCGAATCTAGGGA,339,340,1,23,19615,0,0
20303,ACGTCGAATCTTGGGA,339,342,3,27,19623,0,0
20304,ACGTCGAATCTAGGGA,339,349,10,30,19627,1,0
20305,ACGTCGAATCTAGGGA,339,341,2,25,19696,0,0
20306,ACATCGAATCTAGGGA,339,339,0,28,19702,0,0
20307,ACGTTGAATCTAGGGA,339,358,19,29,19703,4,0
20308,ACGTCGAATCTAGGGA,339,348,9,20,19720,1,0
20309,ACGTCGAATCTAGGGA,339,340,1,26,19725,0,0
20310,ACGTCGAATCTAGGGA,339,344,5,28,19734,0,0
20311,ACGTCGAATCTAGGGA,339,372,33,29,19735,9,0
20312,ACGTCGAATCTAGGGA,339,357,18,26,19739,4,0
20313,ACGTCGAATCTAGGGA,339,343,4,26,19744,0,0
20314,ACGTGGAATCTAGGGA,339,344,5,30,19745,0,0
20315,ACGTCGAATCTAGGGA,339,340,1,21,19748,0,0
20316,ACATTGAATCTAGGGA,339,343,4,30,19753,0,0
20317,TCGTCGAATCTAGGGA,339,345,6,26,19758,0,0
20318,ACGTCGATTCTAGGGA,339,340,1,23,19886,0,0
20319,ACGTCGAATCTAGGGA,339,339,0,29,19988,0,0
20320,ACGTCGAATCTAGGGA,339,357,18,22,19989,4,0
20321,ACGTCGAATCTAGGGA,339,352,13,29,19990,2,0
20322,ACGTCGAATCTAGGGA,339,348,9,27,19991,1,0
20323,ACGTCGAATCTAGGGT,339,344,5,22,19992,0,0
20324,ACGTCGAATCTAGGGA,339,340,1,25,19993,0,0
20325,ACGTCGAATCTAGGGA,339,343,4,21,19994,0,0
20326,ACGTCGAATCTAGGGA,339,343,4,28,19996,0,0
20327,TCGTCGAATCTAGGGA,339,347,8,26,19998,1,0
20328,ACGTCGAATCTAGGGA,339,345,6,20,20001,0,0
20329,ACGTCGAGTCTAGGGA,339,345,6,29,20003,0,0
20330,ACGTCGAATCTAGGGA,340,340,0,21,17246,0,0
20331,ACGTCGAATCTAGGGA,340,352,12,28,17255,3,0
20332,ACGTCGAATCTAGGGT,340,348,8,21,17603,1,0
20333,ACGTCGAATCTAGGGA,340,345,5,24,17699,0,0
20334,TCGTCGAATCTAGGGA,340,351,11,25,18507,2,0
20335,ACGTCGAATCTAGGGA,340,342,2,20,18702,0,0
20336,ACGTCGAATCTAGGGA,340,346,6,25,18716,1,0
20337,ACGTCGAGTCTAGGGA,340,344,4,29,19154,0,0
20338,ACGTCGAATCTAGGGA,340,354,14,21,19210,3,0
20339,ACGTCGAATCTAGGGA,340,344,4,28,19213,0,0
20340,ACGTCGAATCTAGGGA,340,358,18,19,19218,5,0
20341,ACGTCGAATCTAGGGA,340,349,9,27,19222,1,0
20342,ACGTCGAATCTAGGGA,340,356,16,27,19226,3,0
20343,ACGTCGAATCTAGGGA,340,347,7,26,19228,0,0
20344,ACGTCGAATCTAGGGA,340,363,23,23,19231,6,0
20345,ACGTCGAATGTAGGGA,340,346,6,26,19233,0,0
20346,ACGTCGAATCTAGGGA,340,346,6,21,19398,0,0
20347,TCGTCGAATCTAGGGA,340,343,3,24,19399,0,0
20348,ACGTCGAATCTAAGGA,340,348,8,25,19400,1,0
20349,ACGTCGAATGTAGGGA,340,343,3,26,19415,0,0
20350,ACGTCGAATCTAGGGA,340,343,3,24,19416,0,0
20351,ACGTCGAATCTAGGGA,340,347,7,24,19427,0,0
20352,ACGTCGAATCTAGGGA,340,346,6,21,19575,0,0
20353,ACGTCGAATCTAGGGA,340,346,6,26,19583,0,0
20354,ACGTCGAATCTAGGGA,340,349,9,24,19586,1,0
20355,ACGTCGAATGTAGGGA,340,346,6,24,19587,0,0
20356,ACGTTGAATCTAGGGA,340,340,0,30,19588,0,0
20357,ACGTCGAATCTAGGGA,340,340,0,27,19590,0,0
20358,ACGTCGAATCTAGGGA,340,340,0,25,19592,0,0
20359,ACGTCGATTCTGGGGA,340,343,3,24,19594,0,0
20360,ACGTCGAATCTAGGGA,340,341,1,26,19597,0,0
20361,ACGTCGAATCTAGGGA,340,343,3,25,19598,0,0
20362,ACGTCGAATCTAGGGA,340,343,3,24,19602,0,0
20363,ACGTCGAATCTAGGGA,340,341,1,31,19604,0,0
20364,ACGTCGAATGTAGGGA,340,343,3,24,19606,0,0
20365,ACGTCGAATCTAGGGA,340,343,3,27,19607,0,0
20366,ACGTCGAATCTAGGGA,340,341,1,25,19610,0,0
20367,ACGTCGAATCTAGGGA,340,341,1,20,19766,0,0
20368,ACGTCGAATGTAGGGA,340,341,1,23,19768,0,0
20369,ACGTCGAATCTAGGGA,340,343,3,26,19770,0,0
20370,ACGTCGAATCTAGGGA,340,342,2,26,19771,0,0
20371,ACGTCGACTCTAGAGA,340,343,3,26,19778,0,0
20372,ACGTCGAATCTAGGGA,340,343,3,25,19779,0,0
20373,CCGTCGCATCTAGGGA,340,340,0,23,19782,0,0
20374,ACGTCGATTCTGGGGA,340,340,0,23,19785,0,0
20375,ACGTCGAATCTAGGGA,340,340,0,21,19937,0,0
20376,ACGTCGAATATAGGGA,340,343,3,26,19941,0,0
20377,ACGTCGAATCTAGGGA,340,341,1,24,19942,0,0
20378,ACGTCGAATGTAGGGA,340,343,3,24,19943,0,0
20379,ACGTCTACTCTAGGGA,340,341,1,25,19950,0,0
20380,ACGTCGAATGTAGGGA,340,340,0,24,19953,0,0
20381,TCGTCGAATCTAGGGA,340,343,3,27,19954,0,0
20382,ACGTCGAATCTAGGGA,340,342,2,27,19955,0,0
20383,ACGTCGAATCTTGGGA,340,343,3,23,19959,0,0
20384,ACGGCGAATCTAGGGA,340,343,3,25,19962,0,0
20385,ACGTCGAATCTAGGGA,340,343,3,27,19966,0,0
20386,TCGTCGAATCTAGGGA,340,343,3,27,19971,0,0
20387,ACGTCGAATCTAGGGA,340,341,1,25,19975,0,0
20388,ACGTCGAATCTAGGGA,340,343,3,24,19979,0,0
20389,ACGTCGATTCTGGGGA,340,343,3,24,19980,0,0
20390,ACGTTGAATCTAGGGA,340,343,3,30,19981,0,0
20391,AGGTCGAATCTAGGGA,340,343,3,25,19983,0,0
20392,ACGTTGAATCTAGGGA,340,343,3,29,19985,0,0
20393,ACGTCGAATGTAGGGA,340,343,3,24,19987,0,0
20394,AAGTCGAATCTAGGGA,341,343,2,22,18023,0,0
20395,ACGTCGATTCTGGGGA,341,346,5,22,18030,0,0
20396,ACGTCGATTCTGGGGA,341,345,4,22,18388,0,0
20397,ACGTCGAATCTAGGGA,341,355,14,25,18680,3,0
20398,ACGTCGAATCTAGGGA,341,369,28,21,18681,7,0
20399,ACGTCGAATCTAGGGA,341,343,2,20,18932,0,0
20400,TCGTCGAATCTAGGGA,341,343,2,26,18945,0,0
20401,ACATCGAATCTAGGGA,341,354,13,27,19096,2,0
20402,ACGTCGAATCTAGGGA,341,343,2,25,19101,0,0
20403,ACGTCGAAAGCAGGGA,341,387,46,22,19104,13,0
20404,ACGTTGAATCTAGGGA,341,350,9,24,19114,1,0
20405,ACGTCGAATCTAGGGA,341,383,42,28,19123,12,0
20406,ACGTCGAAAGTAGGGA,341,341,0,25,19130,0,0
20407,ACGTCGACTGTAGGGA,341,346,5,25,19295,0,0
20408,ACGTCGAATGTAGGGA,341,342,1,24,19304,0,0
20409,ACGTCGAATCTAGGGA,341,345,4,22,19463,0,0
20410,ACGTCGAATCTAGGGA,341,351,10,21,19472,1,0
20411,ACGTCGAATCTAGGGA,341,344,3,25,19611,0,0
20412,ACGTCGAATCTAGGGA,341,345,4,29,19630,0,0
20413,TCGTCGAATCTAGGGA,341,342,1,24,19763,0,0
20414,ACGTCGAATCTAGGGA,341,356,15,29,19819,3,0
20415,ACGTCGAATCTAGGGA,341,358,17,27,19822,4,0
20416,ACGTCGAATCTAGGGA,341,346,5,25,19829,0,0
20417,ACGTCGAATCTAGGGA,341,344,3,25,19833,0,0
20418,ACGTCGCATCTAGGGA,341,343,2,21,19834,0,0
20419,ACGTCGATTCTGGGGA,341,347,6,24,19839,0,0
20420,ACGTCGAATCTAGGGA,341,344,3,28,19841,0,0
20421,ACGTCGATTCTGGGGA,341,345,4,25,19846,0,0
20422,ACGTCGAATCTAGGGA,341,349,8,22,19847,1,0
20423,ACGTCGAATCTAGGGA,341,349,8,29,19849,1,0
20424,ACGTCGACTCTAGGGA,341,363,22,23,19850,5,0
20425,ACGTCGAATCTAGGGA,341,351,10,28,19855,1,0
20426,ACGTCGAATCTAGGGA,341,343,2,24,19857,0,0
20427,ACGTCGAATGTAGGGA,341,345,4,25,19862,0,0
20428,TCGTCGAATCTAGGGA,341,358,17,27,19863,4,0
20429,ATGTCGAATCTAGGGA,341,350,9,26,19864,1,0
20430,ACGTCGAATCTTGGGA,341,344,3,20,19871,0,0
20431,ACGTCGAATCTAGGGA,341,344,3,21,19873,0,0
20432,ACGTCGAATGTAGGGA,341,363,22,27,19876,5,0
20433,ACGTCGACTCTAGGGA,341,347,6,26,19879,0,0
20434,ACGTCGAATCTAGGGA,341,358,17,26,19881,4,0
20435,ACGTCGAATCTAGGGA,341,349,8,25,19882,1,0
20436,ACGTCGAATCTAGGGA,341,343,2,25,20004,0,0
20437,ACGTCGAATCTATGGA,341,349,8,28,20010,1,0
20438,ACGTCGAATCTAGGGA,341,371,30,24,20014,8,0
20439,ACGTCGAATCTAGGGA,341,341,0,22,20018,0,0
20440,ACGTCGAATCTAGGGA,341,343,2,26,20020,0,0
20441,ACGTCGAATCTAGGGA,341,362,21,21,20022,5,0
20442,ACGTCGAATCTAGGGA,341,345,4,27,20023,0,0
20443,ACGTCGAATGTAGGGA,341,346,5,27,20024,0,0
20444,ACGTCGACTCTAGGGA,341,341,0,26,20026,0,0
20445,ACGTCGAATCTAGGGA,341,379,38,26,20027,11,0
20446,ACGTCGAATCTAGGGA,341,383,42,22,20030,12,0
20447,ACGTCGAATGTAGGGA,341,341,0,27,20032,0,0
20448,ACGTCGAATCTAGGGA,341,344,3,25,20033,0,0
20449,ACGTTGAATCTAGGGA,341,344,3,31,20035,0,0
20450,ACGTCGAATCTTGGGA,342,349,7,18,17548,0,0
20451,ACGTCGAATCTAGGGA,342,342,0,25,18279,0,0
20452,ACGTTGAATCTAGGGA,342,347,5,29,18660,0,0
20453,ACGTCGAATCTAGGGA,342,359,17,26,18666,4,0
20454,ACGTCGACTCTAGGGT,342,367,25,25,18670,6,0
20455,ACGTCGAATCTAGGGA,342,342,0,24,18812,0,0
20456,ACGTCGAATCTTGGGA,342,342,0,26,18825,0,0
20457,ACGTCGATTCTGGGGA,342,342,0,23,18830,0,0
20458,ACGTCGAATCTAAGGA,342,348,6,24,19005,0,0
20459,ACATCGAATCTAGGGA,342,344,2,28,19014,0,0
20460,ACGTCGAATCTAGGGA,342,343,1,24,19160,0,0
20461,ACGTCGAATCTAGGGA,342,358,16,26,19247,3,0
20462,ACGTCGAATCTAGGGA,342,350,8,23,19344,1,0
20463,ACGTCGAATCTAGGGA,342,345,3,30,19346,0,0
20464,ACGTCGATTCTGGGGA,342,343,1,23,19350,0,0
20465,ACATCGAATCTAGGGA,342,345,3,28,19357,0,0
20466,ACGTCGAATCTAGGGA,342,343,1,31,19444,0,0
20467,ACGTCGAAACTAGGGA,342,342,0,23,19445,0,0
20468,ACGTCGAATCTAGGGA,342,342,0,23,19505,0,0
20469,ACGTCGATTCTGGGGA,342,345,3,23,19506,0,0
20470,ACGTCGAATCTAGGGA,342,343,1,24,19512,0,0
20471,ACGTTGAATCTAGGGA,342,343,1,28,19522,0,0
20472,ACGTCGAATCTAGGGA,342,345,3,26,19525,0,0
20473,ACGTCGAATCTAGGGA,342,345,3,23,19615,0,0
20474,ACGTCGAATCTTGGGA,342,345,3,27,19623,0,0
20475,ACGTCGAATCTAGGGA,342,343,1,30,19627,0,0
20476,ACGTCGAATCTAGGGA,342,345,3,20,19720,0,0
20477,ACGTCGAATCTAGGGA,342,345,3,26,19725,0,0
20478,ACGTCGAATCTAGGGA,342,345,3,28,19734,0,0
20479,ACGTCGAATCTAGGGA,342,345,3,29,19735,0,0
20480,ACGTCGAATCTAGGGA,342,345,3,26,19739,0,0
20481,ACGTCGAATCTAGGGA,342,345,3,26,19744,0,0
20482,ACGTCGAATCTAGGGA,342,345,3,21,19748,0,0
20483,TCGTCGAATCTAGGGA,342,345,3,26,19758,0,0
20484,ACGTCGATTCTAGGGA,342,345,3,23,19886,0,0
20485,ACGTCGAATCTAGGGA,342,343,1,29,19988,0,0
20486,ACGTCGAATCTAGGGA,342,345,3,29,19990,0,0
20487,ACGTCGAATCTAGGGA,342,345,3,27,19991,0,0
20488,ACGTCGAATCTAGGGA,342,345,3,25,19993,0,0
20489,ACGTCGAATCTAGGGA,342,345,3,28,19996,0,0
20490,TCGTCGAATCTAGGGA,342,345,3,26,19998,0,0
20491,ACGTCGAGTCTAGGGA,342,344,2,29,20003,0,0
20492,ACGTCGATTCTGGGGA,342,345,3,23,20050,0,0
20493,ACGTTGAATCTAGGGA,342,345,3,29,20056,0,0
20494,ACGTTGAATCTAGGGA,342,345,3,28,20057,0,0
20495,ACGTCGAATCTAGGGA,342,345,3,22,20059,0,0
20496,ACGTCGAATCTAGGGA,342,345,3,24,20062,0,0
20497,TCGTCGAATCTAGGGA,342,345,3,27,20063,0,0
20498,ACGTCGAAAGCAGGGA,342,344,2,23,20067,0,0
20499,ACGTCGAATCTAGGGA,342,345,3,25,20071,0,0
20500,ACGTCGAATCTAGGGA,343,353,10,28,17255,1,0
20501,ACGTCGAATCTAGGGT,343,358,15,21,17603,3,0
20502,ACGTCGAATCTAGGGA,343,360,17,24,17699,4,0
20503,TCGTCGAATCTAGGGA,343,343,0,25,18507,0,0
20504,ACGTCGAATCTAGGGA,343,349,6,21,19210,0,0
20505,ACGTCGAATCTAGGGA,343,343,0,28,19213,0,0
20506,ACGTCGAATCTAGGGA,343,347,4,19,19218,0,0
20507,ACGTCGAATCTAGGGA,343,348,5,27,19222,0,0
20508,ACGTCGAATCTAGGGA,343,356,13,27,19226,2,0
20509,ACGTCGAATCTAGGGA,343,353,10,23,19231,1,0
20510,ACGTCGAATGTAGGGA,343,365,22,26,19233,5,0
20511,ACGTCGAATCTAGGGA,343,349,6,21,19398,0,0
20512,TCGTCGAATCTAGGGA,343,343,0,24,19399,0,0
20513,ACGTCGAATCTAGGGA,343,350,7,25,19400,0,0
20514,ACGTCGAATCTAGGGA,343,371,28,24,19416,7,0
20515,ACGTCGAATCTAGGGA,343,370,27,24,19427,7,0
20516,ACGTCGAATCTAGGGA,343,371,28,21,19575,7,0
20517,ACGTCGAATCTAGGGA,343,345,2,26,19583,0,0
20518,ACGTCGAATGTAGGGA,343,363,20,24,19587,5,0
20519,ACGTTGAATCTAGGGA,343,355,12,30,19588,2,0
20520,ACGTCGAATCTAGGGA,343,343,0,27,19590,0,0
20521,ACGTCGATTCTGGGGA,343,354,11,24,19594,2,0
20522,ACGTCGAATCTAGGGA,343,353,10,26,19597,1,0
20523,ACGTCGAATCTAGGGA,343,375,32,25,19598,9,0
20524,ACGTCGAATCTAGGGA,343,353,10,24,19602,1,0
20525,ACGTCGAATCTAGGGA,343,364,21,31,19604,5,0
20526,ACGTCGAATGTAGGGA,343,350,7,24,19606,0,0
20527,ACGTCGAATCTAGGGA,343,358,15,27,19607,3,0
20528,ACGTCGAATCTAGGGA,343,351,8,25,19610,1,0
20529,ACGTCGAATCTAGGGA,343,349,6,20,19766,0,0
20530,ACGTCGAATGTAGGGA,343,344,1,23,19768,0,0
20531,ACGTCGAATCTAGGGA,343,360,17,26,19770,4,0
20532,ACGTCGAATCTAGGGA,343,350,7,26,19771,0,0
20533,ACGTCGACTCTAGAGA,343,353,10,26,19778,1,0
20534,ACGTCGATTCTGGGGA,343,359,16,23,19785,3,0
20535,ACGTCGAATCTAGGGA,343,356,13,21,19937,2,0
20536,ACGTCGAATCTAGGGA,343,349,6,24,19942,0,0
20537,ACGTCGAATGTAGGGA,343,344,1,24,19943,0,0
20538,ACGTCTACTCTAGGGA,343,343,0,25,19950,0,0
20539,CCGTCGAATGTAGGGA,343,352,9,24,19953,1,0
20540,TCGTCGAATCTAGGGA,343,350,7,27,19954,0,0
20541,ACGTCGAATCTTGGGA,343,344,1,23,19959,0,0
20542,ACGTCGAATCTAGGGA,343,353,10,27,19966,1,0
20543,TCGTCGAATCTAGGGA,343,347,4,27,19971,0,0
20544,ACGTCGAATCTAGGGA,343,343,0,24,19979,0,0
20545,ACGTCGATTCTGGGGA,343,343,0,24,19980,0,0
20546,ACGTCGAATCTAGGGA,343,361,18,25,19983,4,0
20547,TCGTCGAATCTAGGGA,343,343,0,24,20090,0,0
20548,ACGTCGAATCTTGGGA,343,357,14,19,20091,3,0
20549,ACGTCGAATCTAGGGA,343,343,0,20,20092,0,0
20550,ACGTCGAATCTAGGGA,343,349,6,26,20093,0,0
20551,ACGTTGAATCTAGGAA,343,343,0,30,20095,0,0
20552,GCGTCGAATCTAGGGA,343,345,2,25,20098,0,0
20553,ACGTCGATTCTGGGGA,343,347,4,24,20100,0,0
20554,ACGTCGATTCTGGGGA,343,346,3,23,20103,0,0
20555,TCGTCGAATCTAGGGA,343,344,1,27,20105,0,0
20556,ACGTCGAATCTAGGGA,343,358,15,25,20106,3,0
20557,ACGTCGACTCTAGGGA,343,384,41,24,20108,12,0
20558,ACGTCGAATCTAGGGA,343,345,2,25,20110,0,0
20559,ACGTCGAATCTAGGGA,343,375,32,30,20113,9,0
20560,ACGTCGAATCTAGGGA,343,344,1,27,20114,0,0
20561,ACGTCGAATCTAGGGA,343,344,1,24,20115,0,0
20562,ACGTCGAATCTAGGGA,343,354,11,31,20116,2,0
20563,ACATCGAATCTAGGGA,343,350,7,29,20118,0,0
20564,ACGGCTACTCTAGGGA,343,345,2,26,20119,0,0
20565,ACGTCGAATCTAGGGA,343,344,1,32,20120,0,0
20566,ACGTCGAATCTAGGGA,343,356,13,24,20122,2,0
20567,ACGTCGATTCTGGGGA,343,351,8,24,20123,1,0
20568,ACGTCGAATCTAGGGA,343,352,9,25,20124,1,0
20569,ACGTCGAATCTAGGGA,343,351,8,24,20129,1,0
20570,ACGTCGAATCTTGGGA,343,358,15,28,20130,3,0
20571,ACGTCGATTCTGGGGA,344,344,0,22,18030,0,0
20572,ACGTCGATTCTGGGGA,344,349,5,22,18388,0,0
20573,ACGTCGAATCTAGGGA,344,347,3,21,18681,0,0
20574,ACGTCGAATCTAGGGA,344,347,3,20,18932,0,0
20575,ACGTCGAATCTAGGGA,344,347,3,25,19101,0,0
20576,ACGTCGAAAGCAGGGA,344,347,3,22,19104,0,0
20577,ACGTTGAATCTAGGGA,344,347,3,24,19114,0,0
20578,ACGTCGAATCTAGGGA,344,347,3,28,19123,0,0
20579,ACGTCGAAAGTAGGGA,344,347,3,25,19130,0,0
20580,ACGTCGAATGTAGGGA,344,346,2,24,19304,0,0
20581,ACGTCGAATCTAGGGA,344,347,3,29,19630,0,0
20582,TCGTCGAATCTAGGGA,344,347,3,24,19763,0,0
20583,ACGTCGAATCTAGGGA,344,347,3,29,19819,0,0
20584,ACGTCGAATCTAGGGA,344,345,1,27,19822,0,0
20585,ACGTCGAATCTAGGGA,344,347,3,25,19829,0,0
20586,ACGTCGCATCTAGGGA,344,344,0,21,19834,0,0
20587,ACGTCGATTCTGGGGA,344,347,3,25,19846,0,0
20588,ACGTCGAATCTAGGGA,344,347,3,22,19847,0,0
20589,ACGTCGAATCTAGGGA,344,347,3,29,19849,0,0
20590,ACGTCGAATCTACGGA,344,347,3,28,19855,0,0
20591,ACGTCGAATCTAGGGA,344,347,3,24,19857,0,0
20592,ACGTCGAATGTAGGGA,344,347,3,25,19862,0,0
20593,TCGTCGAATCTAGGGA,344,347,3,27,19863,0,0
20594,ATGTCGAATCTAGGGA,344,347,3,26,19864,0,0
20595,ACGTCGAATCTAGGGA,344,347,3,21,19873,0,0
20596,ACGTCGAATCTAGGGA,344,347,3,25,19882,0,0
20597,ACGTCGAATCTAGGGA,344,344,0,25,20004,0,0
20598,ACGTCGAATCTATGGA,344,347,3,28,20010,0,0
20599,ACGTCGAATCTAGGGA,344,347,3,26,20020,0,0
20600,ACGTCGAATCTAGGGA,344,345,1,21,20022,0,0
20601,ACGTCGAATCTAGGGA,344,346,2,27,20023,0,0
20602,ACGTCGAATGTAGGGA,344,344,0,27,20024,0,0
20603,ACGTCGACTCTAGGGA,344,347,3,26,20026,0,0
20604,ACGTCGAATCTAGGGA,344,347,3,22,20030,0,0
20605,ACGTCGAATGTAGGGA,344,347,3,27,20032,0,0
20606,ACGTCGAATCTAGGGA,344,347,3,25,20033,0,0
20607,ACGTTGAATCTAGGGA,344,347,3,31,20035,0,0
20608,ACGTCGAATCTAGGGA,344,344,0,29,20159,0,0
20609,ACGTCGAATCTAGGGT,344,347,3,22,20160,0,0
20610,ACGTCGAATCTAGGGA,344,347,3,21,20164,0,0
20611,ACGTCGAATCTAGGGA,344,347,3,26,20165,0,0
20612,ACGTCGAATCTAGGGA,344,347,3,25,20166,0,0
20613,ACGTCGAATCTAGGGA,344,347,3,22,20168,0,0
20614,ACGTCGAATCTAGGGA,344,347,3,20,20170,0,0
20615,ACGTCGAATCTAGGGA,344,347,3,27,20173,0,0
20616,TCGTCGAATCTAGGGA,344,347,3,25,20178,0,0
20617,ACGTCGAATGTAGGGA,344,347,3,27,20181,0,0
20618,ACGTCGAAAGTAGGGA,344,345,1,24,20184,0,0
20619,ACGTCGAATCTAGGGA,344,347,3,27,20186,0,0
20620,ACGTCGAATCTAGGGA,344,347,3,25,20188,0,0
20621,ACGTCGAATGTAGGGA,344,347,3,25,20189,0,0
20622,ACGTCGAATCTAGGGA,344,347,3,28,20191,0,0
20623,ACGTCGAATCTAGGGA,344,347,3,26,20195,0,0
20624,TCGTCGAATCTAGGGA,344,347,3,28,20197,0,0
20625,ACGTCGAATCTTGGGA,345,357,12,18,17548,2,0
20626,ACGTCGAGTCTAGGGA,345,359,14,26,18666,3,0
20627,ACGTCGAGTCTAGGGA,345,347,2,24,18812,0,0
20628,ACGTCGAATCTTGGGA,345,353,8,26,18825,1,0
20629,ACATCGAATCTAGGGA,345,359,14,28,19014,3,0
20630,ACGTCGAATCTAGGGA,345,346,1,26,19247,0,0
20631,ACGTCGATTCTGGGGA,345,349,4,23,19350,0,0
20632,ACATCGAATCTAGGGA,345,356,11,28,19357,2,0
20633,ACGTCGAATCTAGGGA,345,370,25,23,19445,6,0
20634,ACGTCGATTCTGGGGA,345,351,6,23,19506,0,0
20635,ACGTCGAATCTAGGGA,345,354,9,24,19512,1,0
20636,ACGTTGAATCTAGGGA,345,345,0,28,19522,0,0
20637,ACGTCGAATCTAGGGA,345,350,5,26,19525,0,0
20638,ACGTCGAATCTTGGGA,345,363,18,27,19623,4,0
20639,ACGTCGAATCTAGGGA,345,347,2,30,19627,0,0
20640,ACGTCGAATCTAGGGA,345,361,16,20,19720,3,0
20641,ACGTCGAATCTAGGGA,345,355,10,26,19725,1,0
20642,ACGTCGAATCTAGGGA,345,357,12,28,19734,2,0
20643,ACGTCGAATCTCGGGA,345,356,11,29,19735,2,0
20644,ACGTCGAATCTAGGGA,345,352,7,26,19744,0,0
20645,TCGTCGAATCTAGGGA,345,361,16,26,19758,3,0
20646,ACGTCGATTCTAGGGA,345,347,2,23,19886,0,0
20647,ACGTCGAATCTAGGGA,345,350,5,29,19988,0,0
20648,ACGTCGAATCTAGGGA,345,345,0,29,19990,0,0
20649,ACGTCGAATCTAGGGA,345,347,2,27,19991,0,0
20650,ACGTCGAATCTAGGGA,345,350,5,25,19993,0,0
20651,ACGTCGAATCTAGGGA,345,359,14,28,19996,3,0
20652,TCGTCGAATCTAGGGA,345,345,0,26,19998,0,0
20653,ACGTCGAGTCTAGGGA,345,383,38,29,20003,11,0
20654,ACGTCGATTCTGGGGA,345,359,14,23,20050,3,0
20655,ACGTTGAATCTAGGGA,345,358,13,29,20056,2,0
20656,ACGTTGAATCTAGGGA,345,377,32,28,20057,9,0
20657,ACGTCGAATCTAGGGA,345,351,6,22,20059,0,0
20658,ACGTCGAATCTAGGGA,345,352,7,24,20062,0,0
20659,TCGTCGAATCTAGGGA,345,352,7,27,20063,0,0
20660,ACGTCGAAAGCAGGGA,345,347,2,23,20067,0,0
20661,ACGTCGAATCTAGGGA,345,345,0,25,20071,0,0
20662,ACGTCGAATCTAGGGA,345,345,0,23,20212,0,0
20663,ACGTCGATTCTGGGGA,345,354,9,23,20214,1,0
20664,ACATCGAATCTAGGGA,345,361,16,28,20215,3,0
20665,ACGTCGAATCTAGGGA,345,349,4,26,20216,0,0
20666,ACGTCGAATCTAGGGA,345,352,7,21,20218,0,0
20667,ACGTCGAATCTAGGGA,345,356,11,29,20331,2,0
20668,ACGTCGAATCTAGGGT,345,359,14,22,20332,3,0
20669,TCGTCGAATCTAGGGA,345,350,5,26,20334,0,0
20670,ACGTCGAATCTAGGGA,345,346,1,26,20336,0,0
20671,ACGTCGAATCTAGGGA,345,358,13,22,20338,2,0
20672,ACGTCGAATCTAGGGA,345,347,2,20,20340,0,0
20673,ACGTCGAATCTAGGGT,346,348,2,21,17603,0,0
20674,ACGTCGAATCTAGGGA,346,352,6,24,17699,0,0
20675,ACGTCGAATCTAGGGA,346,351,5,19,19218,0,0
20676,ACGTCGAATCTAGGGA,346,349,3,27,19226,0,0
20677,ACGTCGAATCTAGGGA,346,359,13,23,19231,2,0
20678,ACGTCGAATGTAGGGA,346,350,4,26,19233,0,0
20679,ACGTCGAATCTAGGGA,346,359,13,21,19398,2,0
20680,TCGTCGAATCTAGGGA,346,346,0,24,19399,0,0
20681,ACGTCGAATCTAGGTA,346,351,5,24,19427,0,0
20682,ACGTCGAATCTAGGGA,346,347,1,21,19575,0,0
20683,ACGTCGAATCTAGGGA,346,361,15,26,19583,3,0
20684,ACGTTGAATCTAGGGA,346,361,15,30,19588,3,0
20685,ACGTCGAATCTAGGGA,346,373,27,27,19590,7,0
20686,ACGTCGATTCTGGGGA,346,351,5,24,19594,0,0
20687,ACGTCGAATCTAGGGA,346,376,30,26,19597,8,0
20688,ACGTCGAATCTAGGGA,346,348,2,24,19602,0,0
20689,ACGTCGAATCTAGGGA,346,368,22,31,19604,5,0
20690,ACGTCGAATGTAGGGA,346,366,20,24,19606,5,0
20691,ACGTCGAATCTAGGGA,346,348,2,27,19607,0,0
20692,ACGTCGAATCTAGGGA,346,367,21,25,19610,5,0
20693,ACGTCGAATCTAGGGA,346,359,13,26,19770,2,0
20694,ACGTCGAAGCTAGGGA,346,370,24,26,19771,6,0
20695,ACGTCGACTCTAGAGA,346,358,12,26,19778,2,0
20696,ACGTCGAATCTAGGGA,346,351,5,21,19937,0,0
20697,ACGTCGAATCTAGGGA,346,346,0,24,19942,0,0
20698,ACGTCGAATGTAGGGA,346,382,36,24,19943,10,0
20699,ACGTCTACTCTAGGGA,346,352,6,25,19950,0,0
20700,ACGTCGAATGTAGGGA,346,353,7,24,19953,0,0
20701,TCGTCGAATCTAGGGA,346,361,15,27,19954,3,0
20702,ACGTCGAATCTTGGGA,346,353,7,23,19959,0,0
20703,TCGTCGAATCTAGGGA,346,361,15,27,19971,3,0
20704,ACGTCGAATCTAGGGA,346,347,1,24,19979,0,0
20705,ACGTCGATTCTGGGGA,346,351,5,24,19980,0,0
20706,ACGTCGAATCTAGGGA,346,346,0,25,19983,0,0
20707,ACGTCGAATCTTGGGA,346,347,1,19,20091,0,0
20708,ACGTCGAATCTAGGGA,346,360,14,20,20092,3,0
20709,ACGTCGAATCTAGGGA,346,357,11,26,20093,2,0
20710,ACGTTGAATCTAGGAA,346,365,19,30,20095,4,0
20711,GCGTCGAATCTAGGGA,346,362,16,25,20098,3,0
20712,TCGTCGAATCTAGGGA,346,347,1,27,20105,0,0
20713,ACGTCGACTCTAGGGA,346,364,18,24,20108,3,0
20714,ACGTCGAATCTAGGGA,346,346,0,25,20110,0,0
20715,ACGTCGAATCTAGGGA,346,346,0,30,20113,0,0
20716,GCATCGAATCTAGGGA,346,355,9,29,20118,0,0
20717,ACGGCTACTCTAGGGA,346,347,1,26,20119,0,0
20718,ACTTCGAATCTAGGGA,346,351,5,32,20120,0,0
20719,ACGTCGATTCTGGGGA,346,423,77,24,20123,22,0
20720,ACGTCGAATCTAGGGA,346,365,19,25,20124,4,0
20721,ACGTCGAATCTAGGGA,346,353,7,24,20129,0,0
20722,ACGTCGAATCTTGGGA,346,356,10,28,20130,1,0
20723,ACGTCGAATCTAGGGA,346,352,6,32,20198,0,0
20724,TCGTCGAATCTAGGGA,346,350,4,27,20219,0,0
20725,ACGTCGAATCTAGGGA,346,350,4,20,20273,0,0
20726,ACGTTGAATCTAGGGA,346,346,0,30,20276,0,0
20727,ACGTCGAATCTAGGGA,346,347,1,25,20279,0,0
20728,ACATCGAATCTAGGGA,346,349,3,29,20285,0,0
20729,ACGTTGAATCTAGGGA,346,376,30,29,20287,7,0
20730,ACGTCGAATCTAGGGA,346,350,4,24,20290,0,0
20731,GCGTCGATTCTGGGGA,346,349,3,24,20292,0,0
20732,ACATCGAATCTAGGGA,346,349,3,29,20293,0,0
20733,ACGTCCAATCTAGGGA,346,349,3,24,20296,0,0
20734,ACGTCGAATCTAGGGA,346,349,3,25,20298,0,0
20735,ACGTCGAATCTAGGGA,346,349,3,24,20299,0,0
20736,ACGTTGAATCTAGGGA,346,349,3,29,20300,0,0
20737,ACGTCGAATCTAGGGA,346,349,3,31,20304,0,0
20738,ACGTTGAATCTAGGGA,346,347,1,30,20307,0,0
20739,ACGTCGAATCTAGGGA,346,347,1,21,20308,0,0
20740,ACGTCGAATCTAGGGA,346,349,3,30,20311,0,0
20741,ACGTCGAATCTAGGGA,346,347,1,27,20312,0,0
20742,ACGTCGAATCTAGGGA,346,347,1,23,20320,0,0
20743,ACGTCGAATCTAGGGA,346,348,2,30,20321,0,0
20744,ACGTCGAATCTAGGGA,346,346,0,28,20322,0,0
20745,TCGTCGAATCTAGGGA,346,349,3,27,20327,0,0
20746,ACGTCGATTCTGGGGA,347,365,18,22,18030,4,0
20747,ACGTCGATTCTGGGGA,347,371,24,22,18388,6,0
20748,ACGTCGAATCTAGGGA,347,349,2,21,18681,0,0
20749,ACGTCGAATCTAGGGA,347,347,0,20,18932,0,0
20750,ACGTTGAATCTAGGGA,347,348,1,24,19114,0,0
20751,ACGTCGAATCTAGGGA,347,358,11,28,19123,2,0
20752,ACGTCGAATGTAGGGA,347,354,7,24,19304,0,0
20753,ACGTCGAATCTAGGGA,347,349,2,29,19630,0,0
20754,TCGTCGAATCTAGGGA,347,366,19,24,19763,4,0
20755,ACGTCGAATCTAGGGA,347,351,4,29,19819,0,0
20756,ACGTCGAATCTAGGGA,347,347,0,27,19822,0,0
20757,ACGTCGATTCTGGGGA,347,392,45,25,19846,13,0
20758,ACGTCGAATCTAGGGA,347,356,9,22,19847,1,0
20759,ACGTCGAATCTAGGGA,347,348,1,29,19849,0,0
20760,ACGTCGAATCTAGGGA,347,347,0,24,19857,0,0
20761,ACGTCGAATGTAGGGA,347,368,21,25,19862,5,0
20762,TCGTCGAATCTAGGGA,347,349,2,27,19863,0,0
20763,ATGTCGAATCTAGGGA,347,352,5,26,19864,0,0
20764,ACGTCGAATCTAGGGA,347,353,6,21,19873,0,0
20765,ACGTCGAATCTAGGGA,347,356,9,25,19882,1,0
20766,ACGTCGAATCTAGGGA,347,349,2,25,20004,0,0
20767,ACGTCGAATCTAGGGA,347,350,3,21,20022,0,0
20768,ACGTCGAATCTAGGGA,347,350,3,27,20023,0,0
20769,ACGTCGAATGTAGGGA,347,350,3,27,20024,0,0
20770,ACGTCGACTCTAGGGA,347,350,3,26,20026,0,0
20771,ACGTCGAATCTAGGGA,347,350,3,22,20030,0,0
20772,ACGTCGAATGTAGGGA,347,348,1,27,20032,0,0
20773,ACGTCGAATCTAGGGA,347,349,2,25,20033,0,0
20774,ACGTTGAATCTAGGGA,347,350,3,31,20035,0,0
20775,ACGTCGAATCTAGGGA,347,350,3,29,20159,0,0
20776,ACGTCGAATCTAGGGT,347,347,0,22,20160,0,0
20777,ACGTCGAATCTAGGGA,347,350,3,21,20164,0,0
20778,ACGTCGAATCTAGGGA,347,350,3,25,20166,0,0
20779,ACGTCGAATCTAGGGA,347,350,3,27,20173,0,0
20780,TCGTCGAATCTAGGGA,347,350,3,25,20178,0,0
20781,ACGTCGAATGTAGGGA,347,350,3,27,20181,0,0
20782,ACGTCGAAAGTAGGGA,347,350,3,24,20184,0,0
20783,ACGTCGAATCTAGGGG,347,350,3,27,20186,0,0
20784,ACGTCGAATCTAGGGA,347,349,2,25,20188,0,0
20785,ACGTCGAATCTAGGGA,347,350,3,28,20191,0,0
20786,ACGTCGAATCTAGGGA,347,350,3,26,20195,0,0
20787,ACGTCGAATCTAGGGA,347,350,3,28,20341,0,0
20788,ACGTCGAATCTAGGGA,347,350,3,28,20342,0,0
20789,ACGTCGAATCTAGGGA,347,350,3,24,20344,0,0
20790,ACGTCGAATCTAAGGA,347,347,0,26,20348,0,0
20791,ACGTCGAATCTAGGGA,347,348,1,25,20354,0,0
20792,ACGTCGAATCTTGGGA,348,353,5,18,17548,0,0
20793,ACGTCGAATCTAGGGA,348,352,4,26,18666,0,0
20794,ACGTCGAATCTAGGGA,348,371,23,24,18812,6,0
20795,ACGTCGAATCTTGGGA,348,353,5,26,18825,0,0
20796,ACATCGAATCTAGGGA,348,350,2,28,19014,0,0
20797,ACATCGAATCTAGGGA,348,348,0,28,19357,0,0
20798,ACGTCGAATCTAGGGA,348,350,2,23,19445,0,0
20799,ACGTCGAATCTAGGGA,348,351,3,24,19512,0,0
20800,ACGTTGAATCTAGGGA,348,359,11,28,19522,2,0
20801,ACGTCGAATCTAGGGA,348,348,0,26,19525,0,0
20802,ACGTCGAATCTAGGGA,348,350,2,30,19627,0,0
20803,ACGTCGAATCTAGGGA,348,382,34,20,19720,9,0
20804,ACGTCGAATCTAGGGA,348,355,7,26,19725,0,0
20805,ACGTCGAATCTAGGGA,348,352,4,28,19734,0,0
20806,ACGTCGAATCTAGGGA,348,353,5,29,19735,0,0
20807,ACGTCGAATCTAGGGA,348,363,15,26,19744,3,0
20808,TCGTCGAATCTAGGGA,348,355,7,26,19758,0,0
20809,ACGTCGATTCTAGGGA,348,359,11,23,19886,2,0
20810,ACGTCGAATCTAGGGA,348,352,4,29,19988,0,0
20811,ACGTCGAATCTAGGGA,348,349,1,29,19990,0,0
20812,ACGTCGAATCTAGGGA,348,358,10,27,19991,1,0
20813,ACGTCGAATCTAGGGA,348,349,1,25,19993,0,0
20814,ACGTCGAATCTAGGGA,348,364,16,28,19996,3,0
20815,TCGTCGAATCTAGGGA,348,353,5,26,19998,0,0
20816,ACGTCGAGTCTAGGGA,348,350,2,29,20003,0,0
20817,ACGTCGATTCTGGGGA,348,364,16,23,20050,3,0
20818,ACGTTGAATCTAGGGA,348,360,12,29,20056,2,0
20819,ACGTCGAATCTAGGGA,348,362,14,22,20059,3,0
20820,ACGTCGAATCTAGGGA,348,354,6,24,20062,0,0
20821,ACGTCGAAAGCAGGGA,348,364,16,23,20067,3,0
20822,ACGTCGAATCTAGGGA,348,376,28,25,20071,7,0
20823,ACGTCGATTCTGGGGA,348,348,0,23,20214,0,0
20824,ACATCGAATCTAGGGA,348,355,7,28,20215,0,0
20825,ACGTCGAATCTAGGGA,348,397,49,26,20216,14,0
20826,ACGTCGAATCTAGGGA,348,351,3,21,20218,0,0
20827,ACGTCGAATCTAGGGA,348,351,3,29,20331,0,0
20828,TCGTCGAATCTAGGGA,348,355,7,26,20334,0,0
20829,ACGTCGAATCTAGGGA,348,356,8,22,20338,0,0
20830,ACGTCGAATCTAGGGA,348,351,3,20,20340,0,0
20831,ACGTCGAATCTAGGGA,348,351,3,26,20397,0,0
20832,ACGTCGAATCTAGGGA,348,351,3,22,20398,0,0
20833,ACATCGAATCTAGGGA,348,350,2,28,20401,0,0
20834,ACGTCGAAAGCTGGGA,348,351,3,23,20403,0,0
20835,ACGTTGAATCTAGGGA,348,349,1,25,20404,0,0
20836,ACGTCGAATCTAGGGA,348,351,3,29,20405,0,0
20837,ACGTCGAATCTAGGGA,348,351,3,22,20410,0,0
20838,ACGTCGAATCTAGGGA,348,351,3,30,20414,0,0
20839,ACGTCGAATCTAGGGA,348,351,3,28,20415,0,0
20840,ACGTCGAATCTAGGGA,348,351,3,23,20422,0,0
20841,ACGTCGAATCTAGGGA,348,351,3,30,20423,0,0
20842,ACGTCGACTCTAGGGA,348,351,3,24,20424,0,0
20843,ACGTCGAATCTAGGGA,348,351,3,29,20425,0,0
20844,TCGTCGAATCTAGGGA,348,351,3,28,20428,0,0
20845,ATGTCGAATCTAGGGA,348,351,3,27,20429,0,0
20846,ACGTCGAATGTAGGGA,348,351,3,28,20432,0,0
20847,ACGTCGAATCTAGGGA,348,349,1,27,20434,0,0
20848,ACGTCGAATCTAGGGA,348,351,3,26,20435,0,0
20849,ACGTCGAATCTATGGA,348,350,2,29,20437,0,0
20850,ACGTCGAATCTAGGGA,348,349,1,25,20438,0,0
20851,ACGTCGAATCTAGGGA,348,351,3,22,20441,0,0
20852,ACGTCGAATCTAGGGA,348,348,0,27,20445,0,0
20853,ACGTCGAATCTAGGGT,349,359,10,21,17603,1,0
20854,ACGTCGAATCTAGGGA,349,353,4,24,17699,0,0
20855,ACGTCGAATCTAGGGA,349,352,3,23,19231,0,0
20856,ACGTCGAATGTAGGGA,349,372,23,26,19233,6,0
20857,ACGTCGAATCTAGGGA,349,369,20,21,19398,5,0
20858,TCGTCGAATCTAGGGT,349,349,0,24,19399,0,0
20859,ACGTCGAATCTAGGGA,349,353,4,21,19575,0,0
20860,ACGTCGGATCTAGGGA,349,357,8,26,19583,1,0
20861,ACGTTGAATCTAGGGA,349,351,2,30,19588,0,0
20862,ACGTCGAATCTAGGGA,349,350,1,27,19590,0,0
20863,ACGTCGATTCTGGGGA,349,349,0,24,19594,0,0
20864,ACGTCGAATCTAGGGA,349,355,6,26,19597,0,0
20865,ACGTCGAATCTAGGGA,349,353,4,31,19604,0,0
20866,ACGTCGAATGTAGGGA,349,365,16,24,19606,3,0
20867,ACGTCGAATCTAGGGA,349,361,12,27,19607,2,0
20868,ACGTCGAATCTAGGGA,349,352,3,25,19610,0,0
20869,ACGTCGAATCTAGGGA,349,353,4,26,19771,0,0
20870,ACGTCGACTCTAGAGA,349,355,6,26,19778,0,0
20871,ACGTCGAATCTAGGGA,349,370,21,21,19937,5,0
20872,ACGTCGAATCTAGGGA,349,362,13,24,19942,2,0
20873,ACGTCGAATGTAGGGA,349,351,2,24,19943,0,0
20874,ACGTCTACTCTAGGGA,349,354,5,25,19950,0,0
20875,ACGTCGAATGTAGGGA,349,350,1,24,19953,0,0
20876,TCGTCGAATCTAGGGA,349,356,7,27,19954,0,0
20877,ACGTCGAATCTTGGGA,349,360,11,23,19959,2,0
20878,TCGTCGAATCTAGGGA,349,349,0,27,19971,0,0
20879,ACGTCGAATCTAGGGA,349,356,7,24,19979,0,0
20880,ACCTCGAATCTAGGGA,349,362,13,25,19983,2,0
20881,ACGTCGAATCTTGGGA,349,356,7,19,20091,0,0
20882,ACGTCGAATCTAGGGA,349,358,9,20,20092,1,0
20883,ACGTCGAATCTAGGGA,349,352,3,26,20093,0,0
20884,GCGTCGAATCTAGGGA,349,352,3,25,20098,0,0
20885,TCGTCGAATCTAGGGA,349,352,3,27,20105,0,0
20886,ACGTCGACTCTAGGGA,349,352,3,24,20108,0,0
20887,ACGTCGAATCTAGGGA,349,349,0,25,20110,0,0
20888,ACGTCGAATCTAGGGA,349,352,3,30,20113,0,0
20889,ACATCGAATCTAGGGA,349,352,3,29,20118,0,0
20890,ACGGCTACTCTAGGGA,349,352,3,26,20119,0,0
20891,ACGTCGAATCTAGGGA,349,352,3,25,20124,0,0
20892,ACGTCGAATCTTGGGA,349,352,3,28,20130,0,0
20893,ACGTCGAATCTAGGGA,349,352,3,32,20198,0,0
20894,TCGTCGAATCTAGGGA,349,351,2,27,20219,0,0
20895,ACGTCGAATCTAGGGA,349,352,3,25,20279,0,0
20896,ACGTCGAATCTAGGGA,349,351,2,24,20290,0,0
20897,ACGTCGATTCTGGGGA,349,351,2,24,20292,0,0
20898,ACATCGAATCTAGGGA,349,350,1,29,20293,0,0
20899,ACGTCGAATCTAGGGA,349,352,3,24,20296,0,0
20900,ACGTCGAATCTAGGGA,349,352,3,25,20298,0,0
20901,ACGTCGAATCTAGGGA,349,350,1,24,20299,0,0
20902,ACGTTGAATCTAGGGA,349,352,3,30,20307,0,0
20903,ACGTCGAATCTAGGGA,349,351,2,30,20311,0,0
20904,ACGTCGAATCTAGGGA,349,352,3,27,20312,0,0
20905,ACGTCGAATCTAGGGA,349,350,1,23,20320,0,0
20906,ACGTCGAATCTAGGGA,349,352,3,30,20321,0,0
20907,ACGTCGAATCTAGGGA,349,349,0,23,20446,0,0
20908,ACGTCGAATCTAGGGA,349,352,3,27,20453,0,0
20909,ACGTCGACTCTAGGGT,349,350,1,26,20454,0,0
20910,ACGTCGAATCTAGGGA,349,352,3,27,20461,0,0
20911,ACGTCGAATCTAGGGA,349,352,3,24,20462,0,0
20912,ACGTCGATTCTGGGGA,350,350,0,22,18388,0,0
20913,ACGTCGAATCTAGGGA,350,390,40,21,18681,11,0
20914,ACGTCGAATCTAGGGA,350,373,23,20,18932,6,0
20915,ACGTTGAATCTAGGGA,350,359,9,24,19114,1,0
20916,ACGTCGAATGTAGGGA,350,350,0,24,19304,0,0
20917,ACGTCGAATCTAGGGA,350,368,18,29,19630,4,0
20918,TCGTCGAATCTAGGGA,350,350,0,24,19763,0,0
20919,ACGTCGAATCTAGGGA,350,351,1,29,19819,0,0
20920,ACGTCGAATCTAGGGA,350,372,22,27,19822,5,0
20921,ACGTCGATTCTGGGGA,350,361,11,25,19846,2,0
20922,ACGTCGAATCTAGGGA,350,367,17,29,19849,4,0
20923,ACGTCGAATCTAGGGA,350,356,6,24,19857,0,0
20924,ATGTCGAATCTAGGGA,350,350,0,26,19864,0,0
20925,ACGTCGAATCTAGGGA,350,350,0,21,19873,0,0
20926,ACGTCGAATCTAGGGA,350,353,3,25,20004,0,0
20927,ACGTCGACTCTAGGGA,350,372,22,26,20026,5,0
20928,ACGTCGAATCTAGGGA,350,356,6,22,20030,0,0
20929,ACGTCGAATGTAGGGA,350,351,1,27,20032,0,0
20930,ACGTCGAATCTAGGGA,350,354,4,25,20033,0,0
20931,ACGTTGAATCTAGGGA,350,352,2,31,20035,0,0
20932,ACGTCGAATCTAGGGT,350,355,5,22,20160,0,0
20933,ACGTCGAATCTAGGGA,350,350,0,25,20166,0,0
20934,TCGTCGAATCTCGGGA,350,350,0,25,20178,0,0
20935,ACGTCGAATGTAGGGA,350,352,2,27,20181,0,0
20936,ACGTCGAAAGTAGGGA,350,351,1,24,20184,0,0
20937,ACGTCGAATCTAGGGA,350,353,3,27,20186,0,0
20938,ACGTCGAATCTAGGGA,350,354,4,25,20188,0,0
20939,ACGTCGAATCTAGGGA,350,359,9,28,20191,1,0
20940,ACGTCGAATCTAGGGA,350,353,3,28,20342,0,0
20941,ACGTCGAATCTAGGGA,350,363,13,24,20344,2,0
20942,ACGTCGAATCTAGGGA,350,350,0,29,20500,0,0
20943,ACGTCGAATCTAGGGT,350,363,13,22,20501,2,0
20944,ACGTCGAATCTAGGGA,350,350,0,25,20502,0,0
20945,ACGTCGAATCTAGGGA,350,354,4,28,20508,0,0
20946,ACGTCGAATCTAGGGA,350,362,12,24,20509,2,0
20947,ACGTCGAATGTAGGGA,350,350,0,27,20510,0,0
20948,ACGTCGAATCTAGGGA,350,366,16,25,20514,3,0
20949,ACGTCGAATCTAGGGA,350,351,1,25,20515,0,0
20950,ACGTCGAATCTAGGAA,350,356,6,22,20516,0,0
20951,ACGTCGAATGTAGGGA,350,364,14,25,20518,3,0
20952,ACGTTGAATCTAGGGA,350,359,9,31,20519,1,0
20953,ACGTCGATTCTGGGGA,350,354,4,25,20521,0,0
20954,ACGTCGAATCTAGGGA,350,353,3,27,20522,0,0
20955,ACGTCGAATCTAGGGA,350,353,3,26,20523,0,0
20956,ACGTCGAATCTAGGGA,350,353,3,25,20524,0,0
20957,ACGTCGAATCTAGGGA,350,350,0,32,20525,0,0
20958,ACGTCGAATCTAGGGA,350,352,2,28,20527,0,0
20959,ACGTCGAATCTAGGGA,350,353,3,26,20528,0,0
20960,ACGTCGAATCTAGGGA,350,353,3,27,20531,0,0
20961,ACGTCGACTCTAGAGA,350,351,1,27,20533,0,0
20962,ACGTCGATTCTGGGGA,350,353,3,24,20534,0,0
20963,ACGTCGAATCTAGGGA,350,350,0,22,20535,0,0
20964,CCGTCGAATGTAGGGA,350,353,3,25,20539,0,0
20965,ACGTCGAATCTAGGGA,350,353,3,28,20542,0,0
20966,ACGTCGAATCTAGGGA,350,350,0,26,20546,0,0
20967,ACGTCGAATCTTGGGA,350,351,1,20,20548,0,0
20968,ACGTCGAATCTAGGGA,350,353,3,26,20556,0,0
20969,ACGTCGACTCTAGGGA,350,353,3,25,20557,0,0
20970,ACGTCGAATCTAGGGA,350,353,3,31,20559,0,0
20971,ACGTCGAATCTAGGGA,350,353,3,32,20562,0,0
20972,ACGTCGAATCTAGGGA,350,353,3,25,20566,0,0
20973,ACGTCGGTTCTGGGGA,350,353,3,25,20567,0,0
20974,ACGTCGAATCTAGGGA,350,353,3,26,20568,0,0
20975,ACGTCGAATCTAGGGA,350,353,3,25,20569,0,0
20976,ACGTCGAATCTTGGGA,350,353,3,29,20570,0,0
20977,ACGTCGAATCTTGGGA,351,356,5,18,17548,0,0
20978,ACGTCGAATCTAGGGA,351,357,6,26,18666,0,0
20979,ACGTCGAATCTTGGGA,351,365,14,26,18825,3,0
20980,ACATCGAATCTAGGGA,351,367,16,28,19014,3,0
20981,ACATCGAATCTAGGGA,351,354,3,28,19357,0,0
20982,ACGTCGAATCTAGGGA,351,356,5,23,19445,0,0
20983,ACGTTGAATCTAGGGA,351,352,1,28,19522,0,0
20984,ACGTCGAATCTAGGGA,351,362,11,30,19627,2,0
20985,ACGTCGAATCTAGGGA,351,352,1,28,19734,0,0
20986,ACGTCGAATCTAGGGA,351,375,24,29,19735,6,0
20987,ACGTCGAATCTAGGGA,351,388,37,26,19744,10,0
20988,TCGTCGAATCTAGGGA,351,351,0,26,19758,0,0
20989,ACGTCGAATCTAGGGA,351,354,3,29,19988,0,0
20990,ACGTGGAATCTAGGGA,351,363,12,29,19990,2,0
20991,ACGTCGAATCTAGGGA,351,363,12,27,19991,2,0
20992,ACGTCGAATCTAGGGA,351,352,1,25,19993,0,0
20993,ACGTCGAATCTAGGGA,351,373,22,28,19996,5,0
20994,TCGTCGAATCTAGGGA,351,362,11,26,19998,2,0
20995,ACGTCGATTCTGGGGA,351,357,6,23,20050,0,0
20996,ACGTCGAATCTAGGGA,351,361,10,22,20059,1,0
20997,ACGTCGAATCTAGGGA,351,352,1,24,20062,0,0
20998,ACGTCGAAAGCAGGGA,351,354,3,23,20067,0,0
20999,ACGTCGAATCTAGGGA,351,352,1,25,20071,0,0
21000,ACGTCGATTCTGGGGA,351,367,16,23,20214,3,0
21001,ACATCGAATCTAGGGA,351,362,11,28,20215,2,0
21002,ACGTCGAATCTAGGGA,351,354,3,26,20216,0,0
21003,ACGTCGAATCTAGGGA,351,361,10,21,20218,1,0
21004,ACGTCGAATCTAAGGA,351,351,0,29,20331,0,0
21005,ACGTCGAATCTAGGGA,351,374,23,22,20338,6,0
21006,ACGTCGAATCTAGGGA,351,355,4,20,20340,0,0
21007,ACGTCGAATCTAGGGA,351,351,0,26,20397,0,0
21008,ACGTCGAATCTAGGGA,351,354,3,22,20398,0,0
21009,ACATCGAATCTAGGGA,351,354,3,28,20401,0,0
21010,ACGTCGAAAGCAGGGA,351,354,3,23,20403,0,0
21011,ACGTCGAATCTAGGGA,351,354,3,29,20405,0,0
21012,ACGTCGAATCTAGGGA,351,354,3,30,20414,0,0
21013,ACGTCGAATCTAGGGA,351,354,3,28,20415,0,0
21014,ACGTCGACTCTAGGGA,351,354,3,24,20424,0,0
21015,TCGTCGAATCTAGGGA,351,352,1,28,20428,0,0
21016,ACGTCGAATGTAGGGA,351,354,3,28,20432,0,0
21017,ACGTCGAATCTAGGGA,351,351,0,27,20434,0,0
21018,ACGTCGAATCTAGGGA,351,354,3,25,20438,0,0
21019,ACGTCGAATCTAGGGA,351,354,3,22,20441,0,0
21020,AAGTCGAATCTAGGGA,351,354,3,27,20445,0,0
21021,ACGTCGAATCTAGGGT,352,354,2,21,17603,0,0
21022,ACGTCGAATCTAGGGA,352,353,1,24,17699,0,0
21023,ACGTCGAATCTAGGGA,352,376,24,23,19231,6,0
21024,ACGTCGAATGTAGGGA,352,369,17,26,19233,4,0
21025,ACGTCGAATCTAGGGA,352,363,11,21,19398,2,0
21026,TCGTCGAATCTAGGGA,352,379,27,24,19399,7,0
21027,ACGTCGAATCTAGGGA,352,353,1,26,19583,0,0
21028,ACGTTGAATCTAGGGA,352,363,11,30,19588,2,0
21029,ACGTCGAATCTAGGGA,352,369,17,27,19590,4,0
21030,ACGTCGATTCTGGGGA,352,358,6,24,19594,0,0
21031,ACGTCGAATCTAGGGA,352,352,0,26,19597,0,0
21032,ACGTCGAATCTAGGGA,352,355,3,31,19604,0,0
21033,ACGTCGAATGTAGGGA,352,356,4,24,19606,0,0
21034,ACGTCGAATCTAGGGA,352,364,12,27,19607,2,0
21035,ACGTCGAATCTAGGGA,352,376,24,25,19610,6,0
21036,ACGTCGAATCTAGGGA,352,352,0,26,19771,0,0
21037,ACGTCGACTCTAGAGA,352,352,0,26,19778,0,0
21038,ACGTCGAATCTAGGGA,352,365,13,21,19937,2,0
21039,ACGTCGAATGTAGGGA,352,353,1,24,19943,0,0
21040,ACGTCGAATGTAGGGA,352,356,4,24,19953,0,0
21041,TCGTCGAATCTAGGGA,352,358,6,27,19954,0,0
21042,ACGTCGAATCTTGGGA,352,355,3,23,19959,0,0
21043,TCGTCGAATCTAGGGA,352,358,6,27,19971,0,0
21044,ACGTCGAATCTAGGGA,352,358,6,24,19979,0,0
21045,GCGTCGAATCTAGGGA,352,355,3,25,20098,0,0
21046,ACGCCGACTCTAGGGA,352,365,13,24,20108,2,0
21047,ACGTCGAATCTAGGGA,352,355,3,30,20113,0,0
21048,ACATCGAATCTAGGGA,352,355,3,29,20118,0,0
21049,ACGGCTACTCTAGGGA,352,355,3,26,20119,0,0
21050,ACGTCGAATCTAGGGA,352,352,0,25,20124,0,0
21051,ACGTCGAATCTCGGGA,352,355,3,28,20130,0,0
21052,ACGTCGAATCTAGGGA,352,353,1,32,20198,0,0
21053,ACGTCGAATCTAGGGA,352,352,0,24,20290,0,0
21054,ACGTCGATTCTGGGGA,352,352,0,24,20292,0,0
21055,ACATCGAATCTAGGGA,352,355,3,29,20293,0,0
21056,ACGTCGAATCTAGGGA,352,353,1,24,20296,0,0
21057,ACGTCGAATCTAGGGA,352,355,3,25,20298,0,0
21058,ACGTCGAATCTAGGGA,352,355,3,24,20299,0,0
21059,ACGTTGAATCTAGGGA,352,355,3,30,20307,0,0
21060,ACGTCGAATCTAGGGA,352,355,3,30,20311,0,0
21061,ACGTCGAATCTAGGGA,352,352,0,27,20312,0,0
21062,ACGTCGAATCTAGGGA,352,352,0,23,20320,0,0
21063,ACGTCGAATCTAGGGA,352,353,1,23,20446,0,0
21064,ACGTCGAATCTAGGGA,352,355,3,27,20453,0,0
21065,ACGTCGACTCTAGGGT,352,352,0,26,20454,0,0
21066,ACGTCGAATCTAGGGA,352,352,0,27,20461,0,0
21067,ACGTCGAATCTTGGGA,352,352,0,19,20625,0,0
21068,ACGTCGAGTCTAGGGA,352,355,3,27,20626,0,0
21069,ACGTCGAATCTTGGGA,352,355,3,27,20628,0,0
21070,ACATCGAATCTAGGGA,352,355,3,29,20629,0,0
21071,ACATCGAATATAGGGA,352,352,0,29,20632,0,0
21072,ACGTCGAATCTAGGGA,352,355,3,24,20633,0,0
21073,ACGTCGAATCTAGGGA,352,355,3,25,20635,0,0
21074,ACGTCGAATCTTGGGA,352,353,1,28,20638,0,0
21075,ACGTCGAATCTAGGGA,352,353,1,21,20640,0,0
21076,ACGTCGAATCTAGGGA,352,355,3,27,20641,0,0
21077,ACGTCGAATCTAGGGA,352,355,3,29,20642,0,0
21078,ACGTCGAATCTCGGGA,352,352,0,30,20643,0,0
21079,TCGTCGAATCTAGGGA,352,355,3,27,20645,0,0
21080,ACGTCGAATCTAGGGA,352,353,1,29,20651,0,0
21081,ACGTCGAGTCTAGGGA,352,355,3,30,20653,0,0
21082,ACGTCGATTCTGGGGA,352,355,3,24,20654,0,0
21083,ACGTTGAATCTAGGGA,352,355,3,30,20655,0,0
21084,ACGTTGAATCTAGGGA,352,354,2,29,20656,0,0
21085,ACGTCGATTCTGGGGA,352,352,0,24,20663,0,0
21086,ACATCGAATCTAGGGA,352,355,3,29,20664,0,0
21087,ACGTCGAATCTAGGGA,352,355,3,30,20667,0,0
21088,ACGTCGAATCTAGGGT,352,355,3,23,20668,0,0
21089,ACGTCGAATCTAGGGA,352,355,3,23,20671,0,0
21090,ACGTCGATTCTGGGGA,353,356,3,22,18388,0,0
21091,ACGTCGAATCTAGGGA,353,361,8,21,18681,1,0
21092,ACGTCGAATCTAGGGA,353,364,11,20,18932,2,0
21093,ACGTTGAATCTAGGGA,353,362,9,24,19114,1,0
21094,ACGTCGAATGTAGGGA,353,366,13,24,19304,2,0
21095,TCGTCGAATCTAGGGA,353,377,24,24,19763,6,0
21096,ACGTCGAATCTAGGGA,353,362,9,29,19819,1,0
21097,ACGTCGAATCTAGGGA,353,353,0,27,19822,0,0
21098,ACGTCGAATCTAGGGA,353,360,7,29,19849,0,0
21099,ACGTCGAATCTAGGGA,353,358,5,24,19857,0,0
21100,ATGTCGAATCTAGGGA,353,355,2,26,19864,0,0
21101,ACGTCGAATCTAGGGA,353,358,5,21,19873,0,0
21102,ACGTCGAATCTAGGGA,353,370,17,25,20004,4,0
21103,ACGTCGACTCTAGGGA,353,361,8,26,20026,1,0
21104,ACGTCGAATCTAGGGA,353,362,9,22,20030,1,0
21105,ACGTCGAATCTAGGGA,353,379,26,25,20033,7,0
21106,ACGTTGAATCTAGGGA,353,353,0,31,20035,0,0
21107,ACGTCGAATCTAGGGT,353,370,17,22,20160,4,0
21108,ACGTCGAATCTAGGGA,353,366,13,25,20166,2,0
21109,ACGTCGAATGTAGGGA,353,354,1,27,20181,0,0
21110,ACGTCGAAAGTAGGGA,353,354,1,24,20184,0,0
21111,ACGTCGAATCTAGGGA,353,355,2,27,20186,0,0
21112,ACGTCGAATCTAGGGA,353,383,30,25,20188,8,0
21113,ACGTCGAATCTAGGGA,353,359,6,28,20191,0,0
21114,ACGTCGAATCTAGGGA,353,357,4,28,20342,0,0
21115,ACGTCGAATCTAGGGA,353,360,7,24,20344,0,0
21116,ACGTCGAATCTAGGGT,353,380,27,22,20501,7,0
21117,ACGTCGAATCTAGGGA,353,361,8,25,20502,1,0
21118,ACGTCGAATCTAGGGA,353,365,12,28,20508,2,0
21119,ACGTCGAATGTAGGGA,353,364,11,27,20510,2,0
21120,ACGTCGAATCTAGGGA,353,358,5,25,20514,0,0
21121,ACGTCGAATCTAGGGA,353,358,5,25,20515,0,0
21122,ACGTCGAATCTAGGGA,353,381,28,22,20516,7,0
21123,ACGTCGAATGTAGGGA,353,370,17,25,20518,4,0
21124,ACGTTGAATCTAGGGA,353,353,0,31,20519,0,0
21125,ACGTCGATTCTGGGGA,353,367,14,25,20521,3,0
21126,ACGTCGAATCTAGGGA,353,356,3,26,20523,0,0
21127,ACGTCGAATCTAGGGA,353,357,4,32,20525,0,0
21128,ACGTCGAATCTAGGGA,353,365,12,28,20527,2,0
21129,ACGTCGAATCTAGGGA,353,363,10,27,20531,1,0
21130,ACGTCGATTCTGGGGA,353,367,14,24,20534,3,0
21131,ACGTCGAATCTAGGGA,353,361,8,22,20535,1,0
21132,ACGTCGAATCTAGGGA,353,355,2,26,20546,0,0
21133,ACGTCGAATCTTGGGA,353,391,38,20,20548,11,0
21134,ACGTCGAATCTAGGGA,353,371,18,26,20556,3,0
21135,ACGTCGACTCTAGGGA,353,357,4,25,20557,0,0
21136,ACGTCGAATCTACGGA,353,356,3,31,20559,0,0
21137,ACGTCGAATCTAGGGA,353,356,3,32,20562,0,0
21138,ACGTCGAATCTAGGGA,353,356,3,25,20566,0,0
21139,ACGTCGAATCTTGGGA,353,356,3,29,20570,0,0
21140,ACGTCGAATCTAGGGA,353,356,3,24,20677,0,0
21141,ACGTCGAATCTAGGGA,353,356,3,22,20679,0,0
21142,ACGTCGAATCTAGGGA,353,356,3,27,20683,0,0
21143,AGGTTGAATCTAGGGA,353,356,3,31,20684,0,0
21144,ACGTCGAATCTAGGGA,353,356,3,28,20685,0,0
21145,ACGTCGAATCTAGGGA,353,356,3,27,20687,0,0
21146,ACGTCGAATCTAGGGA,353,355,2,32,20689,0,0
21147,ACGTCGAATGTAGGGA,353,356,3,25,20690,0,0
21148,ACGTCGAATCTAGGGA,353,355,2,26,20692,0,0
21149,ACGTCGAATCTAGGGA,353,353,0,27,20693,0,0
21150,ACGTCGAAGCTAGGGA,353,353,0,27,20694,0,0
21151,ACGTCGACTCTAGAGA,353,356,3,27,20695,0,0
21152,ACGTCGAATGTAGGGA,353,356,3,25,20698,0,0
21153,TCGTCGAATCTAGGGA,353,355,2,28,20701,0,0
21154,TCGTCGAATCTAGGGA,353,353,0,28,20703,0,0
21155,ACGTCGAATCTAGGGA,353,356,3,21,20708,0,0
21156,ACGTCGAATCTAGGGA,353,356,3,27,20709,0,0
21157,ACGTTGAATCTAGGAA,353,356,3,31,20710,0,0
21158,GCGTCGAATCTAGGGA,353,356,3,26,20711,0,0
21159,ACGTCGAATCTTGGGA,354,354,0,18,17548,0,0
21160,ACGTCGAATCTAGGGA,354,354,0,26,18666,0,0
21161,ACGTCGAATCTTGGGA,354,354,0,26,18825,0,0
21162,ACATCGAATCTAGGGA,354,366,12,28,19014,2,0
21163,ACGTTGAATCTAGGGA,354,360,6,28,19522,0,0
21164,ACGTCGAATCTAGGGA,354,355,1,28,19734,0,0
21165,ACGTCGAATCTAGGGA,354,357,3,29,19735,0,0
21166,ACGTCGAATCTAGGGA,354,362,8,26,19744,1,0
21167,TCGTCGAATCTAGGGA,354,356,2,26,19758,0,0
21168,ACGTCGAATCTAGGGA,354,360,6,29,19990,0,0
21169,ACGTCGAATCTAGGGA,354,360,6,27,19991,0,0
21170,ACGTCGAATCTAGGGA,354,369,15,25,19993,3,0
21171,ACGTCGAATCTAGGGA,354,357,3,28,19996,0,0
21172,TCGTCGAATCTAGGGA,354,382,28,26,19998,7,0
21173,ACGTCGATTGTGGGGA,354,373,19,23,20050,4,0
21174,ACGTCGAATCTAGGGA,354,372,18,22,20059,4,0
21175,ACGTCGAATCTAGGGA,354,360,6,24,20062,0,0
21176,ACGTCGAAAGCAGGGA,354,385,31,23,20067,8,0
21177,ACGTCGAATCTAGGGA,354,362,8,25,20071,1,0
21178,ACGTCGATTCTGGGGA,354,357,3,23,20214,0,0
21179,ACGTCGAATCTAGGGA,354,365,11,26,20216,2,0
21180,ACGTCGAATCTAGGGA,354,356,2,21,20218,0,0
21181,ACGTCGAAACTAGGGA,354,360,6,20,20340,0,0
21182,ACGTCGAATCTAGGGA,354,355,1,26,20397,0,0
21183,ACGTCGAATCTAGGGA,354,362,8,22,20398,1,0
21184,ACGTCGAAAGCAGGGA,354,379,25,23,20403,6,0
21185,ACGTCGAATCTAGGGA,354,366,12,29,20405,2,0
21186,ACGTCGAATCTAGGGA,354,354,0,30,20414,0,0
21187,ACGTCGAATCTAGGGA,354,356,2,28,20415,0,0
21188,ACGTCGACTCTAGGGA,354,357,3,24,20424,0,0
21189,TCGTCGAATCTAGGGA,354,357,3,28,20428,0,0
21190,ACGTCGAATGTAGGGA,354,355,1,28,20432,0,0
21191,ACGTCGAATCTAGGGA,354,356,2,27,20434,0,0
21192,ACGTCGAATCTAGGGA,354,357,3,25,20438,0,0
21193,ACGTCGAATCTAGGGA,354,357,3,22,20441,0,0
21194,ACGTCGAATCTAGGGA,354,357,3,27,20445,0,0
21195,ACGTCGATTCTGGGGA,354,355,1,23,20746,0,0
21196,ACGTCGATTCTGGGGA,354,357,3,23,20747,0,0
21197,ACGTCGAATCTAGGGA,354,357,3,29,20751,0,0
21198,TCGTCGAATCTAGGGA,354,357,3,25,20754,0,0
21199,ACGTCGATTCTGGGGA,354,357,3,26,20757,0,0
21200,ACGTCGAATCTAGGGA,354,357,3,23,20758,0,0
21201,ACGTCGAATGTAGGGA,354,355,1,26,20761,0,0
21202,ACGTCGAATCTAGGGA,354,357,3,26,20765,0,0
21203,ACGTCGAATCTAGGGT,355,355,0,21,17603,0,0
21204,ACGTCGAATCTAGGGA,355,365,10,24,17699,1,0
21205,ACGTCGAATGTAGGGA,355,372,17,26,19233,4,0
21206,ACGTCGAATCTAGGGA,355,357,2,21,19398,0,0
21207,ACGTTGAATCTAGGGA,355,355,0,30,19588,0,0
21208,ACGTCGAATCTAGGGA,355,365,10,27,19590,1,0
21209,ACGTCGATTCTGGGGA,355,389,34,24,19594,9,0
21210,ACGTCGAATCTAGGGA,355,358,3,26,19597,0,0
21211,ACGTCGAATCTAGGGA,355,355,0,31,19604,0,0
21212,ACGTCGAATGTAGGGA,355,367,12,24,19606,2,0
21213,ACGTCGAATCTAGGGA,355,355,0,27,19607,0,0
21214,ACGTCGAATCTAGGGA,355,358,3,25,19610,0,0
21215,ACGTCGAATCTAGGGA,355,360,5,26,19771,0,0
21216,ACGTCGACTCTAGAGA,355,363,8,26,19778,1,0
21217,ACGTCGAATCTAGGGA,355,356,1,21,19937,0,0
21218,ACGTCGAATGTAGGGA,355,374,19,24,19943,4,0
21219,ACGTCGAATGTAGGGA,355,368,13,24,19953,2,0
21220,TCGTCGAATCTAGGGA,355,360,5,27,19954,0,0
21221,TCGTCGAATCTAGGGA,355,370,15,27,19971,3,0
21222,ACGTCGACTCTAGGGA,355,365,10,24,20108,1,0
21223,ACATCGAATCTAGGGA,355,355,0,29,20118,0,0
21224,ACGGCTACTCTAGGGA,355,358,3,26,20119,0,0
21225,ACGTCGAATCTAGGGA,355,358,3,25,20124,0,0
21226,ACGTCGAATCTTGGGA,355,358,3,28,20130,0,0
21227,ACGTCGAATCTAGGGA,355,358,3,32,20198,0,0
21228,ACGTCGAATCTAGGGA,355,358,3,24,20290,0,0
21229,ACATCGAATCTAGGGA,355,355,0,29,20293,0,0
21230,ACGTCGAATCTAGGGA,355,357,2,24,20296,0,0
21231,ACGTCGAATCTAGGGA,355,358,3,25,20298,0,0
21232,ACGTCGAATCTAGGGA,355,355,0,24,20299,0,0
21233,ACGTTGAATCTAGGGA,355,358,3,30,20307,0,0
21234,ACGTCGAATCTAGGGA,355,358,3,30,20311,0,0
21235,AGGTCGAATCTAGGGA,355,358,3,27,20312,0,0
21236,ACGTCGAATCTAGGGA,355,358,3,23,20320,0,0
21237,ACGTCGAATCTAGGGA,355,355,0,23,20446,0,0
21238,ACGTCGAATCTAGGGA,355,357,2,27,20453,0,0
21239,ACGTCGACTCTAGGGT,355,358,3,26,20454,0,0
21240,ACGTCGAATCTAGGGA,355,358,3,27,20461,0,0
21241,ACGTCGAATCTTGGGA,355,358,3,19,20625,0,0
21242,ACGTCGAGTCTAGGGA,355,358,3,27,20626,0,0
21243,ACATCGAATCTAGGGA,355,358,3,29,20629,0,0
21244,ACATCGAATCTAGGGA,355,355,0,29,20632,0,0
21245,ACGTCGAATCTAGGGA,355,356,1,24,20633,0,0
21246,ACGTCGAATCTTGGGA,355,358,3,28,20638,0,0
21247,ACGTCGAATCTAGGGA,355,358,3,21,20640,0,0
21248,ACGTCGAATCTAGGGA,355,358,3,29,20642,0,0
21249,ACGTCGAATCTCGGGA,355,358,3,30,20643,0,0
21250,TCGTCGAATCTAGGGA,355,358,3,27,20645,0,0
21251,ACGTCGAATCTAGGGA,355,358,3,29,20651,0,0
21252,ACGTCGAGTCTAGGGA,355,358,3,30,20653,0,0
21253,ACGTCGATTCTGGGGA,355,358,3,24,20654,0,0
21254,ACGTTGAATCTAGGGA,355,358,3,30,20655,0,0
21255,ACGTTGAATCTAGGGA,355,358,3,29,20656,0,0
21256,ACATCGAATCTAGGGA,355,358,3,29,20664,0,0
21257,ACGTCGAATCTAGGGA,355,358,3,30,20667,0,0
21258,ACGTCGAATCTAGGGT,355,358,3,23,20668,0,0
21259,ACGTCGAATCTAGGGA,355,358,3,23,20671,0,0
21260,ACGTCGACTCTAGGGA,355,358,3,25,20713,0,0
21261,ACGTCGATTCTGGGGA,355,358,3,25,20719,0,0
21262,ACGTCGAATCTAGGGA,355,358,3,26,20720,0,0
21263,ACGTCGAATCTTGGGA,355,358,3,29,20722,0,0
21264,ACGTTGAATCTAGGGA,355,357,2,30,20729,0,0
21265,ACGTCGAATCTAGGGA,355,358,3,25,20794,0,0
21266,ACGTTGAATCTAGGGA,355,358,3,29,20800,0,0
21267,ACGTCGAATCTAGGGA,355,356,1,21,20803,0,0
21268,ACGTCGAATCTAGGGA,355,358,3,27,20807,0,0
21269,ACGTCGATTCTAGGGA,355,358,3,24,20809,0,0
21270,ACGTCGAATCTAGGGA,355,355,0,28,20812,0,0
21271,ACGTCGAATCTAGGGA,355,358,3,29,20814,0,0
21272,ACGTCGATTCTGGGGA,355,358,3,24,20817,0,0
21273,ACGTTGAATCTAGGGA,355,358,3,30,20818,0,0
21274,ACGTCGAATCTAGGGA,355,358,3,23,20819,0,0
21275,ACGTCGAAAGCAGGGA,355,358,3,24,20821,0,0
21276,ACGTCGAATCTAGGGA,355,358,3,26,20822,0,0
21277,ACGTCGAATCTAGGGA,355,358,3,27,20825,0,0
21278,ACGTCGATTCTGGGGA,356,358,2,22,18388,0,0
21279,ACGTCGAATCTAGGGA,356,361,5,21,18681,0,0
21280,ACGTCGAATCTAGGGA,356,366,10,20,18932,1,0
21281,TCGTCGAATCTAGGGA,356,382,26,24,19763,7,0
21282,ACGTCGAATCTAGGGA,356,360,4,27,19822,0,0
21283,ACGTCGAATCTAGGGA,356,379,23,29,19849,6,0
21284,ACGTCGAATCTAGGGA,356,365,9,24,19857,1,0
21285,ATGTCGAATCTAGGGA,356,356,0,26,19864,0,0
21286,ACGTCGAATCTAGGGA,356,357,1,21,19873,0,0
21287,ACGTCGAATCTAGGGA,356,370,14,25,20004,3,0
21288,ACGTCGACTCTAGGGA,356,369,13,26,20026,2,0
21289,ACGTCGAATCTAGGGA,356,361,5,22,20030,0,0
21290,ACGTCGAATCTAGGGA,356,376,20,25,20033,5,0
21291,ACGTCGAATCTAGGGT,356,374,18,22,20160,4,0
21292,ACGTCGAATCTAGGGA,356,371,15,25,20166,3,0
21293,ACGTCGAAAGTAGGGA,356,359,3,24,20184,0,0
21294,ACGTCGAATCTAGGGA,356,357,1,27,20186,0,0
21295,ACGTCGAATCTAGGGA,356,366,10,25,20188,1,0
21296,ACGTCGAATCTAGGGA,356,377,21,28,20191,5,0
21297,ACGTCGAATCTAGGGA,356,358,2,24,20344,0,0
21298,ACGTCGAATCTAGGGT,356,359,3,22,20501,0,0
21299,ACGTCGAATCTAGGGA,356,371,15,25,20502,3,0
21300,ACGTCGAATGTAGGGA,356,359,3,27,20510,0,0
21301,ACGTCGAATCTAGGGA,356,365,9,25,20514,1,0
21302,ACGTCGAATCTAGGGA,356,358,2,25,20515,0,0
21303,ACGTCGAATCTAGGGA,356,357,1,22,20516,0,0
21304,ACGTCGAATGTAGGGA,356,357,1,25,20518,0,0
21305,ACGTCGAATCTAGGGA,356,361,5,26,20523,0,0
21306,ACGTCGAATCTAGGGA,356,363,7,32,20525,0,0
21307,ACGTCGAATCTAGGGA,356,357,1,28,20527,0,0
21308,ACGTCGAATCTAGGGA,356,360,4,27,20531,0,0
21309,ACGTCGATTCTGGGGA,356,371,15,24,20534,3,0
21310,ACGTCGAATCTAGGGA,356,371,15,26,20546,3,0
21311,ACGTCGAATCTTGGGA,356,356,0,20,20548,0,0
21312,ACGTCGAATCTAGGGA,356,362,6,26,20556,0,0
21313,ACGTCGACTCTAGGGA,356,379,23,25,20557,6,0
21314,ACGTCGAATCTAGGGA,356,375,19,31,20559,4,0
21315,ACGTCGAATCTTGGGA,356,368,12,29,20570,2,0
21316,ACGTCGAATCTAGGGA,356,357,1,24,20677,0,0
21317,ACGTCGAATCTAGGGA,356,364,8,22,20679,1,0
21318,ACGTCGAATCTAGGGA,356,361,5,27,20683,0,0
21319,ACGTTGAATCTAGGGA,356,366,10,31,20684,1,0
21320,ACGTCGAATCTAGGGA,356,364,8,28,20685,1,0
21321,ACGTCGAATCTAGGGA,356,368,12,27,20687,2,0
21322,ACGTCGAATCTAGGGA,356,356,0,32,20689,0,0
21323,CCGTCGAATGTAGGGA,356,357,1,25,20690,0,0
21324,ACGTCGAATCTAGGGA,356,359,3,26,20692,0,0
21325,ACGTCGAATCTAGGGA,356,367,11,27,20693,2,0
21326,ACGTCGAAGCTAGGGA,356,358,2,27,20694,0,0
21327,ACGTCGACTCTAGAGA,356,359,3,27,20695,0,0
21328,ACGTCGAATGTAGGGA,356,359,3,25,20698,0,0
21329,TCGTCGAATCTAGGGA,356,365,9,28,20701,1,0
21330,TCGTCGAATCTAGGGA,356,368,12,28,20703,2,0
21331,ACGTCGAATCTAGGGA,356,359,3,21,20708,0,0
21332,ACGTCGAATCTAGGGA,356,358,2,27,20709,0,0
21333,ACGTTGAATCTAGGAA,356,360,4,31,20710,0,0
21334,GCGTCGAATCTAGGGA,356,362,6,26,20711,0,0
21335,ACGTCGAATCTAGGGT,356,356,0,22,20853,0,0
21336,ACGTCGAATGTAGGGA,356,366,10,27,20856,1,0
21337,ACGTCGAATCTAGGGA,356,362,6,22,20857,0,0
21338,ACGTCGGATCTAGGGA,356,359,3,27,20860,0,0
21339,ACGTCGAATGTAGGGA,356,359,3,25,20866,0,0
21340,ACGTCGAATCTGGGGA,356,358,2,28,20867,0,0
21341,ACGTCGAATCTAGGGA,356,364,8,22,20871,1,0
21342,ACGTCGAAGCTAGGGA,356,361,5,25,20872,0,0
21343,ACGTCGAATCTTGGGA,356,381,25,24,20877,6,0
21344,ACCTCGAATCTAGGGA,356,361,5,26,20880,0,0
21345,ACGTCGAATCTAGGGA,357,358,1,26,18666,0,0
21346,ACGTCGAATCTTGGGA,357,365,8,26,18825,1,0
21347,ACATCGAATCTAGGGA,357,357,0,28,19014,0,0
21348,ACGTCGAATCTAGGGA,357,364,7,28,19734,1,0
21349,ACGTCGAATCTAGGGA,357,372,15,26,19744,4,0
21350,TCGTCGAATCTAGGGA,357,358,1,26,19758,0,0
21351,ACGTCGAATCTAGGGA,357,359,2,29,19990,0,0
21352,ACGTCGAATCTAGGGA,357,357,0,27,19991,0,0
21353,ACGTCGAATCTAGGGA,357,370,13,25,19993,2,0
21354,ACGTCGAATCTAGGGA,357,367,10,28,19996,1,0
21355,TCGTCGAATCTAGGGA,357,362,5,26,19998,0,0
21356,ACGTCGATTCTGGGGA,357,361,4,23,20050,0,0
21357,ACGTCGAATCTAGGGA,357,360,3,24,20062,0,0
21358,ACGTCGAAAGCAGGGA,357,364,7,23,20067,0,0
21359,ACGTCGAATCTAGGGA,357,398,41,25,20071,12,0
21360,ACGTCGATTCTGGGGA,357,359,2,23,20214,0,0
21361,ACGTCGAATCTAGGGA,357,360,3,21,20218,0,0
21362,ACGTCGAATCTAGGGA,357,362,5,20,20340,0,0
21363,ACGTCGAATCTAGGGA,357,369,12,22,20398,2,0
21364,ACGTCGAAAGCAGGGA,357,393,36,23,20403,10,0
21365,ACGTCGAATCTAGGGA,357,357,0,29,20405,0,0
21366,ACGTCGAATCTAGGGA,357,359,2,28,20415,0,0
21367,ACGTCGACTCTAGGGA,357,376,19,24,20424,4,0
21368,TCGTCGAATCTAGGGA,357,360,3,28,20428,0,0
21369,ACGTCGAATGTAGGGA,357,371,14,28,20432,3,0
21370,ACGTCGAATCTAGGGA,357,367,10,27,20434,1,0
21371,ACGTCGAATCTAGGGA,357,362,5,25,20438,0,0
21372,ACGTCGAATCTAGGGA,357,359,2,22,20441,0,0
21373,ACGTCGAATCTAGGGA,357,367,10,27,20445,1,0
21374,ACGTCGATTCTGGGGA,357,366,9,23,20746,1,0
21375,ACGTCGATTCTGGGGA,357,369,12,23,20747,2,0
21376,ACGTCGAATCTAGGGA,357,369,12,29,20751,2,0
21377,TTGTCGAATCTAGGGA,357,357,0,25,20754,0,0
21378,ACGTCGATTGTGGGGA,357,380,23,26,20757,6,0
21379,ACGTCGAATGTAGCGA,357,375,18,26,20761,3,0
21380,ACGTCGAATCTAGGGA,357,360,3,21,20882,0,0
21381,ACGTCGAATCTAGGGA,357,374,17,22,20913,3,0
21382,ACGTCGAATCTAGGGA,357,361,4,21,20914,0,0
21383,ACGTTGAATCTAGGGA,357,365,8,25,20915,0,0
21384,ACGTCGAATCTAGGGA,357,359,2,30,20917,0,0
21385,ACGTCGAATCTAGGGA,357,359,2,28,20920,0,0
21386,ACGTCGATTCTGGGGA,357,360,3,26,20921,0,0
21387,ACGTCGAATCTAGGGA,357,360,3,30,20922,0,0
21388,ACGTCGACTCTAGGGA,357,360,3,27,20927,0,0
21389,ACGTCGAATCTAGGGA,357,360,3,29,20939,0,0
21390,ACGTCGAATCTAGGGA,357,358,1,25,20941,0,0
21391,ACGTCGAATCTAGGGT,357,360,3,23,20943,0,0
21392,ACGTCGAATCTAGGGA,357,360,3,25,20946,0,0
21393,ACGTCGAATCTAGGGA,357,357,0,26,20948,0,0
21394,ACGTCGAATGTAGGGA,357,360,3,26,20951,0,0
21395,ACGTTGAATCTAGGGA,357,360,3,32,20952,0,0
21396,ACGTCGAATCTAGGGA,358,365,7,24,17699,0,0
21397,ACGTCGAATGTAGGGA,358,362,4,26,19233,0,0
21398,ACGTTGAATCTAGGGA,358,372,14,30,19588,3,0
21399,ACGTCGAATCTAGGGA,358,368,10,27,19590,1,0
21400,ACATCGAATGTAGGGA,358,377,19,24,19606,4,0
21401,ACGTCGAATCTAGGGA,358,359,1,27,19607,0,0
21402,ACGTCGACTCTAGAGA,358,371,13,26,19778,2,0
21403,TCGTCGAATCTAGGGA,358,358,0,27,19971,0,0
21404,ACGTCGACTCTAGGGA,358,361,3,24,20108,0,0
21405,ACATCGAATCTAGGGA,358,374,16,29,20118,3,0
21406,ACGGCTACTCTAGGGA,358,364,6,26,20119,0,0
21407,ACGTCGAATCTAGGGA,358,374,16,25,20124,3,0
21408,ACGTCGAATCTTGGGA,358,372,14,28,20130,2,0
21409,ACGGCGAATCTAGGGA,358,361,3,32,20198,0,0
21410,ACGTCGAATCTAGGGA,358,361,3,24,20299,0,0
21411,ACGTCGAATCTAGGGA,358,361,3,30,20311,0,0
21412,ACGTCGAATCTAGGGA,358,360,2,23,20446,0,0
21413,ACGTCGAATCTAGGGA,358,361,3,27,20453,0,0
21414,ACGTCGACTCTAGGGT,358,361,3,26,20454,0,0
21415,ACGTCGAGTCTAGGGA,358,359,1,27,20626,0,0
21416,ACATCGAATCTAGGGA,358,361,3,29,20629,0,0
21417,ACGTCGAATCTAGGGA,358,361,3,24,20633,0,0
21418,ACGTCGAATCTTGGGA,358,361,3,28,20638,0,0
21419,ACGTCGAATCTAGGGA,358,361,3,21,20640,0,0
21420,TCGTCGAATCTAGGGA,358,360,2,27,20645,0,0
21421,ACGTCGAATCTAGGGA,358,361,3,29,20651,0,0
21422,ACGTCGAGTCTAGGGA,358,361,3,30,20653,0,0
21423,ACGTCGATTCTGGGGA,358,361,3,24,20654,0,0
21424,ACGTTGAATCTAGGGA,358,361,3,29,20656,0,0
21425,ACATCGAATCTAGGGA,358,361,3,29,20664,0,0
21426,ACGTCCAATCTAGGGT,358,361,3,23,20668,0,0
21427,ACGTCGACTCTAGGGA,358,360,2,25,20713,0,0
21428,ACGTCGATTCTGGGGA,358,361,3,25,20719,0,0
21429,ACGTCGAATCTAGGGA,358,361,3,26,20720,0,0
21430,ACGTTGAATCTAGGGA,358,361,3,30,20729,0,0
21431,ACGTCGAATCTAGGGA,358,361,3,25,20794,0,0
21432,ACGTTGAATCTAGGGA,358,361,3,29,20800,0,0
21433,ACGTCGAATCTAGGGA,358,361,3,21,20803,0,0
21434,ACGTCGAATCTAGGGA,358,360,2,27,20807,0,0
21435,ACGTCGATTCTAGGGA,358,361,3,24,20809,0,0
21436,ACGTCGAATCTAGGGA,358,361,3,29,20814,0,0
21437,ACGTCGATACTGGGGA,358,361,3,24,20817,0,0
21438,ACGTTGAATCTAGGGA,358,361,3,30,20818,0,0
21439,ACGTCGAATCTAGGGA,358,361,3,23,20819,0,0
21440,ACGTCGAAAGCAGGGA,358,361,3,24,20821,0,0
21441,ACGTCGAATCTAGGGA,358,359,1,26,20822,0,0
21442,ACGTCGAATCTAGGGA,358,361,3,27,20825,0,0
21443,ACGTCGAATCTTGGGA,358,359,1,27,20979,0,0
21444,ACATCGAATCTAGGGA,358,361,3,29,20980,0,0
21445,ACGTCGAATCTAGGGA,358,361,3,31,20984,0,0
21446,ACGTCGAATCTAGGGA,358,361,3,30,20986,0,0
21447,ACGTCGAATCTAGGGA,358,361,3,27,20987,0,0
21448,ACGTGGAATCTAGGGA,358,361,3,30,20990,0,0
21449,ACGTCGAATCTAGGGA,358,361,3,28,20991,0,0
21450,ACGTCGAATCTAGGGA,358,361,3,29,20993,0,0
21451,TCGTCGAATCTAGGGA,358,360,2,27,20994,0,0
21452,ACGTCGAATCTAGGGA,358,358,0,23,20996,0,0
21453,ACGTCGATTCTGGGGA,358,361,3,24,21000,0,0
21454,ACATCGAATCTAGGGA,358,359,1,29,21001,0,0
21455,ACGTCGAATCTAGGGA,358,360,2,22,21003,0,0
21456,ACGTCGAATCTAGGGA,358,360,2,23,21005,0,0
21457,ACGTCGATTCTGGGGA,359,366,7,22,18388,0,0
21458,ACGTCGAATCTAGGGA,359,364,5,20,18932,0,0
21459,ACGTCGAATCTAGGGA,359,367,8,27,19822,1,0
21460,ACGTCGAATCTAGGGA,359,361,2,29,19849,0,0
21461,ACGTCGAATCTAGGGA,359,360,1,24,19857,0,0
21462,ACGTCGAATCTAGGGA,359,371,12,21,19873,2,0
21463,ACGTCGAATCTAGGGA,359,361,2,25,20004,0,0
21464,ACGTCGAATCTAGGGA,359,383,24,22,20030,6,0
21465,ACGTCGAATCTAGGGT,359,394,35,22,20160,10,0
21466,ACGTCGAAAGTAGGGA,359,359,0,24,20184,0,0
21467,ACGTCGAATCTAGGGA,359,359,0,27,20186,0,0
21468,ACGTCGAATCTAGGGA,359,367,8,25,20188,1,0
21469,ACGTCGAATCTAGGGA,359,381,22,28,20191,5,0
21470,ACGTCGAATCTAGGGA,359,373,14,24,20344,3,0
21471,ACGTCGAATCTAGGGA,359,371,12,25,20502,2,0
21472,ACGTCGAATGTAGGGA,359,359,0,27,20510,0,0
21473,ACGTCGAATCTAGGGA,359,364,5,25,20514,0,0
21474,ACGTCGAATCTAGGGA,359,360,1,25,20515,0,0
21475,ACGTCGAATCTAGGGA,359,359,0,22,20516,0,0
21476,ACGTCGAATGTAGGGA,359,361,2,25,20518,0,0
21477,ACGTCGAATCTAGGGA,359,367,8,26,20523,1,0
21478,ACGTCGAATCTAGGGA,359,362,3,32,20525,0,0
21479,ACGTCTAATCTAGGGA,359,359,0,27,20531,0,0
21480,ACGTCGAATCTAGGGA,359,379,20,26,20546,5,0
21481,ACGTCGACTCTAGGGA,359,365,6,25,20557,0,0
21482,ACGTCGAATCTAGGGA,359,378,19,31,20559,4,0
21483,ACGTCGAATCTAGGGA,359,368,9,27,20683,1,0
21484,ACGTTGAATCTAGGGA,359,365,6,31,20684,0,0
21485,ACGTCGAATCTAGGGA,359,362,3,28,20685,0,0
21486,ACGTCGAATCTAGGGT,359,367,8,27,20687,1,0
21487,ACGTCGAATCTAGCGA,359,365,6,32,20689,0,0
21488,ACGTCGAATGTAGGGA,359,362,3,25,20690,0,0
21489,ACGTCGAATCTAGGGA,359,363,4,26,20692,0,0
21490,ACGTCGAAGCTAGGGA,359,370,11,27,20694,2,0
21491,ACGTCGAATGTAGGGA,359,369,10,25,20698,1,0
21492,TCGTCGAATCTAGGGA,359,359,0,28,20701,0,0
21493,TCGTCGAATCTCGGGA,359,364,5,28,20703,0,0
21494,ACGTCGAATCTAGGGA,359,370,11,21,20708,2,0
21495,ACGTTGAATCTAGGAA,359,362,3,31,20710,0,0
21496,GCGTCGAATCTAGGGA,359,375,16,26,20711,3,0
21497,ACGTCGAATGTAGGGA,359,372,13,27,20856,2,0
21498,ACGTCGAATCTAGGGA,359,370,11,22,20857,2,0
21499,ACGTCGAATGTAGGGA,359,359,0,25,20866,0,0
21500,ACGTCGAATCTAGGGA,359,360,1,28,20867,0,0
21501,ACGTCGAATCTAGGGA,359,370,11,22,20871,2,0
21502,ACGTCGAATCTAGGGA,359,363,4,25,20872,0,0
21503,ACGTCGAATCTTGGGA,359,367,8,24,20877,1,0
21504,ACCTCGAATCTAGGGA,359,359,0,26,20880,0,0
21505,ACGTCGAATCTAGGGA,359,368,9,24,21023,1,0
21506,ACGTTGAATGTAGGGA,359,374,15,27,21024,3,0
21507,ACGTCGAATCTAGGGA,359,361,2,22,21025,0,0
21508,TCGTCGAATCTAGGGA,359,370,11,25,21026,2,0
21509,ACGTTGAATCTAGGGA,359,359,0,31,21028,0,0
21510,ACGTCGAATCTAGGGA,359,383,24,28,21029,6,0
21511,ACGTCGAATCTAGGGA,359,359,0,28,21034,0,0
21512,ACGTCGAATCTAGGGA,359,365,6,26,21035,0,0
21513,ACGTCGAATCTAGGGA,359,374,15,22,21038,3,0
21514,ACGCCGACTCTAGGGA,359,369,10,25,21046,1,0
21515,ACGTCGAATCTAGGGA,360,362,2,26,18666,0,0
21516,ACGTCGAATCTTGGGA,360,362,2,26,18825,0,0
21517,ACATCGAATCTAGGGA,360,360,0,28,19014,0,0
21518,ACGTCGAATCTAGGGA,360,360,0,26,19744,0,0
21519,TCGTCGAATCTAGGGA,360,368,8,26,19758,1,0
21520,ACGTCGAATCTAGGGA,360,366,6,27,19991,1,0
21521,ACGTCGAATCTAGGGA,360,360,0,25,19993,0,0
21522,ACGTCGAATCTAGGGA,360,367,7,28,19996,1,0
21523,TCGTCGAATCTAGGGA,360,364,4,26,19998,0,0
21524,ACGTCGATTCTGGGGA,360,367,7,23,20050,1,0
21525,ACGTCGAATCTACGGA,360,361,1,24,20062,0,0
21526,ACGTCGAAAGCAGGGA,360,364,4,23,20067,0,0
21527,ACGTCGAATCTAGGGA,360,372,12,25,20071,2,0
21528,ACGTCGAATCTAGGGA,360,370,10,21,20218,1,0
21529,ACGTCGAATCTAGGGA,360,373,13,22,20398,2,0
21530,ACGTCGAAAGCAGGGA,360,369,9,23,20403,1,0
21531,ACGTCGAATCTAGGGA,360,360,0,29,20405,0,0
21532,ACGTCGACTCTAGGGA,360,360,0,24,20424,0,0
21533,ACGTCGAATGTAGGGA,360,361,1,28,20432,0,0
21534,ACGTCGAATCTAGGGA,360,377,17,25,20438,4,0
21535,ACGTCGAATCTAGGGA,360,370,10,22,20441,1,0
21536,ACGTCGAATCTAGGGA,360,363,3,27,20445,0,0
21537,ACGTCGATTCTGGGGA,360,368,8,23,20746,1,0
21538,ACGTCGATTCTGGGGA,360,364,4,23,20747,0,0
21539,TCGTCGAATCTAGGGA,360,373,13,25,20754,2,0
21540,ACGTCGATTCTGGGGA,360,361,1,26,20757,0,0
21541,ACGTCGAATGTAGGGA,360,360,0,26,20761,0,0
21542,ACGTCGAATCTAGGGA,360,360,0,22,20913,0,0
21543,ACGTCGAATCTAGGGA,360,362,2,21,20914,0,0
21544,ACGTCGAATCTAGGGA,360,376,16,30,20917,3,0
21545,ACGTCGAATCTAGGGA,360,360,0,28,20920,0,0
21546,ACGTCGATTCTGGGGA,360,363,3,26,20921,0,0
21547,ACGTCGAATCTAGGGA,360,363,3,30,20922,0,0
21548,ACGTCGACTCTAGGGA,360,363,3,27,20927,0,0
21549,ACGTCGAATCTAGGGA,360,363,3,25,20941,0,0
21550,ACGTCGAATCTAGGGT,360,363,3,23,20943,0,0
21551,ACGTCGAATCTAGGGA,360,362,2,25,20946,0,0
21552,ACGTCGAATCTAGGGA,360,363,3,26,20948,0,0
21553,ACGTCGAATGTAGGGA,360,363,3,26,20951,0,0
21554,ACGTCGAATCTAGGGA,360,363,3,22,21091,0,0
21555,ACGTCGAATCTAGGGA,360,363,3,21,21092,0,0
21556,ACGTTGAATCTAGGGA,360,363,3,25,21093,0,0
21557,ACGTCGAATGTAGGGA,360,360,0,25,21094,0,0
21558,TCGTCGAATCTAGGGA,360,363,3,25,21095,0,0
21559,ACGTCGAATCTAGGGA,360,363,3,30,21096,0,0
21560,ACGTCGAATCTAGGGA,360,363,3,26,21102,0,0
21561,ACGTCGACTCTAGGGA,360,360,0,27,21103,0,0
21562,ACGTCGAATCTAGGGA,360,363,3,23,21104,0,0
21563,ACGTCGAATCTAGGGA,360,363,3,26,21105,0,0
21564,ACGTCGAATCTAGGTT,360,363,3,23,21107,0,0
21565,ACGTCGAATCTAGGGA,360,363,3,26,21108,0,0
21566,ACGTCGAATCTAGGGA,360,363,3,26,21112,0,0
21567,ACGTCGAATCTAGGGT,360,361,1,23,21116,0,0
21568,ACGTCGAATCTAGGGA,360,360,0,26,21117,0,0
21569,ACGTCGAATCTAGGGA,360,363,3,29,21118,0,0
21570,ACGTCGAATGTAGGGA,360,360,0,28,21119,0,0
21571,ACGTCGAATCTAGGGA,360,363,3,23,21122,0,0
21572,ACGTCGAATGTAGGGA,360,363,3,26,21123,0,0
21573,ACGTCGATTCTGGGGA,360,363,3,26,21125,0,0
21574,ACGTCGAATCTAGGGA,360,363,3,29,21128,0,0
21575,ACGTCGAATCTAGGGA,360,363,3,28,21129,0,0
21576,ACGTCGATTCTGGGGA,360,362,2,25,21130,0,0
21577,ACGTCGAATCTAGGGA,360,363,3,23,21131,0,0
21578,ACGTCGAATCTTGGGA,360,363,3,21,21133,0,0
21579,ACGTCGAATCTAGGGA,361,393,32,24,17699,9,0
21580,ACGACGAATGTAGGGA,361,382,21,26,19233,5,0
21581,ACGTCGACTCTAGAGA,361,364,3,26,19778,0,0
21582,TCGTCGAATCTAGGGA,361,366,5,27,19971,0,0
21583,ACATCGAATCTAGGGA,361,376,15,29,20118,3,0
21584,ACGGCTACTCTAGGGA,361,368,7,26,20119,0,0
21585,ACGTCGAATCTAGGGA,361,378,17,25,20124,4,0
21586,ACGTCGAATCTTGGGA,361,363,2,28,20130,0,0
21587,ACGTCGAATCTAGGGA,361,370,9,32,20198,1,0
21588,ACGTCGAATCTAGGGA,361,366,5,24,20299,0,0
21589,ACGTCGAATCTAGGGA,361,372,11,30,20311,2,0
21590,ACGTCGAATCTAGGGA,361,369,8,23,20446,1,0
21591,ACGTCGACTCTAGGGT,361,366,5,26,20454,0,0
21592,ACGTCGAATCTAGGGA,361,370,9,24,20633,1,0
21593,ACGTCGAATCTTGGGA,361,368,7,28,20638,0,0
21594,ACGTCGAGTCTAGGGA,361,395,34,30,20653,9,0
21595,ACTTTGAATCTAGGGA,361,374,13,29,20656,2,0
21596,ACGTCGACTCTAGGGA,361,362,1,25,20713,0,0
21597,ACGTCGATTCTGGGGA,361,364,3,25,20719,0,0
21598,ACGTCGAATCTAGGGA,361,384,23,26,20720,6,0
21599,ACGTTGAATCTAGGGA,361,364,3,30,20729,0,0
21600,ACGTCGAATCTAGGGA,361,377,16,25,20794,3,0
21601,ACGTCGAATCTAGGGA,361,366,5,21,20803,0,0
21602,ACGTCGAATCTAGGGA,361,377,16,27,20807,3,0
21603,ACGTCGAATCTAGGGA,361,370,9,29,20814,1,0
21604,ACGTCGATTCTGGGGA,361,371,10,24,20817,1,0
21605,ACGTCGAATCTAGGGA,361,372,11,23,20819,2,0
21606,ACGTCGAAAGCAGGGA,361,361,0,24,20821,0,0
21607,ACGTCGAATCTAGGGA,361,379,18,26,20822,4,0
21608,ACGTCGAATCTAGGGA,361,366,5,27,20825,0,0
21609,ACGTCGAATCTTGGGA,361,366,5,27,20979,0,0
21610,ACATCGAATCTAGGGA,361,366,5,29,20980,0,0
21611,ACGTCGAATCTAGGGA,361,364,3,31,20984,0,0
21612,ACGTCGAATCTAGGGA,361,418,57,30,20986,17,0
21613,ACGTCGAATCTAGGGA,361,371,10,27,20987,1,0
21614,ACGTGGAATCTAGGGA,361,361,0,30,20990,0,0
21615,ACGTCGAATCTAGGGA,361,377,16,28,20991,3,0
21616,ACGTCGAATCTAGGGA,361,368,7,29,20993,0,0
21617,TCGTCGAATCTAGGGA,361,363,2,27,20994,0,0
21618,ACGTCGATTCTGGGGA,361,363,2,24,21000,0,0
21619,ACATCGAATCTAGGGA,361,362,1,29,21001,0,0
21620,ACGTCGAATCTAGGGA,361,408,47,23,21005,14,0
21621,ACATCGAATCTAGGGA,361,375,14,29,21162,2,0
21622,ACGTCGAATCTAGGGA,361,364,3,27,21166,0,0
21623,ACGTCGAATCTAGGGA,361,374,13,26,21170,2,0
21624,TCGTCGAATCTAGGGA,361,363,2,27,21172,0,0
21625,ACGTCGATTGTGGGGA,361,384,23,24,21173,5,0
21626,ACGTCGAATCTAGGGT,361,365,4,23,21174,0,0
21627,ACGTCGAAAGCAGGGA,361,383,22,24,21176,5,0
21628,ACGTCGAATCTAGGGA,361,363,2,26,21177,0,0
21629,ACGTCGAATCTAGGGA,361,367,6,27,21179,0,0
21630,ACGTCGAATCTAGGGA,361,378,17,23,21183,3,0
21631,ACGTCGAAAGCAGGGA,361,363,2,24,21184,0,0
21632,ACGTCGAATCTAGGGA,361,365,4,30,21185,0,0
21633,ACGTCGATTCTGGGGA,362,365,3,22,18388,0,0
21634,ACGTCGAATCTAGGGA,362,365,3,20,18932,0,0
21635,ACGTCGAATCTAGGAA,362,365,3,27,19822,0,0
21636,ACGTCGAATCTAGGGA,362,362,0,29,19849,0,0
21637,ACGTCGAATCTAGGGA,362,365,3,24,19857,0,0
21638,ACGTCGAATCTAGGGA,362,365,3,25,20004,0,0
21639,ACGTCGAATCTAGGGT,362,365,3,22,20160,0,0
21640,ACGTCGAAAGTAGGGA,362,365,3,24,20184,0,0
21641,ACGTCGAATCTAGGGA,362,362,0,27,20186,0,0
21642,ACGTCGAATCTAGGGA,362,365,3,25,20188,0,0
21643,ACGTCGAATCTAGGGA,362,365,3,24,20344,0,0
21644,ACGTCGAATGTAGGGA,362,365,3,27,20510,0,0
21645,ACGTCGAATCTAGGGA,362,362,0,25,20514,0,0
21646,ACGTCGAATCTAGGGA,362,365,3,25,20515,0,0
21647,ACGTCGAATCTAGGGA,362,365,3,22,20516,0,0
21648,ACGTCGAATGTAGGGA,362,363,1,25,20518,0,0
21649,ACGTCGAATCTAGGGA,362,365,3,26,20523,0,0
21650,ACGTCGAATCTAGGGA,362,365,3,32,20525,0,0
21651,ACGTCGACTCTAGGGA,362,364,2,25,20557,0,0
21652,ACGTCGAATCTAGGGA,362,365,3,31,20559,0,0
21653,ACGTCGAATCTAGGGA,362,365,3,28,20685,0,0
21654,ACGTCGAATCTAGGGA,362,365,3,27,20687,0,0
21655,ACGTCGAATCTAGGGA,362,363,1,32,20689,0,0
21656,ACGTCGAATGTAGGGT,362,365,3,25,20690,0,0
21657,ACGTCGAATCTAGGGA,362,365,3,26,20692,0,0
21658,ACGTCGAAGCTAGGGA,362,365,3,27,20694,0,0
21659,ACGTCGAATGTAGGGA,362,365,3,25,20698,0,0
21660,ACGTTGAATCTAGGAA,362,365,3,31,20710,0,0
21661,ACGTCGAATGTAGGGA,362,365,3,27,20856,0,0
21662,ACGTCGAATCTAGGGA,362,365,3,22,20857,0,0
21663,ACGTCGAATGTAGGGA,362,365,3,25,20866,0,0
21664,ACGTCGAATCTAGGGA,362,365,3,22,20871,0,0
21665,ACGTCGAATCTAGGGA,362,365,3,24,21023,0,0
21666,ACGTCGAATGTAGGGA,362,365,3,27,21024,0,0
21667,ACGTCGAATCTAGGGA,362,363,1,22,21025,0,0
21668,TCGTCGAATCTAGGGA,362,362,0,25,21026,0,0
21669,ACGTTGAATCTAGGGA,362,365,3,31,21028,0,0
21670,ACGTCGAATCTAGGGA,362,365,3,28,21029,0,0
21671,ACGTCGAATCTAGGGA,362,365,3,28,21034,0,0
21672,ACGTCGAATCTAGGGA,362,365,3,26,21035,0,0
21673,ACGTCGAATCTAGGGA,362,363,1,22,21038,0,0
21674,ACGCCGACTCTAGGGA,362,365,3,25,21046,0,0
21675,ACGTCGAATCTAGGGA,362,365,3,27,21134,0,0
21676,ACGTCGAATCTAGGGA,362,365,3,25,21204,0,0
21677,ACGTCGAATGTAGGGA,362,365,3,27,21205,0,0
21678,TCGTCGAATCTAGGGA,362,365,3,28,21208,0,0
21679,ACGTCGATTCTGGGGA,362,365,3,25,21209,0,0
21680,ACGTCGAATGTAGGGA,362,365,3,25,21212,0,0
21681,ACGTCGACTCTAGAGA,362,363,1,27,21216,0,0
21682,ACGTCGAATGTAGGGA,362,365,3,25,21218,0,0
21683,ACGTCGAATGTAGAGA,362,365,3,25,21219,0,0
21684,TCGTCGAATCTAGGGA,362,365,3,28,21221,0,0
21685,ACGTCGACTCTAGGGA,362,364,2,25,21222,0,0
21686,ACGTCGAATCTTGGGA,362,364,2,27,21346,0,0
21687,ACGTCGAATCTAGGGA,362,365,3,29,21348,0,0
21688,ACGTCGAATCTAGGGA,362,364,2,27,21349,0,0
21689,ACGTCGAATCGAGGGA,363,399,36,26,18666,10,0
21690,ACATCGAATCTAGGGA,363,363,0,28,19014,0,0
21691,ACGTCGAATCTAGGGA,363,375,12,26,19744,2,0
21692,TCGTCGAATCTAGGGA,363,371,8,26,19758,1,0
21693,ACGTCGAATCTAGGGA,363,364,1,27,19991,0,0
21694,ACGTCGAATCTAGGGA,363,363,0,25,19993,0,0
21695,TCGTCGAATCTAGGGA,363,365,2,26,19998,0,0
21696,ACGTCGATTCTGGGGA,363,371,8,23,20050,1,0
21697,ACGTCGAAAGCAGGGA,363,369,6,23,20067,0,0
21698,ACGTCGAATCTAGGGA,363,374,11,25,20071,2,0
21699,ACGTCGAATCTAGGGA,363,363,0,22,20398,0,0
21700,ACGTCGAAAGCAGGGA,363,399,36,23,20403,10,0
21701,ACGTCGAATCTAGGGA,363,365,2,29,20405,0,0
21702,ACGTCGAATCTAGGGA,363,364,1,25,20438,0,0
21703,ACGTCGAATCTAGGGA,363,367,4,27,20445,0,0
21704,ACGTCGATTCTGGGGA,363,363,0,23,20746,0,0
21705,ACGTCGATTCTGGGGA,363,364,1,23,20747,0,0
21706,TCGTCGAATCTAGGGA,363,375,12,25,20754,2,0
21707,ACGTCGATTCTGGGGA,363,397,34,26,20757,9,0
21708,ACGTCGAATGTAGGGA,363,371,8,26,20761,1,0
21709,ACGTCGAATCTAGGGA,363,367,4,22,20913,0,0
21710,ACGTCGAATCTAGAGA,363,364,1,21,20914,0,0
21711,ACGTCGAATCTAGGGA,363,372,9,30,20917,1,0
21712,ACGTCGAATCTAGGGA,363,364,1,28,20920,0,0
21713,ACGTCGAATCTAGGGA,363,415,52,30,20922,15,0
21714,ACGTCGACTCTAGGGA,363,416,53,27,20927,16,0
21715,ACGTCGAATCTAGGGA,363,370,7,26,20948,0,0
21716,ACGTCGAATGTAGGGA,363,381,18,26,20951,4,0
21717,ACGTCGAATCTAGGGA,363,368,5,21,21092,0,0
21718,ACGTCGAATGTAGGGA,363,389,26,25,21094,7,0
21719,TCGTCGAATCTAGGGA,363,365,2,25,21095,0,0
21720,ACGTCGAATCTAGGGA,363,372,9,26,21102,1,0
21721,ACGTCGAATCTAGGGA,363,366,3,26,21105,0,0
21722,ACGTCGAATCTAGGGT,363,388,25,23,21107,6,0
21723,ACGTCGAATCTAGGGA,363,389,26,26,21108,7,0
21724,ACGTCGAATCTAGGGA,363,386,23,26,21112,6,0
21725,ACGTCGAATCTAGGGT,363,363,0,23,21116,0,0
21726,ACGTCGAATCTAGGGA,363,376,13,29,21118,2,0
21727,ACGTCGAATGTAGGGA,363,367,4,28,21119,0,0
21728,ACGTCGAATCTAGGGA,363,368,5,23,21122,0,0
21729,ACGTCGAATGTAGGGA,363,372,9,26,21123,1,0
21730,ACGTCGATTCTGGGGA,363,385,22,26,21125,5,0
21731,ACGTCGAATCTAGGGA,363,372,9,29,21128,1,0
21732,ACGTCGATTCTGGGGA,363,376,13,25,21130,2,0
21733,ACGTCGAATCTTGGGA,363,364,1,21,21133,0,0
21734,ACGTCGAATCTAGGGA,363,376,13,21,21280,2,0
21735,TCGTCGAATCTAGGGA,363,363,0,25,21281,0,0
21736,ACGTCGAATCTAGGGA,363,367,4,30,21283,0,0
21737,ACGTCGAATCTAGGGA,363,368,5,25,21284,0,0
21738,ACGTCGAATCTAGGGA,363,371,8,26,21287,1,0
21739,ACGTCGACTCTAGGGA,363,364,1,27,21288,0,0
21740,ACGTCGAATCTAGGGA,363,381,18,26,21290,4,0
21741,ACGTCGAATCTAGGGT,363,384,21,23,21291,5,0
21742,ACGTCGAATCTAGGGA,363,365,2,26,21292,0,0
21743,ACGTCGAATCTAGGGA,363,389,26,26,21295,7,0
21744,ACGTCGAATCTAGGGA,363,363,0,29,21296,0,0
21745,ACGTCGAATCTAGGGA,363,366,3,26,21299,0,0
21746,ACGTCGAATCTAGGGA,363,371,8,26,21301,1,0
21747,ACGTCGATTCTGGGGA,363,368,5,25,21309,0,0
21748,ACGTCGAATCTAGGGA,363,376,13,27,21310,2,0
21749,ACGTCGACTCTAGGGA,363,364,1,26,21313,0,0
21750,ACGTCGAATCTAGGGA,363,409,46,32,21314,13,0
21751,ACGTCGAATCTTGGGA,363,363,0,30,21315,0,0
21752,ACGTCGAATCTAGGGA,363,386,23,23,21317,6,0
21753,ACGTTGAATCTAGGGA,363,366,3,32,21319,0,0
21754,ACGTCGAATCTAGGGA,363,367,4,29,21320,0,0
21755,ACGTCGAATCTAGGGA,363,368,5,28,21321,0,0
21756,ACGTCGAATCTAGGGA,363,367,4,28,21325,0,0
21757,TCGTCGAATCTAGGGA,363,371,8,29,21329,1,0
21758,TCGTCGAATCTAGGGA,363,375,12,29,21330,1,0
21759,ACGTCGAATGTAGGGA,363,378,15,28,21336,2,0
21760,ACGTCGAATCTAGGGA,363,363,0,23,21341,0,0
21761,ACGTCGAATCTTGGGA,363,407,44,25,21343,12,0
21762,ACGTCGAATGTAGGGA,364,375,11,26,19233,2,0
21763,ACGTCGACTCTAGAGA,364,365,1,26,19778,0,0
21764,TCGTTGAATCTAGGGA,364,368,4,27,19971,0,0
21765,ACATCGAATCTAGGGA,364,374,10,29,20118,1,0
21766,ACGGCTACTCTAGGGA,364,365,1,26,20119,0,0
21767,ACGTCGAATCTAGGGA,364,379,15,25,20124,3,0
21768,ACGTCGAATCTTGGGA,364,374,10,28,20130,1,0
21769,ACGTCGAATCTAGGGA,364,367,3,32,20198,0,0
21770,ACGTCGAATCTAGGGA,364,406,42,30,20311,12,0
21771,ACGTCGAATCTAGGGA,364,365,1,23,20446,0,0
21772,ACGTCGACTCTAGGGT,364,366,2,26,20454,0,0
21773,ACGTCGAATCTAGGGA,364,365,1,24,20633,0,0
21774,ACGTCGAGTCTAGGGA,364,384,20,30,20653,5,0
21775,ACGTTGAATCTAGGGA,364,366,2,29,20656,0,0
21776,ACGTCGATTCTGGGGA,364,377,13,25,20719,2,0
21777,ACGTCGAATCTAGGGA,364,371,7,26,20720,0,0
21778,ACGTTGAATCTAGGGA,364,367,3,30,20729,0,0
21779,ACGTCGAATCTAGGGA,364,367,3,25,20794,0,0
21780,ACGTCGAATCTAGAGA,364,366,2,21,20803,0,0
21781,ACGTCGAATCTAGGGA,364,381,17,26,20822,4,0
21782,ACGTCGAATCTAGGGA,364,389,25,27,20825,6,0
21783,ACGTCGAATCTTGGGA,364,380,16,27,20979,3,0
21784,ACATCGAATCTAGGGA,364,370,6,29,20980,0,0
21785,ACGTCGAATCTAGGGA,364,368,4,30,20986,0,0
21786,ACGTCGAATCTAGGGA,364,386,22,27,20987,5,0
21787,ACGTCGAATCTAGGGA,364,384,20,29,20993,5,0
21788,ACGTCGATTCTGGGGA,364,365,1,24,21000,0,0
21789,ACGTCGAATCTAGGGA,364,368,4,23,21005,0,0
21790,ACATCGAATCTAGGGA,364,372,8,29,21162,1,0
21791,ACGTCGAATCTAGGGA,364,370,6,26,21170,0,0
21792,TCGTCGAATCTAGGGA,364,373,9,27,21172,1,0
21793,ACGTCGATTGTGGGGA,364,378,14,24,21173,3,0
21794,ACGTCGAATCTAGGGA,364,375,11,23,21174,2,0
21795,ACGTCGAAAGCAGGGA,364,366,2,24,21176,0,0
21796,ACGTCGAATCTAGGGA,364,364,0,27,21179,0,0
21797,ACGTCGAAAGCAGGGA,364,369,5,24,21184,0,0
21798,ACGTCGAATCTAGGGA,364,367,3,30,21185,0,0
21799,ACGTCGAATCTAGGGA,364,367,3,26,21353,0,0
21800,ACGTCGAATCTAGGGA,364,367,3,29,21354,0,0
21801,ACGTCGAATCTAGGGA,364,365,1,26,21359,0,0
21802,ACGTCGAATCTAGGGA,364,367,3,23,21363,0,0
21803,ACGTTGAAAGCAGGGA,364,365,1,24,21364,0,0
21804,ACGTCGACTCTAGGGA,364,367,3,25,21367,0,0
21805,ACGTCGAATGTAGGGA,364,367,3,29,21369,0,0
21806,ACGTCGAATCTAGGGA,364,366,2,28,21370,0,0
21807,ACGTCGAATCTAGGGA,364,367,3,28,21373,0,0
21808,ACGTCGATTCTGGGGA,364,367,3,24,21374,0,0
21809,ACGTCGATTCTGGGGA,364,367,3,24,21375,0,0
21810,ACGTCGAATCTAGGGA,364,367,3,30,21376,0,0
21811,ACGTCGATTGTGGGGA,364,364,0,27,21378,0,0
21812,ACGTCGATTCTGGGGA,365,386,21,22,18388,5,0
21813,ACGTCGAATCTAGGGA,365,369,4,20,18932,0,0
21814,ACGTCGAATCTAGGGA,365,375,10,29,19849,1,0
21815,ACGTCGAATCTAGGGA,365,382,17,25,20004,4,0
21816,ACGTCGAATCTAGGGT,365,370,5,22,20160,0,0
21817,ACGTCGAAAGTAGGGA,365,379,14,24,20184,3,0
21818,ACGTCGAATCTAGGGA,365,370,5,27,20186,0,0
21819,ACGTCGAATCTAGGGA,365,392,27,25,20514,7,0
21820,ACGTCGAATCTAGGGA,365,366,1,25,20515,0,0
21821,ACGTCGAATCTAGGGA,365,368,3,22,20516,0,0
21822,ACGTCGAATCTAGGGA,365,378,13,26,20523,2,0
21823,ACGTCGACTCTAGGGA,365,370,5,25,20557,0,0
21824,ACGTCGAATCTAGGGA,365,394,29,31,20559,8,0
21825,ACATCGAATCTAGGGA,365,370,5,28,20685,0,0
21826,ACGTCGAATCTAGGGA,365,369,4,27,20687,0,0
21827,ACGTCGAATCTAGGGA,365,368,3,32,20689,0,0
21828,ACGTCGAATGTAGGGA,365,385,20,25,20690,5,0
21829,ACGTCGAATCTAGGGA,365,379,14,26,20692,3,0
21830,ACGTCGAAGCTAGGGA,365,368,3,27,20694,0,0
21831,ACGTCGAATGTAGGGA,365,368,3,25,20698,0,0
21832,ACGTCGAATGTAGGGA,365,368,3,27,20856,0,0
21833,ACGTCGAATCTAGGGA,365,368,3,22,20857,0,0
21834,ACGTCGAATCTAGGGA,365,368,3,22,20871,0,0
21835,ACGTCGAATCTAGGGA,365,365,0,24,21023,0,0
21836,ACGTCGAATGTAGGGA,365,368,3,27,21024,0,0
21837,TCGTCGAATCTAGGGA,365,365,0,25,21026,0,0
21838,ACGTCGAATCTAGGGA,365,365,0,28,21029,0,0
21839,ACGTCGAATCTAGGGA,365,368,3,26,21035,0,0
21840,ACGTCGAATCTAGGGA,365,368,3,27,21134,0,0
21841,ACGTCGAATGTAGGGA,365,368,3,27,21205,0,0
21842,ACGTCGATTCTGGGGA,365,368,3,25,21209,0,0
21843,ACGTCGAATGTAGGGA,365,368,3,25,21212,0,0
21844,ACGTCGAATGTAGGTA,365,368,3,25,21218,0,0
21845,ACGTCGAATGTAGGGA,365,368,3,25,21219,0,0
21846,TCGTCGAATCTAGGGA,365,368,3,28,21221,0,0
21847,ACGTCGAATCTAGGGA,365,368,3,27,21349,0,0
21848,ACGTTGAATCTAGGGA,365,366,1,31,21398,0,0
21849,ACGTCGAATCTAGGGA,365,368,3,28,21399,0,0
21850,ACATCGAATGTAGGGA,365,368,3,25,21400,0,0
21851,ACGTCGACTCTAGAGA,365,367,2,27,21402,0,0
21852,ACATCGAATCTAGGGA,365,368,3,30,21405,0,0
21853,ACGTCGAATCTAGGGA,365,368,3,26,21407,0,0
21854,TCGTCGAATCTAGGGA,365,368,3,27,21519,0,0
21855,ACGTCGAATCTAGGGA,365,365,0,28,21520,0,0
21856,ACGTCGAATCTAGGGA,365,366,1,29,21522,0,0
21857,ACGTCGATTCTGGGGA,365,366,1,24,21524,0,0
21858,ACATCGAATCTAGGGA,366,381,15,28,19014,3,0
21859,ACGTCGAATCTAGGGA,366,374,8,26,19744,1,0
21860,TCGTCGAATCTAGGGA,366,377,11,26,19758,2,0
21861,ACGTCGAATCTAGGGA,366,366,0,27,19991,0,0
21862,ACGTCGATTCTGGGGA,366,386,20,23,20050,5,0
21863,ACGTCGAAAGCAGGGA,366,372,6,23,20067,0,0
21864,ACGTCGAATCTAGGGA,366,370,4,25,20071,0,0
21865,ACGTCGAATCTAGGGA,366,366,0,22,20398,0,0
21866,ACGTCGAAAGCAGGGA,366,380,14,23,20403,3,0
21867,ACGTCGAATCTAGGGA,366,366,0,29,20405,0,0
21868,ACGTCGAATCTAGGGA,366,367,1,25,20438,0,0
21869,ACGTCGAATCTAGGGA,366,406,40,27,20445,11,0
21870,ACGTCGATTCTGGGGA,366,369,3,23,20747,0,0
21871,ACGTCGATTCTGGGGA,366,375,9,26,20757,1,0
21872,ACGTCGAATGTAGGGA,366,396,30,26,20761,8,0
21873,ACGTCGAATCTAGGGA,366,367,1,22,20913,0,0
21874,ACGTCGAATCTAGGGA,366,376,10,21,20914,1,0
21875,ACGTCGAATCTAGGGA,366,369,3,30,20917,0,0
21876,ACGTCGAATCTAGGGA,366,373,7,28,20920,0,0
21877,ACGTCGAATCTAGGGA,366,368,2,30,20922,0,0
21878,ACGTCGACTCTAGGGA,366,378,12,27,20927,2,0
21879,TCGTCGAATCTAGGGA,366,377,11,25,21095,2,0
21880,ACGTCGAATCTAGGGA,366,369,3,26,21102,0,0
21881,ACGTCGAATCTAGGGA,366,384,18,26,21105,4,0
21882,ACGTCGAATCTAGGGT,366,383,17,23,21107,4,0
21883,ACGTCGAATCTAGGGA,366,371,5,26,21112,0,0
21884,ACGTCGAATCTAGGGT,366,369,3,23,21116,0,0
21885,ACGTCGAATCTAGGGA,366,376,10,23,21122,1,0
21886,ACGTCGAATGTAGGGA,366,372,6,26,21123,0,0
21887,ACGTCGATTCTGGGGA,366,373,7,26,21125,0,0
21888,ACGTCGATTCTGGGGA,366,377,11,25,21130,2,0
21889,ACGTCGAATCTTGGGA,366,367,1,21,21133,0,0
21890,TCGTCGAATCTAGGGA,366,389,23,25,21281,6,0
21891,ACGTCGAATCTAGGGA,366,366,0,30,21283,0,0
21892,ACGTCGAATCTAGGGA,366,369,3,26,21287,0,0
21893,ACGTCGACTCTAGGGA,366,368,2,27,21288,0,0
21894,ACGTCGAATCTAGGGA,366,375,9,26,21290,1,0
21895,ACGTCGAATCTAGGGT,366,367,1,23,21291,0,0
21896,ACGTCGAATCTAGGGA,366,367,1,26,21292,0,0
21897,ACGTCGAATCTAGGGA,366,376,10,29,21296,1,0
21898,ACGTCGAATCTAGGGA,366,392,26,26,21299,7,0
21899,ACGTCGATTCTGGGGA,366,384,18,25,21309,4,0
21900,ACGTCGAATCTAGGGA,366,371,5,27,21310,0,0
21901,ACGTCGACTCTAGGGA,366,370,4,26,21313,0,0
21902,ACGTCGAATCTAGGGA,366,371,5,32,21314,0,0
21903,ACGTCGAATCTTGGGA,366,379,13,30,21315,2,0
21904,ACGTCGAATCTAGGGA,366,375,9,28,21321,0,0
21905,ACGTCGAATCTAGGGA,366,370,4,28,21325,0,0
21906,TCGTCGAATCTAGGGA,366,366,0,29,21330,0,0
21907,ACGTCGAATCTTGGGA,366,381,15,25,21343,2,0
21908,ACGTCGAATGTAGCGA,366,367,1,27,21379,0,0
21909,ACGTCGAATCTAGGGA,366,370,4,23,21381,0,0
21910,ACGTCGAATCTTGGGA,366,369,3,29,21408,0,0
21911,ACGTCGAATCTAGGGA,366,367,1,28,21459,0,0
21912,ACGTCGAATCTAGGGA,366,369,3,22,21462,0,0
21913,ACGTCGAATCTAGGGA,366,369,3,23,21464,0,0
21914,ACGTCGAATCTAGGGT,366,367,1,23,21465,0,0
21915,ACGTCGAATCTAGGGA,366,369,3,26,21468,0,0
21916,ACGTCGAATCTAGGGA,366,369,3,29,21469,0,0
21917,ACGTCGAATCTAGGGA,366,369,3,25,21470,0,0
21918,ACGTCGAATCTAGGGA,366,369,3,26,21471,0,0
21919,ACGTCGAATCTAGGGA,366,368,2,27,21477,0,0
21920,ACGTCGAATCTAGGGA,366,369,3,27,21480,0,0
21921,ACGTCGAATCTAGGGA,366,369,3,32,21482,0,0
21922,ACGTCGAATCTAGGGA,366,369,3,28,21483,0,0
21923,ACGTCGAATCTAGGGT,366,369,3,28,21486,0,0
21924,ACGTCGAAGCTAGGGA,366,366,0,28,21490,0,0
21925,ACGTCGAATGTAGGGA,366,369,3,26,21491,0,0
21926,ACGTCGAATCTAGGGA,366,369,3,22,21494,0,0
21927,GCGTCGAATCTAGGGA,366,369,3,27,21496,0,0
21928,ACGTCGAATGTAGGGA,366,369,3,28,21497,0,0
21929,ACGTCGAATATAGGGA,366,369,3,23,21498,0,0
21930,ACGTCGAATCTAGGGA,366,367,1,23,21501,0,0
21931,ACGTCGAATCTTGGGA,366,369,3,25,21503,0,0
21932,ACGTCGAATCTAGGGA,366,369,3,25,21505,0,0
21933,ACGTTGAATGTAGGGA,366,369,3,28,21506,0,0
21934,TCGTCGAATCTAGGGA,366,369,3,26,21508,0,0
21935,ACGTCGAATCTAGGGA,366,369,3,29,21510,0,0
21936,ACGTCGAATCTAGGGA,366,369,3,23,21513,0,0
21937,ACGCCGACTCTAGGGA,366,369,3,26,21514,0,0
21938,ACGTCGAATGTAGGGA,367,384,17,26,19233,4,0
21939,ACGTCGACTCTAGAGA,367,382,15,26,19778,3,0
21940,ACGGCTACTCTAGGGA,367,372,5,26,20119,0,0
21941,ACGTCGAATCTAGGGA,367,384,17,25,20124,4,0
21942,ACGTCGAATCTTGGGA,367,375,8,28,20130,1,0
21943,ACGTCGAATCTAGGGA,367,372,5,30,20311,0,0
21944,ACGTCGAATCTAGGGA,367,379,12,23,20446,2,0
21945,ACGTCGAATCTAGGGA,367,368,1,24,20633,0,0
21946,ACGTCGAGTCTAGGGA,367,372,5,30,20653,0,0
21947,ACGTTGAATCTAGGGA,367,368,1,29,20656,0,0
21948,ACGTCGATTCTGGGGA,367,368,1,25,20719,0,0
21949,ACGTTGAATCTAGGGA,367,376,9,30,20729,1,0
21950,ACGTCGAATCTAGGGA,367,369,2,25,20794,0,0
21951,ACGTCGAATCTAGGGA,367,378,11,21,20803,2,0
21952,ACGTCGAATCTAGGGA,367,370,3,26,20822,0,0
21953,ACGTCGAATCTAGGGA,367,379,12,27,20825,2,0
21954,ACGTCGAATCTAGGGA,367,373,6,30,20986,0,0
21955,ACGTCGAATCTAGGGA,367,381,14,27,20987,3,0
21956,ACGTCGAATCTAGGGA,367,369,2,29,20993,0,0
21957,ACGTCGAATCTAGGGA,367,378,11,23,21005,2,0
21958,ACGTCGAATCTAGGGA,367,384,17,26,21170,4,0
21959,TCGTCGAATCTAGGGA,367,371,4,27,21172,0,0
21960,ACGTCGATTGTGGGGA,367,377,10,24,21173,1,0
21961,ACGTCGAATCTAGGGA,367,379,12,23,21174,2,0
21962,ACGTCGAAAGCAGGGA,367,376,9,24,21176,1,0
21963,ACGTCGAAAGCAGGGA,367,377,10,24,21184,1,0
21964,ACGTCGAATCTAGGGA,367,372,5,26,21353,0,0
21965,ACGTCGAATCTAGGGA,367,370,3,26,21359,0,0
21966,ACGTCGAATCTAGGGA,367,372,5,23,21363,0,0
21967,ACGTCGAAAGCAGGGA,367,382,15,24,21364,3,0
21968,ACGTCGACTCTAGGGA,367,368,1,25,21367,0,0
21969,ACGTCGAATGTAGGGA,367,368,1,29,21369,0,0
21970,ACGTCGATTCTGGGGA,367,369,2,24,21375,0,0
21971,ACGTCGAATCTAGGGA,367,374,7,30,21376,0,0
21972,ACGTCGATTGTGGGGA,367,403,36,27,21378,10,0
21973,ACGTCGAATCTAGGGA,367,370,3,26,21527,0,0
21974,ACGTCGAATCTAGGGA,367,368,1,22,21528,0,0
21975,ACGTCGAATCTAGGGA,367,390,23,23,21529,6,0
21976,ACGTCGAAAGCAGGGA,367,377,10,24,21530,1,0
21977,ACGTCGAATCTAGGGA,367,370,3,26,21534,0,0
21978,ACGTCGAATCTAGGGA,367,370,3,23,21535,0,0
21979,ACGTCTATTCTGGGGA,367,370,3,24,21537,0,0
21980,TCGTCGAATCTAGGGA,367,367,0,26,21539,0,0
21981,ACGTCGATTCTGGGGA,368,372,4,22,18388,0,0
21982,ACGTCGAATCTAGGGA,368,377,9,29,19849,1,0
21983,ACGTCGAATCTAGGGA,368,388,20,25,20004,5,0
21984,ACGTCGAATCTAGGGT,368,368,0,22,20160,0,0
21985,ACGTCGAAAGTAGGGA,368,369,1,24,20184,0,0
21986,ACGTCGAATCTAGGGA,368,369,1,27,20186,0,0
21987,ACGTCGAATCTAGGGA,368,386,18,25,20514,4,0
21988,ACGTCGAATCTAGGGA,368,376,8,25,20515,0,0
21989,ACGTCGAATCTAGGGA,368,371,3,22,20516,0,0
21990,ACGTCGAATCTAGGGA,368,369,1,26,20523,0,0
21991,ACGTCGACTCTAGGGA,368,370,2,25,20557,0,0
21992,ACGTCGAATCTAGGGA,368,368,0,31,20559,0,0
21993,ACGTCGAATCTAGGGA,368,371,3,28,20685,0,0
21994,ACGTCGAATCTAGGGA,368,371,3,27,20687,0,0
21995,ACGTCGAAGCTAGGGA,368,369,1,27,20694,0,0
21996,ACGTCGAATGTAGGGA,368,371,3,25,20698,0,0
21997,ACGTCGAATGTAGGGA,368,371,3,27,20856,0,0
21998,ACGTCGAATCTAGGGA,368,370,2,22,20857,0,0
21999,ACGTCGAATCTAGGGA,368,371,3,22,20871,0,0
22000,ACGTCGAATCTAGGGA,368,371,3,24,21023,0,0
22001,ACGTCGAATGTAGGGA,368,368,0,27,21024,0,0
22002,TCGTCGAATCTAGGGA,368,368,0,25,21026,0,0
22003,ACGTCGAATCTAGGGA,368,371,3,28,21029,0,0
22004,ACGTCGAATCTAGGGA,368,371,3,26,21035,0,0
22005,ACGTCGAATCTAGGGA,368,371,3,27,21134,0,0
22006,ACGTCGAATGTAGGGA,368,370,2,27,21205,0,0
22007,ACGTCGATTCTGGGGA,368,371,3,25,21209,0,0
22008,ACGTCGAATGTAGGGA,368,371,3,25,21218,0,0
22009,TCGTCGAATCTAGGGA,368,371,3,28,21221,0,0
22010,ACGTCGAATCTAGGGA,368,371,3,27,21349,0,0
22011,ACGTTGAATCTAGGGA,368,370,2,31,21398,0,0
22012,ACATCGAATGTAGGGA,368,369,1,25,21400,0,0
22013,ACGTCGACTCTAGAGA,368,370,2,27,21402,0,0
22014,ACATCGAATCTAGGGA,368,369,1,30,21405,0,0
22015,ACGTCGAATCTAGGGA,368,371,3,26,21407,0,0
22016,ACGTCGAATCTAGGGA,368,371,3,31,21544,0,0
22017,ACGTCGAATCTAGGGA,368,371,3,25,21579,0,0
22018,ACGACGAATGTAGGGA,368,371,3,27,21580,0,0
22019,ACATCGAATCTAGGGA,368,369,1,30,21583,0,0
22020,ACGTCGAATCTAGGGA,368,371,3,26,21585,0,0
22021,ACGTCGAATCTAGGGA,368,371,3,33,21587,0,0
22022,ACGTCGAATCTAGGGA,368,371,3,31,21589,0,0
22023,ACGTCGAATCTAGGGA,368,371,3,24,21590,0,0
22024,ACGTCGAATCTAGGGA,368,371,3,25,21592,0,0
22025,ACGTCGAGTCTAGGGA,368,371,3,31,21594,0,0
22026,ACTTTGAATCTAGGGA,368,371,3,30,21595,0,0
22027,ACGTCGAATCTAGGGA,368,371,3,27,21598,0,0
22028,ACGTCGAATCTAGGGA,368,371,3,26,21600,0,0
22029,ACGTCGAATCTAGGGA,368,371,3,28,21602,0,0
22030,ACGTCGAATCTAGGGA,368,371,3,30,21603,0,0
22031,ACGTCGATTCTGGGGA,368,371,3,25,21604,0,0
22032,ACGTCGAATCTAGGGA,368,371,3,24,21605,0,0
22033,ACGTCGAATCTAGGGA,368,368,0,27,21607,0,0
22034,ACGTCGAATCTAGGGA,368,371,3,31,21612,0,0
22035,ACGTCGAATCTAGGGA,368,370,2,28,21613,0,0
22036,ACGTCGAATCTAGGGA,368,369,1,29,21615,0,0
22037,ACGTCGAATCTAGGGA,368,369,1,24,21620,0,0
22038,ACATCGAATCTAGGGA,369,376,7,28,19014,0,0
22039,ACGTCGAATCTAGGGA,369,402,33,26,19744,9,0
22040,ACGTCGAATCTAGGGA,369,376,7,27,19991,0,0
22041,ACGTCGATTCTGGGGA,369,369,0,23,20050,0,0
22042,ACGTCGAAAGCAGGGA,369,377,8,23,20067,1,0
22043,ACGTCGAATCTAGGGA,369,392,23,25,20071,6,0
22044,ACGTCGAAAGCAGGGA,369,382,13,23,20403,2,0
22045,ACGTCGAATCTAGGGA,369,391,22,29,20405,5,0
22046,ACGTCGAATCTAGGGA,369,380,11,25,20438,2,0
22047,ACGTCGAATCTAGGGA,369,394,25,27,20445,6,0
22048,ACGTCGATTCTGGGGA,369,377,8,23,20747,1,0
22049,ACGTCGATTCTGGGGA,369,372,3,26,20757,0,0
22050,ACGTCGAATCTAGGGA,369,369,0,22,20913,0,0
22051,ACGTCGAATCTAGGGA,369,379,10,21,20914,1,0
22052,ACGTCGAATCTAGGGA,369,375,6,28,20920,0,0
22053,ACGTCGACTCTAGGGA,369,369,0,27,20927,0,0
22054,TCGTCGAATCTAGGGA,369,384,15,25,21095,3,0
22055,ACGTCGAATCTAGGGA,369,376,7,26,21102,0,0
22056,ACGTCGAATCTAGGGA,369,385,16,26,21105,3,0
22057,ACGTCGAATCTAGGGT,369,374,5,23,21107,0,0
22058,ACGTCGAATCTAGGGA,369,385,16,26,21112,3,0
22059,ACGTCTAATCTAGGGT,369,389,20,23,21116,5,0
22060,ACGTCGAATCTAGGGA,369,376,7,23,21122,0,0
22061,ACGTCGAATGTAGGGA,369,369,0,26,21123,0,0
22062,ACGTCGAATCTTGGGA,369,393,24,21,21133,6,0
22063,TCGTCGAATCTAGGGA,369,373,4,25,21281,0,0
22064,ACGTCGAATCTAGGGA,369,369,0,30,21283,0,0
22065,ACGTCGAATCTAGGGA,369,377,8,26,21287,1,0
22066,ACGTCGAATCTAGGGA,369,383,14,26,21290,3,0
22067,ACGTCGAATCTAGGGT,369,379,10,23,21291,1,0
22068,ACGTCGAATCTAGGGA,369,374,5,26,21292,0,0
22069,ACGTCGAATCTAGGGA,369,369,0,29,21296,0,0
22070,ACGTCGAATCTAGGGA,369,373,4,26,21299,0,0
22071,ACGTCGATTCTGGGGA,369,381,12,25,21309,2,0
22072,ACGTCGAATCTAGGGA,369,380,11,27,21310,2,0
22073,ACGTCGACTCTAGGGA,369,382,13,26,21313,2,0
22074,ACGTCGAATCTAGGGA,369,374,5,32,21314,0,0
22075,ACGTCGAATCTTGGGA,369,374,5,25,21343,0,0
22076,ACGTCGAATCTAGCGA,369,374,5,27,21379,0,0
22077,ACGTCGAATCTAGGGA,369,369,0,23,21381,0,0
22078,ACGTCGAATCTTGGGA,369,369,0,29,21408,0,0
22079,ACGTCGAATCTAGGGA,369,376,7,22,21462,0,0
22080,ACGTCGAATCTAGGGA,369,375,6,23,21464,0,0
22081,ACGTCGAATCTAGGGT,369,370,1,23,21465,0,0
22082,ACGTCGAATCTAGGGA,369,370,1,29,21469,0,0
22083,ACGTCGAATCTAGGGA,369,375,6,25,21470,0,0
22084,ACGTCGAATCTAGGGA,369,372,3,26,21471,0,0
22085,ACGTAGAATCTAGGGA,369,381,12,27,21480,2,0
22086,ACGTCGAATCTAGGGA,369,421,52,32,21482,15,0
22087,ACGTCGAAGCTAGGGA,369,370,1,28,21490,0,0
22088,ACGTCGAATCTAGGGA,369,372,3,22,21494,0,0
22089,GCGTCGAATCTAGGGA,369,373,4,27,21496,0,0
22090,ACGTCGAATGTAGGGA,369,395,26,28,21497,7,0
22091,ACGTCGAATCTAGGGA,369,373,4,23,21498,0,0
22092,ACGTCGAATCTAGGGA,369,376,7,23,21501,0,0
22093,ACGTTGAATGTAGGGA,369,370,1,28,21506,0,0
22094,TCGTCGAATCTAGGGA,369,373,4,26,21508,0,0
22095,ACGTCGAATCTAGGGA,369,374,5,29,21510,0,0
22096,ACGTCGAATCTAGGGA,369,381,12,23,21513,2,0
22097,ACGTCGAATGTAGGGA,370,377,7,26,19233,1,0
22098,ACGTCGACTCTAGAGA,370,374,4,26,19778,0,0
22099,ACGTCGAATCTAGGGA,370,373,3,25,20124,0,0
22100,ACGTCGAATCTTGGGA,370,372,2,28,20130,0,0
22101,ACGTCGAATCTAGGGA,370,384,14,30,20311,3,0
22102,ACGTCGAATCTAGGGA,370,382,12,23,20446,3,0
22103,ACGTCGAGTCTAGGGA,370,370,0,30,20653,0,0
22104,ACGTTGAATCTAGGGA,370,371,1,29,20656,0,0
22105,ACGTCGATTCTGGGGA,370,383,13,25,20719,3,0
22106,ACGTTGAATCTAGGGA,370,373,3,30,20729,0,0
22107,ACGTCGAATCTAGGGA,370,371,1,25,20794,0,0
22108,ACGTCGAATCTGGGGA,370,376,6,21,20803,0,0
22109,ACGTCGATTCTAGGGA,370,371,1,26,20822,0,0
22110,ACGTCGAATCTAGGGA,370,370,0,27,20825,0,0
22111,ACGTCGAATCTAGGGA,370,370,0,30,20986,0,0
22112,ACGTCGAATCTAGGGA,370,370,0,27,20987,0,0
22113,ACGTCGAATCTAGGGA,370,371,1,29,20993,0,0
22114,ACGTCGAATCTAGGGA,370,379,9,23,21005,1,0
22115,TCGTCGAATCTAGGGA,370,408,38,27,21172,11,0
22116,ACGTCGATTGTGGGGA,370,373,3,24,21173,0,0
22117,ACGTCGAATCTAGGGA,370,374,4,23,21174,0,0
22118,ACGTCGAAAGCAGGGA,370,373,3,24,21176,0,0
22119,ACGTCGAAAGCAGGGA,370,373,3,24,21184,0,0
22120,ACGTCGAATCTAGGGA,370,372,2,26,21359,0,0
22121,ACGTCGAAAGCAGGGA,370,373,3,24,21364,0,0
22122,ACGTCGACTCTAGGGA,370,373,3,25,21367,0,0
22123,ACGTCGAATGTAGGGA,370,373,3,29,21369,0,0
22124,ACGTCGATTGTGGGGA,370,372,2,27,21378,0,0
22125,ACGTCGAATCTAGGGA,370,372,2,26,21527,0,0
22126,ACGTCGAATCTAGGGA,370,370,0,23,21529,0,0
22127,ACGTCGAATCTAGGGA,370,373,3,26,21534,0,0
22128,TCGTCGAATCTAGGGA,370,373,3,26,21539,0,0
22129,ACATCGAATCTAGGGA,370,373,3,30,21621,0,0
22130,ACGTCGAATCTAGGGA,370,372,2,27,21623,0,0
22131,ACGTCGATTGTGGGGA,370,373,3,25,21625,0,0
22132,ACGTCGAAAGCAGGGA,370,373,3,25,21627,0,0
22133,ACGTCGAATCTAGGGA,370,373,3,24,21630,0,0
22134,ACGTCGAATCGAGGGA,370,373,3,27,21689,0,0
22135,ACGTCGAATCTAGGGA,370,370,0,27,21691,0,0
22136,TCGTCGAATCTAGGGA,370,373,3,27,21692,0,0
22137,ACGTCGATTCTGGGGA,370,370,0,24,21696,0,0
22138,ACGTCGAATGTAGGGA,370,373,3,26,21698,0,0
22139,ACGTCGAAAGCAGGGA,370,373,3,24,21700,0,0
22140,TCGTCGAATCTAGGGA,370,373,3,26,21706,0,0
22141,ACGTCGATTCTGGGGA,370,373,3,27,21707,0,0
22142,ACGTCGAATGTAGGGA,370,373,3,27,21708,0,0
22143,ACGTCGAATCTAGGGA,370,373,3,31,21711,0,0
22144,ACGTCGAATCTATGGA,370,373,3,31,21713,0,0
22145,ACGTCGACTCTAGGGA,370,373,3,28,21714,0,0
22146,ACGTCGAATGTAGGGA,370,373,3,27,21716,0,0
22147,ACGTCGAATGTAGGGA,370,371,1,26,21718,0,0
22148,ACGTCGAATCTAGGGA,370,373,3,27,21720,0,0
22149,ACGTCGAATCTAGGGT,370,370,0,24,21722,0,0
22150,ACGTCGAATCTAGGGA,370,373,3,27,21723,0,0
22151,ACGTCGAATATAGGGA,370,371,1,27,21724,0,0
22152,ACGTCGAATCTAGGGA,370,373,3,30,21726,0,0
22153,ACGTCGAACGTAGGGA,370,373,3,27,21729,0,0
22154,ACGTCGATTCTGGGGA,370,373,3,27,21730,0,0
22155,ACGTCGAATCTAGGGA,370,373,3,30,21731,0,0
22156,ACGTCGATTCTGGGGA,370,373,3,26,21732,0,0
22157,ACGTCGAATCTAGGGA,370,373,3,22,21734,0,0
22158,ACGTCGAATCTAGGGA,370,373,3,27,21738,0,0
22159,ACGTCGAATCTAGGGA,370,373,3,27,21740,0,0
22160,ACGTCGAATCTAGGGT,370,372,2,24,21741,0,0
22161,ACGTCGAATCTAGGGA,370,373,3,27,21743,0,0
22162,ACGTCGAATCTAGGGA,370,373,3,27,21746,0,0
22163,ACGTCGAATCTAGGGA,370,370,0,28,21748,0,0
22164,ACGTCGAATCTAGGGT,370,373,3,33,21750,0,0
22165,ACGTCGAATCTAGGGA,370,373,3,24,21752,0,0
22166,TCGTCGAATCTAGGGA,370,373,3,30,21757,0,0
22167,ACGTCGAATCTAGGGA,371,375,4,29,19849,0,0
22168,ACGTCGAATCTAGGGA,371,384,13,25,20004,2,0
22169,ACGTCGAAAGTAGGGA,371,379,8,24,20184,1,0
22170,ACGTCGAATCTAGGGA,371,375,4,27,20186,0,0
22171,ACGTCGAATCTAGGGA,371,378,7,26,20523,0,0
22172,ACGTCGACTCTAGGGA,371,374,3,25,20557,0,0
22173,ACGTCGAATCTAGGGA,371,392,21,31,20559,5,0
22174,ACGTCGAATCTAGGGA,371,373,2,28,20685,0,0
22175,ACGTCGAATCTAGGGA,371,373,2,27,20687,0,0
22176,ACGTCGAATGTAGGGA,371,378,7,25,20698,0,0
22177,ACGTCGAATGTAGGGA,371,384,13,27,20856,2,0
22178,ACGTCGAATCTAGGGA,371,375,4,24,21023,0,0
22179,TCGTCGAATCTAGGGA,371,383,12,25,21026,2,0
22180,ACGTCGAATCTAGGGA,371,408,37,26,21035,10,0
22181,ACGTCGAATGTAGGGA,371,374,3,27,21205,0,0
22182,ACGTCGATTCTGGGGA,371,378,7,25,21209,0,0
22183,ACGTCGAATGTAGGGA,371,373,2,25,21218,0,0
22184,ACGTCGAATCTAGGGA,371,372,1,27,21349,0,0
22185,ACGTTGAATCTAGGGA,371,372,1,31,21398,0,0
22186,ACATCGAATGTAGGGA,371,373,2,25,21400,0,0
22187,ACATCGAATCTAGGGA,371,372,1,30,21405,0,0
22188,ACGTCGAATCTAGGGA,371,383,12,26,21407,2,0
22189,ACGTCGAATCTAGGGA,371,376,5,31,21544,0,0
22190,ACGTCGAATCTAGGGA,371,382,11,25,21579,2,0
22191,ACGACGAACGTAGGGA,371,373,2,27,21580,0,0
22192,ACATCGAATCTAGGGA,371,390,19,30,21583,4,0
22193,ACGTCGAATCTAGGGA,371,386,15,26,21585,3,0
22194,ACGTCGAATCTAGGGA,371,379,8,31,21589,1,0
22195,ACGTCGAGTCTAGGGA,371,379,8,31,21594,1,0
22196,ACTTTGAATCTAGGGA,371,375,4,30,21595,0,0
22197,ACGTCGAATCTAGGGA,371,381,10,27,21598,1,0
22198,ACGTCGAATCTAGGGA,371,378,7,26,21600,0,0
22199,ACGTCGAATCTAGGGA,371,372,1,28,21602,0,0
22200,ACGTCGAATCTAGGGA,371,372,1,24,21605,0,0
22201,ACGTCGAATCTAGGGA,371,390,19,27,21607,4,0
22202,ACGTCGAATCTAGGGA,371,371,0,31,21612,0,0
22203,ACGTCGAATCTAGGGA,371,371,0,29,21615,0,0
22204,ACGTCGAATCTAGGGA,371,376,5,24,21620,0,0
22205,ACGTCGAATGTAGGGA,371,377,6,27,21762,0,0
22206,ACATCGAATCTAGGGA,371,373,2,30,21765,0,0
22207,ACGTCGAATCTAGGGA,371,372,1,26,21767,0,0
22208,ACGTCGAATTTTGGGA,371,371,0,29,21768,0,0
22209,ACGTCGAATCTAGGGA,371,371,0,31,21770,0,0
22210,ACGTCGAGTCTAGGGA,371,375,4,31,21774,0,0
22211,ACGTCGATTCTGGGGA,371,383,12,26,21776,2,0
22212,ACGTCGAATCTAGGGA,371,379,8,27,21781,1,0
22213,ACGTCGAATCTAGGGA,371,378,7,28,21782,0,0
22214,ACGTCGAATCTTGGGA,371,387,16,28,21783,3,0
22215,ACGTCGAATCTAGGGA,371,388,17,28,21786,4,0
22216,ACGTCGAATCTAGGGA,371,383,12,30,21787,2,0
22217,ACATCGAATCTAGGGA,371,374,3,30,21790,0,0
22218,TCGTCGAATCTAGGGA,371,378,7,28,21792,0,0
22219,ACGTCGATTGTGGGGA,371,376,5,25,21793,0,0
22220,ACGTCGAATCTAGGGA,371,372,1,24,21794,0,0
22221,ACATCGAATCTAGGGA,372,377,5,28,19014,0,0
22222,ACGTCGAATCTAGGGA,372,374,2,26,19744,0,0
22223,ACGTCGAATCTAGGGA,372,379,7,27,19991,1,0
22224,ACGTCGATTCTGGGGA,372,375,3,23,20050,0,0
22225,ACGTCGAAAGCAGGGA,372,382,10,23,20067,2,0
22226,ACGTCGAATCTAGGGA,372,374,2,25,20071,0,0
22227,ACGTCGAAAGCAGGGA,372,392,20,23,20403,5,0
22228,ACGTCGAATCTAGGGA,372,376,4,29,20405,0,0
22229,ACGTCGAATCTAGGGA,372,374,2,27,20445,0,0
22230,ACGTCGATTCTGGGGA,372,372,0,26,20757,0,0
22231,ACGTCGAATCTAGGGA,372,375,3,22,20913,0,0
22232,ACGTCGAATCTAGGGA,372,378,6,21,20914,0,0
22233,TCGTCGAATCTAGGGA,372,390,18,25,21095,4,0
22234,ACGTCGAATCTAGGGA,372,376,4,26,21105,0,0
22235,ACGTCGAATCTAGGGA,372,386,14,26,21112,3,0
22236,ACGTCGAATCTAGGGT,372,372,0,23,21116,0,0
22237,ACGTCGAATCTAGGGA,372,381,9,23,21122,1,0
22238,ACGTCGAATCTTGGGA,372,395,23,21,21133,6,0
22239,TCGTCGAATCTAGGGA,372,395,23,25,21281,6,0
22240,ACGTCGAATCTAGGGA,372,381,9,30,21283,1,0
22241,ACGTCGAATCTAGGGA,372,379,7,26,21290,0,0
22242,ACGTCGAATCTAGGGT,372,386,14,23,21291,3,0
22243,ACGTCGAATCTAGGGA,372,380,8,29,21296,1,0
22244,ACGTCGACTCTAGGGA,372,375,3,26,21313,0,0
22245,ACGTCGAATCTAGGGA,372,378,6,32,21314,0,0
22246,ACGTCGAATCTTGGGA,372,372,0,25,21343,0,0
22247,ACGTCGAATGTAGCGA,372,385,13,27,21379,2,0
22248,ACGTCGAATCTAGGGA,372,382,10,23,21381,1,0
22249,ACGTCGAATCTAGGGA,372,379,7,23,21464,0,0
22250,ACGTCGAATCTAGGGT,372,385,13,23,21465,2,0
22251,ACGTCGAATCTAGGGA,372,394,22,29,21469,5,0
22252,ACGTCGAATCTAGGGA,372,403,31,25,21470,8,0
22253,ACGTCGAATCTAGGGA,372,375,3,27,21480,0,0
22254,ACGTCGAATCTAGGGA,372,375,3,32,21482,0,0
22255,GCGTCGAATCTAGGGA,372,375,3,27,21496,0,0
22256,ACGTTGAATGTAGGGA,372,372,0,28,21506,0,0
22257,ACGTCGAATCTAGGGA,372,375,3,29,21510,0,0
22258,ACGTCGAATCTAGGGA,372,375,3,23,21513,0,0
22259,TCGTCGAATCTAGGGA,372,375,3,30,21758,0,0
22260,ACGTCGAATGTAGGGA,372,375,3,29,21759,0,0
22261,ACGTCGAATCTTGGGA,372,375,3,26,21761,0,0
22262,ACGTCGATTCTGGGGA,372,375,3,23,21812,0,0
22263,ACGTCGAATCTAGGGA,372,375,3,30,21814,0,0
22264,ACGTCGAATCTAGGGA,372,375,3,26,21815,0,0
22265,ACGTCGAAAGTAGGGA,372,374,2,25,21817,0,0
22266,ACGTCGAATCTAGCGA,372,375,3,26,21819,0,0
22267,ACGTCGAATCTAGGGA,372,375,3,27,21822,0,0
22268,ACGTCGAATCTAGGGA,372,375,3,32,21824,0,0
22269,ACGTCGAATGTAGGGA,372,374,2,26,21828,0,0
22270,ACGTCGAATCTAGGGA,372,375,3,27,21829,0,0
22271,ACGTCGAATGTAGGGA,373,377,4,26,19233,0,0
22272,ACGTTGACTCTAGAGA,373,385,12,26,19778,2,0
22273,ACGTCGAATCTAGGGA,373,382,9,25,20124,1,0
22274,ACGTCGAATCTTGGGA,373,377,4,28,20130,0,0
22275,ACGTCGAATCTAGGGA,373,388,15,23,20446,3,0
22276,ACGTCGAGTCTAGGGA,373,373,0,30,20653,0,0
22277,ACGTTGAATCTAGGGA,373,374,1,29,20656,0,0
22278,ACGTCGATTCTGGGGA,373,373,0,25,20719,0,0
22279,ACGTTGAATCTAGGGA,373,378,5,30,20729,0,0
22280,ACGTCGAATCTAGGGA,373,375,2,21,20803,0,0
22281,ACGTCGAATCTAGGGA,373,373,0,26,20822,0,0
22282,ACGTCGAATCTAGGGA,373,376,3,27,20825,0,0
22283,ACGTCGAATCTAGGGA,373,379,6,30,20986,0,0
22284,ACGTCGAATCTAGGGA,373,389,16,27,20987,3,0
22285,ACGTCGAATCTAGGGA,373,379,6,23,21005,0,0
22286,TCGTCGAATCTAGGGA,373,401,28,27,21172,7,0
22287,ACGTCGGAAGCAGGGA,373,381,8,24,21176,1,0
22288,ACGTCGAAAGCAGGGA,373,384,11,24,21184,2,0
22289,ACGTCGAATCTAGGGA,373,400,27,26,21359,7,0
22290,ACGTCGAAAGCAGGGA,373,394,21,24,21364,5,0
22291,ACGTCGACTCTAGGGA,373,393,20,25,21367,5,0
22292,ACGTCGATTGTGGGGA,373,375,2,27,21378,0,0
22293,ACGTCGAATCTAGGGA,373,377,4,26,21534,0,0
22294,ACATCGAATCTAGGGA,373,379,6,30,21621,0,0
22295,ACGTCGAATCTAGGGA,373,373,0,27,21623,0,0
22296,ACGTCGATTGTGGGGA,373,388,15,25,21625,3,0
22297,ACGTCGAAAGCAGGGA,373,378,5,25,21627,0,0
22298,ACGTCGAATCTAGGGA,373,404,31,24,21630,8,0
22299,ACGTCGAATCGAGGGA,373,378,5,27,21689,0,0
22300,ACGTCGAATCTAGGGA,373,375,2,27,21691,0,0
22301,ACGTCGAATCTAGGGA,373,373,0,26,21698,0,0
22302,ACGTCGAAAGCAGGGA,373,380,7,24,21700,0,0
22303,TCGTCGAATCTAGGGA,373,376,3,26,21706,0,0
22304,ACGTCGATTCTGGGGA,373,374,1,27,21707,0,0
22305,ACGTCGAATCTAGGGA,373,384,11,31,21713,2,0
22306,ACGTCGACTCTAGGGA,373,374,1,28,21714,0,0
22307,ACGTCGAATGTAGGGA,373,383,10,27,21716,1,0
22308,ACGTCGAATGTAGGGA,373,386,13,26,21718,2,0
22309,ACGTCGAATCTAGGGT,373,374,1,24,21722,0,0
22310,ACGTCGAATCTAGGGA,373,380,7,27,21723,0,0
22311,ACGTCGAATCTAGGGA,373,377,4,27,21724,0,0
22312,ACGTCGAATCTAGGGA,373,378,5,30,21726,0,0
22313,ACGTCGATTCTGGGGA,373,374,1,27,21730,0,0
22314,ACGTCGATTCTGGGGA,373,375,2,26,21732,0,0
22315,ACGTCGAATATAGGGA,373,374,1,22,21734,0,0
22316,CCGTCGAATCTAGGGA,373,376,3,27,21740,0,0
22317,ACGTCGAATCTAGGGT,373,376,3,24,21741,0,0
22318,ACGTCGAATCTAGGGA,373,376,3,27,21743,0,0
22319,ACGTCGAATCTAGGGA,373,376,3,28,21748,0,0
22320,ACGTCGAATCTAGGGA,373,376,3,33,21750,0,0
22321,ACGTCGAATCTAGGGA,373,376,3,24,21752,0,0
22322,ACATCGAATCTAGGGA,373,376,3,29,21858,0,0
22323,ACGTCGAATCTAGGGA,373,376,3,27,21859,0,0
22324,TCGTCGAATCTAGGGA,373,376,3,27,21860,0,0
22325,ACGTCGATTCTGGGGA,373,376,3,24,21862,0,0
22326,ACGTCGAAAGCAGGGA,373,376,3,24,21866,0,0
22327,ACGTCGAATCTAGGGA,373,376,3,28,21869,0,0
22328,ACGTCGATTCTGGGGA,373,376,3,27,21871,0,0
22329,ACGTCGAATGTAGGGA,373,373,0,27,21872,0,0
22330,ACGTCGAATCTAGGGA,373,375,2,22,21874,0,0
22331,ACGTCGACTCTAGGGA,373,373,0,28,21878,0,0
22332,TCGTCGAATCTAGGGA,373,373,0,26,21879,0,0
22333,ACGTCGAATCTAGGGA,373,376,3,27,21881,0,0
22334,ACGTCGAATCTAGGGT,373,375,2,24,21882,0,0
22335,ACGTCGTATCTAGGGA,373,374,1,24,21885,0,0
22336,ACGTCGATTCTGGGGA,373,375,2,26,21888,0,0
22337,TCGTCGAATCTAGGGA,373,376,3,26,21890,0,0
22338,ACGTCGAATCTAGGGA,373,376,3,27,21894,0,0
22339,ACGTCGAATCTAGGGA,373,376,3,30,21897,0,0
22340,ATGTCGAATCTAGGGA,373,376,3,27,21898,0,0
22341,ACGTCGATTCTGGGGA,373,376,3,26,21899,0,0
22342,ACGTCGAATCTTGGGA,373,376,3,31,21903,0,0
22343,ACGTCGAATCTAGGGA,374,374,0,29,19849,0,0
22344,ACGTCGAATCTAGGGA,374,380,6,25,20004,0,0
22345,ACGTCGAATCTAGGGA,374,379,5,26,20523,0,0
22346,ACGTCGACTCTAGGGA,374,376,2,25,20557,0,0
22347,ACGTCGAATCTAGGGA,374,375,1,31,20559,0,0
22348,ACGTCGAATCTAGGGA,374,377,3,27,20687,0,0
22349,ACGTCGAATGTAGGGA,374,374,0,25,20698,0,0
22350,ACGTCGAATCTAGGGA,374,385,11,24,21023,2,0
22351,TCGTCGAATCTAGGGA,374,379,5,25,21026,0,0
22352,ACGTCGAATCTAGGGA,374,396,22,26,21035,5,0
22353,ACGTCGATGCTGGGGA,374,376,2,25,21209,0,0
22354,ACATCGAATGTAGGGA,374,379,5,25,21400,0,0
22355,ACGTCGAATCTAGGGA,374,377,3,31,21544,0,0
22356,ACGTCGAATCTAGGGA,374,383,9,25,21579,1,0
22357,ACGACGAATGTAGGGA,374,378,4,27,21580,0,0
22358,ACATCGAATCTAGGGA,374,377,3,30,21583,0,0
22359,ACGTCGAATCTAGGGA,374,382,8,26,21585,1,0
22360,ACGTCGAGTCTAGGGA,374,375,1,31,21594,0,0
22361,ACGTCGAATCTAGGGA,374,382,8,27,21598,1,0
22362,ACGTCGAATCTAGGGA,374,379,5,26,21600,0,0
22363,ACGTCGAATCTAGGGA,374,374,0,28,21602,0,0
22364,ACGTCGAATCTAGGGA,374,385,11,27,21607,2,0
22365,ACGTCGAATCTAGGGA,374,396,22,31,21612,5,0
22366,ACGTCGAATCTAGGGA,374,384,10,29,21615,1,0
22367,ACGTCGAATCTAGGGA,374,376,2,24,21620,0,0
22368,ACGTCGAATGTAGGGA,374,375,1,27,21762,0,0
22369,ACGTCGAATCTAGGGA,374,418,44,26,21767,13,0
22370,ACGTCGAATCTAGGGA,374,392,18,31,21770,4,0
22371,ACGTCGAGTCTAGGGA,374,384,10,31,21774,1,0
22372,ACCTCGATTCTGGGGA,374,391,17,26,21776,4,0
22373,ACGTCGAATCTAGGGA,374,376,2,27,21781,0,0
22374,ACGTCGAATCTAGGGA,374,384,10,28,21782,1,0
22375,ACGTCGAATCTTGGGA,374,390,16,28,21783,3,0
22376,ACGTCGAATCTAGGGA,374,387,13,28,21786,2,0
22377,ACGTCGAATCTAGGGA,374,381,7,30,21787,0,0
22378,ACGTCGATTGTGGGGA,374,374,0,25,21793,0,0
22379,ACGTCGAATCTAGGGA,374,375,1,24,21794,0,0
22380,ACGTCGAATGTAGGGA,374,376,2,27,21938,0,0
22381,ACGTCGACTCTAGAGA,374,381,7,27,21939,0,0
22382,ACGTCGAATCTAGGGA,374,381,7,26,21941,0,0
22383,ACGTCGAATCTTGGGA,374,381,7,29,21942,0,0
22384,ACGTCGAATCTAGGGA,374,384,10,24,21944,1,0
22385,ACGTTGAATCTAGGGA,374,393,19,31,21949,4,0
22386,ACGTCGAATCTAGGGA,374,395,21,22,21951,5,0
22387,ACGTCGAATCTAGGGA,374,381,7,28,21953,0,0
22388,ACGTCGAATCTAGGGA,374,378,4,28,21955,0,0
22389,ACGTCGAATCTAGGGA,374,380,6,24,21957,0,0
22390,ACGTCGAATCTAGGGA,374,385,11,27,21958,2,0
22391,ACGTCGATTGTGGGGA,374,394,20,25,21960,5,0
22392,ACGTCGAATCTAGGGA,374,381,7,24,21961,0,0
22393,ACGTCGAAAGCAGGGA,374,378,4,25,21962,0,0
22394,ACGTCGAAAGCAGGGA,374,391,17,25,21963,4,0
22395,ACGTCGAAAGCAGGGA,374,374,0,25,21967,0,0
22396,ACGTCGATTGTGGGGA,374,380,6,28,21972,0,0
22397,ACGTCGAATCTAGGGA,374,379,5,24,21975,0,0
22398,ACGTCGAAAGCAGGGA,374,376,2,25,21976,0,0
22399,ACGTCGAATCTAGGGA,375,382,7,26,19744,0,0
22400,ACGTCGATTCTGGGGT,375,375,0,23,20050,0,0
22401,ACGTCGAAAGCAGGGA,375,378,3,23,20403,0,0
22402,ACGTCGAATCTAGGGA,375,378,3,29,20405,0,0
22403,ACGTCGAATCTAGGGA,375,378,3,27,20445,0,0
22404,ACGTCGATTCTGGGGA,375,375,0,26,20757,0,0
22405,ACGTCGAATCTAGGGA,375,378,3,22,20913,0,0
22406,TCGTCGAATCTAGGGA,375,378,3,25,21095,0,0
22407,ACGTCGAATCTAGGGA,375,375,0,26,21105,0,0
22408,ACGTCGAATCTAGGGA,375,375,0,26,21112,0,0
22409,ACGTCGAATCTAGGGT,375,378,3,23,21116,0,0
22410,ACGTCGAATCTAGGGA,375,378,3,23,21122,0,0
22411,ACGTCGAATCTTGGGA,375,378,3,21,21133,0,0
22412,TCGTCGAATCTAGGAA,375,377,2,25,21281,0,0
22413,ACGTCGAATCTAGGGA,375,378,3,30,21283,0,0
22414,ACGTCGAATCTAGGGA,375,378,3,26,21290,0,0
22415,ACGTCGAATCTAGGGA,375,377,2,29,21296,0,0
22416,ACGTCGACTCTAGGGA,375,378,3,26,21313,0,0
22417,ACGACGAATCTTGGGA,375,378,3,25,21343,0,0
22418,ACGTCGAATCTAGGGA,375,378,3,23,21464,0,0
22419,ACGTCGAATCTAGGGT,375,378,3,23,21465,0,0
22420,ACGTCGAATCTAGGGA,375,378,3,29,21469,0,0
22421,ACGTCGAATCTAGGGA,375,378,3,27,21480,0,0
22422,ACGTCGAATCTAGGGA,375,378,3,32,21482,0,0
22423,ACGTCGAATCTAGGGT,375,378,3,29,21510,0,0
22424,ACGTCGAATGTAGGGA,375,378,3,29,21759,0,0
22425,ACGTCGAATCTTGGGA,375,375,0,26,21761,0,0
22426,ACGTCGATTCTGGGGA,375,376,1,23,21812,0,0
22427,ACGTCGAATCTAGGGA,375,378,3,26,21815,0,0
22428,ATGTCGAAAGTAGGGA,375,378,3,25,21817,0,0
22429,ACGTCGAATCTAGGGA,375,375,0,26,21819,0,0
22430,ACGTCGAATCTAGGGA,375,378,3,27,21822,0,0
22431,ACGTCGAATCTAGGGA,375,378,3,32,21824,0,0
22432,AAGTCGAATGTAGGGA,375,378,3,26,21828,0,0
22433,ACGTCGAATCTAGGGT,375,377,2,27,21829,0,0
22434,ACGTCGAATCTTGGGA,375,378,3,26,21907,0,0
22435,ACGTCGAATCTAGGGA,375,377,2,30,21982,0,0
22436,ACGTCGAATCTAGGGA,375,378,3,26,21983,0,0
22437,ACGTCGAATCTAGGGA,375,378,3,26,21987,0,0
22438,ACGTCGAATGTAGGGA,375,378,3,27,22097,0,0
22439,ACGTCGAATCTAGGGA,375,378,3,31,22101,0,0
22440,ACGTCGAATCTAGGGA,375,378,3,24,22102,0,0
22441,ACGTCGATTCTGGGGA,375,378,3,26,22105,0,0
22442,ACGTCGAATGTAGGGA,376,376,0,26,19233,0,0
22443,ACGTCGACTCTAGAGA,376,397,21,26,19778,5,0
22444,ACGTCGAATCTAGGGA,376,385,9,25,20124,1,0
22445,ACGTCGAATCTAGGGA,376,388,12,23,20446,2,0
22446,ACGTCGAGTCTTGGGA,376,376,0,30,20653,0,0
22447,ACGTTGAATCTAGGGA,376,386,10,29,20656,1,0
22448,ACGTCGATTCTGGGGA,376,378,2,25,20719,0,0
22449,ACGTCGAATCTAGGGA,376,412,36,21,20803,10,0
22450,ACGTCGAATCTAGGGA,376,390,14,27,20825,3,0
22451,ACGTCGAATCTAGGGA,376,377,1,27,20987,0,0
22452,TCGTCGAATCTAGGGA,376,400,24,27,21172,6,0
22453,ACGTCGAAAGCAGGGA,376,383,7,24,21176,0,0
22454,ACGTCGAAGGCAGGGA,376,385,9,24,21184,1,0
22455,ACGTCGAATCTAGGGA,376,401,25,26,21359,6,0
22456,ACGTCGAAAGCAGGGA,376,376,0,24,21364,0,0
22457,ACGTCGATTGTGGGGA,376,388,12,27,21378,2,0
22458,ACGTCGAATCTAGGGA,376,404,28,26,21534,7,0
22459,ACGTCGATTGTGGGGA,376,384,8,25,21625,1,0
22460,ACGTCGAAAGCAGGGA,376,382,6,25,21627,0,0
22461,ACGTCGAATCTAGGGA,376,378,2,24,21630,0,0
22462,ACGTCGAATCGAGGGA,376,381,5,27,21689,0,0
22463,ACGTCGAAAGCAGGGA,376,381,5,24,21700,0,0
22464,ACGTCGATTCTGGGGA,376,401,25,27,21707,6,0
22465,ACGTCGAATCTAGGGA,376,378,2,31,21713,0,0
22466,ACGTCGACTCTAGGGA,376,377,1,28,21714,0,0
22467,ACGTCGAATGTAGGGA,376,387,11,27,21716,2,0
22468,ACGTCGAATGTAGGGA,376,381,5,26,21718,0,0
22469,ACGTGGAATCTAGGGT,376,390,14,24,21722,3,0
22470,ACGTCGAATCTAGGGA,376,376,0,27,21723,0,0
22471,ACGTCGAATCTAGGGA,376,382,6,27,21724,0,0
22472,ACGTCGATTCTGGGGA,376,394,18,27,21730,4,0
22473,ACGTCGAATCTAGGGA,376,379,3,27,21740,0,0
22474,ACGTCGAATCTAGGGT,376,377,1,24,21741,0,0
22475,ACGTCGAATCTAGGGA,376,376,0,27,21743,0,0
22476,ACGTCGAATCTAGGGA,376,376,0,33,21750,0,0
22477,AGGTCGAATCTAGGGA,376,378,2,24,21752,0,0
22478,ACATCGAATCTAGGGA,376,387,11,29,21858,2,0
22479,TCGTCGAATCTAGGGA,376,386,10,27,21860,1,0
22480,ACGTCGATTCTGGGGA,376,377,1,24,21862,0,0
22481,ACGTCGAAAGCAGGGA,376,384,8,24,21866,1,0
22482,ACGTCGAATCTAGGGA,376,377,1,28,21869,0,0
22483,ACGTCGAATGTAGGGA,376,379,3,27,21872,0,0
22484,ACGTCGACTCTAGGGA,376,380,4,28,21878,0,0
22485,TCGTCGAATCTAGGGA,376,378,2,26,21879,0,0
22486,ACGTCGAATCTAGGGA,376,377,1,27,21881,0,0
22487,ACGTCGAATCTAGGGT,376,383,7,24,21882,0,0
22488,ACGTCGATTCTGGGGA,376,381,5,26,21888,0,0
22489,TCGTCGAATCTAGGGA,376,379,3,26,21890,0,0
22490,ACGTCGAATCTAGGGA,376,382,6,27,21898,0,0
22491,ACGTCGATTCTGGGGA,376,385,9,26,21899,1,0
22492,ACGTCGAATCTTGGGA,376,376,0,31,21903,0,0
22493,ACGTCGAATCTAGGGA,376,376,0,27,22039,0,0
22494,ACGTCGAAAGCAGGGA,376,376,0,24,22042,0,0
22495,ACGTCGAATCTAGGGA,376,382,6,26,22043,0,0
22496,ACGTCGAAAGCAGGGA,376,403,27,24,22044,7,0
22497,ACGTCGAATCTAGGGA,376,377,1,30,22045,0,0
22498,ACGTCGAATCTAGGGA,376,399,23,26,22046,6,0
22499,ACGTCGAATCTAGGGA,376,385,9,28,22047,1,0
22500,ACGTCGATTCTGGGGA,376,381,5,24,22048,0,0
22501,ACGTCGAATCTAGGGA,376,380,4,22,22051,0,0
22502,TCGTCGAATCTAGGGA,376,390,14,26,22054,3,0
22503,ACGTCGAATCTAGGGA,376,380,4,27,22056,0,0
22504,ACGTCGAATCTAGGGA,376,380,4,27,22058,0,0
22505,ACGTCTAATCTAGGGT,376,384,8,24,22059,1,0
22506,ACGTCGAATCTTGGGA,376,376,0,22,22062,0,0
22507,ACGTCGAATCTAGGGA,376,377,1,27,22065,0,0
22508,ACGTCGAATCTAGGGA,376,376,0,27,22066,0,0
22509,ACGTCGAATCTAGGGT,376,378,2,24,22067,0,0
22510,ACGTCGATTCTGGGGA,376,381,5,26,22071,0,0
22511,ACGTCGAATCTAGGGA,376,413,37,28,22072,10,0
22512,ACGTCGACTCTAGGGA,376,381,5,27,22073,0,0
22513,ACGTAGAATCTAGGGA,376,396,20,28,22085,5,0
22514,ACGTCGAATCTAGGGA,376,388,12,33,22086,2,0
22515,ACGTCGAATGTAGGGA,376,387,11,29,22090,2,0
22516,ACGTCGAATCTAGGGA,376,380,4,24,22096,0,0
22517,ACGTCGAATCTAGGGA,377,391,14,29,19849,3,0
22518,ACGTCGAATCTAGGGA,377,378,1,25,20004,0,0
22519,ACGTCGACTCTAGGGA,377,378,1,25,20557,0,0
22520,ACGTCGAATGTAGGGA,377,379,2,25,20698,0,0
22521,TCGTCGAATCTAGGGA,377,401,24,25,21026,7,0
22522,ACGTCGATTCTGGGGA,377,378,1,25,21209,0,0
22523,ACGTCGAATCTAGGGA,377,380,3,25,21579,0,0
22524,ACGACGAATGTAGGGA,377,385,8,27,21580,1,0
22525,ACGTCGAATCTAGGGA,377,390,13,26,21585,3,0
22526,ACGTCGAGTCTAGGGA,377,390,13,31,21594,3,0
22527,ACGTCGAATCTAGGGA,377,385,8,27,21598,1,0
22528,ACGTCGAATCTAGGGA,377,388,11,27,21607,2,0
22529,ACGTCGAATCTAGGGA,377,380,3,31,21612,0,0
22530,ACGTCGAATCTAGGGA,377,379,2,24,21620,0,0
22531,ACGTCGAATCTAGGGA,377,399,22,26,21767,6,0
22532,ACGTCGAATCTAGGGA,377,397,20,31,21770,5,0
22533,ACGTCGAGTCTAGGGA,377,390,13,31,21774,2,0
22534,ACGTCGAATCTAGGGA,377,378,1,27,21781,0,0
22535,ACGTCGAATCTAGGGA,377,377,0,28,21782,0,0
22536,ACGTCGAATCTTGGGA,377,379,2,28,21783,0,0
22537,ACGTCGAATCTAGGGA,377,382,5,28,21786,0,0
22538,ACGTCGAATCTAGGGA,377,378,1,30,21787,0,0
22539,ACGTCGATTGTGGGGA,377,379,2,25,21793,0,0
22540,ACGTCGAATGTAGGGA,377,380,3,27,21938,0,0
22541,ACGTCGACTCTAGAGA,377,379,2,27,21939,0,0
22542,ACGTCGACTCTAGGGA,377,378,1,26,21941,0,0
22543,ACGTCGAATCTAGGGA,377,380,3,24,21944,0,0
22544,ACGTCGAATCTAGGGA,377,379,2,22,21951,0,0
22545,ACGTCGAATCTAGGGA,377,377,0,28,21953,0,0
22546,ACGTCGAATCTAGGGA,377,377,0,28,21955,0,0
22547,ACGTCGAATCTAGGGA,377,380,3,24,21957,0,0
22548,ACGTCGAATCTAGGGA,377,377,0,27,21958,0,0
22549,ACGTCGAATCTAGGGA,377,380,3,24,21961,0,0
22550,ACGTCGAAAGCAGGGA,377,380,3,25,21967,0,0
22551,ACGTCGATTGTGGGGA,377,380,3,28,21972,0,0
22552,ACGTCGAATCTAGGGA,377,380,3,24,21975,0,0
22553,ACGTCGAATCTAGGGA,377,377,0,24,22114,0,0
22554,TCGTCGAATCTAGGGA,377,380,3,28,22115,0,0
22555,ACGTCGAATCTAGGGA,377,380,3,28,22223,0,0
22556,ACGTCGAAAGCAGGGA,377,380,3,24,22225,0,0
22557,ACGTCGAAAGCAGGGA,377,380,3,24,22227,0,0
22558,ACGTCGAATCTAGGGA,378,395,17,26,19744,4,0
22559,ACGTCGAAAGCAGGGA,378,383,5,23,20403,0,0
22560,ACGTCGAATCTAGGGA,378,397,19,29,20405,4,0
22561,ACGTCGAATCTAGGGA,378,379,1,27,20445,0,0
22562,ACGTCGATTCTGGGGA,378,379,1,26,20757,0,0
22563,ACGTCGAATCTAGGGA,378,392,14,22,20913,3,0
22564,ACGTCGAATCTAGGGA,378,378,0,26,21105,0,0
22565,ACGTCGAATCTAGGGA,378,413,35,26,21112,10,0
22566,ACGTCGAATCTAGGGT,378,404,26,23,21116,7,0
22567,ACGTCGAATCTAGGGA,378,379,1,23,21122,0,0
22568,ACGTCGAATCTTGGGA,378,383,5,21,21133,0,0
22569,TCGTCGAATCTAGGGA,378,378,0,25,21281,0,0
22570,ACGTCGAATCTAGGGA,378,398,20,30,21283,5,0
22571,ACGTCGACTCTAGGGA,378,386,8,26,21313,1,0
22572,ACGTCGAATCTTGGGA,378,381,3,25,21343,0,0
22573,ACGTCGAATGTAGGGA,378,384,6,23,21464,0,0
22574,ACGTCGAATCTAGGGT,378,383,5,23,21465,0,0
22575,ACGTCGAATCTAGGGA,378,385,7,29,21469,0,0
22576,ACGTCGAATCTAGGGA,378,385,7,27,21480,0,0
22577,ACGTCGAATCTAGGGA,378,386,8,29,21510,1,0
22578,ACGTCGAATCTTGGGA,378,378,0,26,21761,0,0
22579,ACGTCGATTCTGGGGA,378,384,6,23,21812,0,0
22580,ACGTCGAATCTAGGGA,378,383,5,26,21815,0,0
22581,ACGTCGAAAGTAGGGA,378,403,25,25,21817,6,0
22582,ACGTCGAATCTAGGGA,378,378,0,26,21819,0,0
22583,ACGTCGAATCTAGGGA,378,388,10,32,21824,1,0
22584,ACGTCGAATGTAGGGA,378,379,1,26,21828,0,0
22585,ACGTCGAATCTAGGGA,378,378,0,27,21829,0,0
22586,ACGTCGAATCTTGGGA,378,379,1,26,21907,0,0
22587,ACGTCGAATCTAGGGA,378,393,15,26,21983,3,0
22588,ACGTCGAATCTAGGGA,378,383,5,26,21987,0,0
22589,ACGTCGAATCAAGGGA,378,399,21,31,22101,5,0
22590,ACGTCGAATCTAGGGA,378,381,3,24,22102,0,0
22591,ACGTCGATTCTGGGGA,378,380,2,26,22105,0,0
22592,ACGTCGAATCTAGGGA,378,380,2,26,22168,0,0
22593,ACGTCGAAGGTAGGGA,378,378,0,25,22169,0,0
22594,ACGTCGAATCTAGGGA,378,396,18,32,22173,4,0
22595,ACGTCGAATGTAGGGA,378,378,0,28,22177,0,0
22596,TCGTCGAATCTAGGGA,378,384,6,26,22179,0,0
22597,ACGTCGAATCTAGGGA,378,398,20,27,22180,5,0
22598,TCGTCGAATCTAGGGA,378,389,11,27,22188,2,0
22599,ACGTCGAATCTAGGGA,378,380,2,26,22190,0,0
22600,ACATCGAATCTAGGGA,378,392,14,31,22192,3,0
22601,ACGTCGAATCTAGGGA,378,382,4,27,22193,0,0
22602,ACGTCGAATCTAGGGA,378,409,31,32,22194,8,0
22603,ACGTCGAGTCTAGGGA,378,379,1,32,22195,0,0
22604,ACGTCGAATCTAGGGA,378,379,1,28,22197,0,0
22605,ACGTCGAATCTAGGGA,378,380,2,28,22201,0,0
22606,ACGTCGATTCTGGGGA,378,381,3,27,22211,0,0
22607,ACGTCGAATCTAGGGA,378,383,5,28,22212,0,0
22608,ACGTCGAATCTTGGGA,378,381,3,29,22214,0,0
22609,ACGTCGAATCTAGGGA,378,379,1,29,22215,0,0
22610,ACGTCGAATCTAGGGA,378,381,3,31,22216,0,0
22611,ACGTCGACTCTAGAGA,379,379,0,26,19778,0,0
22612,ACGTCGAATCTAGGGA,379,401,22,25,20124,5,0
22613,ACGTCGAATCTAGGGA,379,396,17,23,20446,4,0
22614,ACGTCGAGTCTAGGGA,379,389,10,30,20653,1,0
22615,ACGTCGATTCTGGGGA,379,390,11,25,20719,2,0
22616,ACGTCGAATCTAGGGA,379,395,16,21,20803,3,0
22617,ACGTCGAATCTAGGGA,379,400,21,27,20825,5,0
22618,ACGTCGAATCTAGGGA,379,380,1,27,20987,0,0
22619,TCGTCGAATCTAGGGA,379,402,23,27,21172,6,0
22620,ACGTCGAAAGCAGGGA,379,379,0,24,21176,0,0
22621,ACGTCGAATCTAGGGA,379,400,21,26,21359,5,0
22622,ACGTCGAAAGCAGGGA,379,388,9,24,21364,1,0
22623,ACGTCGATTGTGGGGA,379,384,5,27,21378,0,0
22624,ACGTCGATTGTGGGGA,379,388,9,25,21625,1,0
22625,ACGTCGAAAGCAGGGA,379,384,5,25,21627,0,0
22626,ACGTCGAATCGAGGGA,379,389,10,27,21689,1,0
22627,ACGTCGAAAGCAGGGA,379,381,2,24,21700,0,0
22628,ACGTCGATTCTGGGGA,379,383,4,27,21707,0,0
22629,ACGTCGAATCTAGGGA,379,384,5,31,21713,0,0
22630,ACGTCGACTCTAGGGA,379,379,0,28,21714,0,0
22631,ACGTCGAATGTAGGGA,379,389,10,27,21716,1,0
22632,ACGTCGAATGTAGGGA,379,380,1,26,21718,0,0
22633,ACGTCGAATCTAGGGT,379,408,29,24,21722,8,0
22634,ACGTCGAATCTAGGGA,379,389,10,27,21723,1,0
22635,ACGTCGAATCTAGGGA,379,423,44,27,21724,11,0
22636,ACGTCGATTCTGGGGA,379,382,3,27,21730,0,0
22637,ACGTCGAATCTAGGGA,379,382,3,27,21740,0,0
22638,ACGTCGAATCTAGGGT,379,382,3,24,21741,0,0
22639,ACGTCGAATCTAGGGA,379,381,2,27,21743,0,0
22640,ACGTCGAATCTAGGGA,379,382,3,33,21750,0,0
22641,ACGTCGAATCTAGGGA,379,380,1,24,21752,0,0
22642,ACATCGAATCTAGGGA,379,382,3,29,21858,0,0
22643,ACGTCGATTCTGGGGA,379,382,3,24,21862,0,0
22644,ACGACGAAAGCAGGGA,379,382,3,24,21866,0,0
22645,ACGTCGAATCTAGGGA,379,382,3,28,21869,0,0
22646,ACGTCGAATGTAGGGA,379,382,3,27,21872,0,0
22647,ACGTCGAATCTAGGGA,379,382,3,27,21881,0,0
22648,ACGTCGAATCTAGGGT,379,382,3,24,21882,0,0
22649,TCGTCGAATCTAGGGA,379,380,1,26,21890,0,0
22650,ACGTCGAATCTAGGGA,379,382,3,27,21898,0,0
22651,ACGTCGATTCTGGGGA,379,382,3,26,21899,0,0
22652,ACGTCGAATCTAGGGA,379,382,3,27,22039,0,0
22653,ACGTCGAATCTAGGGA,379,381,2,26,22043,0,0
22654,ACGTCGAAAGCAGGGA,379,382,3,24,22044,0,0
22655,ACGTCGAATCTAGGGA,379,382,3,30,22045,0,0
22656,ACGTCGAATCTAGGGA,379,381,2,26,22046,0,0
22657,ACGTCGAATCTAGGGA,379,380,1,28,22047,0,0
22658,TCGTCGAATCTAGGGA,379,382,3,26,22054,0,0
22659,ACGTCGAATCTAGGGA,379,382,3,27,22056,0,0
22660,ACGTCGAATCTAGGGA,379,382,3,27,22058,0,0
22661,ACGTCTAATCTAGGGT,379,381,2,24,22059,0,0
22662,ACGTCGAATCTTGGGA,379,382,3,22,22062,0,0
22663,ACGTCGAATCTAGGGA,379,382,3,27,22066,0,0
22664,ACGTCGATTCTGGGGA,379,382,3,26,22071,0,0
22665,ACGTCGAATCTAGGGA,379,382,3,28,22072,0,0
22666,ACGTCGACTCTAGGGA,379,382,3,27,22073,0,0
22667,ACGTAGAATCTAGGGA,379,380,1,28,22085,0,0
22668,ACGTCGAATCTAGGGA,379,382,3,33,22086,0,0
22669,ACGTCGAATGTAGGGA,379,382,3,29,22090,0,0
22670,ACGTCGAATCTAGGGA,379,382,3,24,22096,0,0
22671,TCGTCGAATCTAGGGA,379,380,1,26,22233,0,0
22672,ACGTCGAATCTAGGGA,379,382,3,27,22235,0,0
22673,ACGTCGAATCTAGGGA,379,382,3,24,22237,0,0
22674,CCGTCGAATCTTGGGA,379,382,3,22,22238,0,0
22675,TCGTCGAATCTAGGGA,379,382,3,26,22239,0,0
22676,ACGTCGAATCTAGGGA,379,382,3,31,22240,0,0
22677,ACGTCGAATCTAGGGT,379,382,3,24,22242,0,0
22678,ACGTCGAATCTAGGGA,379,382,3,30,22243,0,0
22679,ACGTCGAATGTAGCGA,379,382,3,28,22247,0,0
22680,ACGTCGAATCTAGGGA,379,382,3,24,22248,0,0
22681,ACGTCGAATCTAGGGT,379,379,0,24,22250,0,0
22682,ACGTCGAATCTAGGGA,379,382,3,30,22251,0,0
22683,ACGTCGAATCTAGGGA,380,388,8,29,19849,1,0
22684,ACGTCGAATCTAGGGA,380,391,11,25,20004,2,0
22685,ACGTCGACTCTAGGGA,380,398,18,25,20557,4,0
22686,ACGTCGAATGTAGGGA,380,383,3,25,20698,0,0
22687,ACGTCGATTCTGGGGA,380,381,1,25,21209,0,0
22688,ACGTCGAATCTAGGGA,380,381,1,25,21579,0,0
22689,ACTACGAATGTAGGGA,380,388,8,27,21580,1,0
22690,ACGTCGAGTCTAGGGA,380,392,12,31,21594,2,0
22691,ACGTCGAATCTAGGGA,380,380,0,27,21598,0,0
22692,ACGTCGAATCTAGGGA,380,380,0,31,21612,0,0
22693,ACGTCGAATCTAGGGA,380,380,0,24,21620,0,0
22694,ACGTCGAATCTAGGGA,380,384,4,31,21770,0,0
22695,ACGTCGAGTCTAGGGA,380,385,5,31,21774,0,0
22696,ACGTCGAATCTAGGGA,380,388,8,27,21781,1,0
22697,ACGTCGAATCTAGGGA,380,399,19,28,21782,4,0
22698,ACGTCGAATCTAGGGA,380,386,6,28,21786,0,0
22699,ACGTCGAATCTAGGGA,380,399,19,30,21787,4,0
22700,ACGTCGAATGTAGGGA,380,393,13,27,21938,2,0
22701,ACGTCGACTCTAGAGA,380,393,13,27,21939,2,0
22702,ACGTCGAATCTAGGGA,380,384,4,26,21941,0,0
22703,ACGTCGAATCTAGGGA,380,384,4,28,21955,0,0
22704,ACGTCGAATCTAGGGA,380,390,10,27,21958,1,0
22705,ACGTCGAAAGCAGGGA,380,413,33,25,21967,9,0
22706,ACGTCGATTGTGGGGA,380,385,5,28,21972,0,0
22707,ACGTCGAATCTAGGGA,380,384,4,24,21975,0,0
22708,TCGTCGAATCTAGGGA,380,381,1,28,22115,0,0
22709,ACGTCGAAAGCAGGGA,380,385,5,24,22225,0,0
22710,ACGTCGAAAGCAGGGA,380,398,18,24,22227,4,0
22711,ACGTCGAATCTAGGGA,380,382,2,26,22252,0,0
22712,ACGTTGACTCTAGAGA,380,380,0,27,22272,0,0
22713,ACGTCGAATCTAGGGA,380,403,23,26,22273,6,0
22714,ACGTCGAATCTAGGGA,380,383,3,24,22275,0,0
22715,ACGTCGAATCTAGGGA,380,382,2,28,22284,0,0
22716,TCGTCGAATCTAGGGA,380,383,3,28,22286,0,0
22717,ACGTCGGAAGCAGGGA,380,398,18,25,22287,4,0
22718,ACGTCGAAAGCAGGGA,380,385,5,25,22288,0,0
22719,ACGTCGAATCTAGGGA,380,391,11,27,22289,2,0
22720,ACGTCGAAAGCAGGGA,380,384,4,25,22290,0,0
22721,ACGTCGACTCTAGGGA,380,383,3,26,22291,0,0
22722,ACGTCGATTGTGGGGA,380,390,10,26,22296,1,0
22723,ACGTCGAATCTAGGGA,380,387,7,25,22298,0,0
22724,ACGTCGAATCTAGGGA,380,384,4,32,22305,0,0
22725,ACGTCGAATGTAGGGA,380,382,2,28,22307,0,0
22726,ACGTCGAATGTAGGGA,380,388,8,27,22308,1,0
22727,ACGTCGAATCTAGGGA,381,387,6,26,19744,1,0
22728,ACGTCGAAAGCAGGGA,381,385,4,23,20403,0,0
22729,ACGTCGAATCTAGGGA,381,388,7,29,20405,1,0
22730,ACGTCGATTCTGGGGA,381,385,4,26,20757,0,0
22731,ACGTCGAATCTAGGGA,381,398,17,22,20913,4,0
22732,ACGTCGAATCTAGGGA,381,385,4,26,21112,0,0
22733,ACGTCGAATCTTGGGA,381,394,13,21,21133,3,0
22734,TCGTCGAATCTAGGGA,381,398,17,25,21281,4,0
22735,ACGTCGAATCTAGGGA,381,381,0,23,21464,0,0
22736,ACGTCGAATCTAGGGT,381,404,23,23,21465,6,0
22737,ACGTCGAATCTAGGGA,381,398,17,29,21510,4,0
22738,ACGTCGAATCTTGGGA,381,405,24,26,21761,7,0
22739,ACGTCGATTCTGGGGA,381,385,4,23,21812,0,0
22740,ACGTCGAATCTAGGGA,381,381,0,26,21815,0,0
22741,ACGTCGAATCTAGGGA,381,387,6,26,21819,1,0
22742,ACGTCGAATCTAGGGA,381,390,9,32,21824,2,0
22743,ACGTCGAATGTAGGGA,381,392,11,26,21828,2,0
22744,ACGTCGAATCTAGGGA,381,390,9,26,21983,2,0
22745,ACGTCGAATCTAGGGA,381,382,1,26,21987,0,0
22746,AGGTCGAATCTAGGGA,381,382,1,31,22101,0,0
22747,ACGTCGAATCTAGGGA,381,414,33,24,22102,10,0
22748,ACGTCGATTCTGGGGA,381,381,0,26,22105,0,0
22749,ACGTCGAATCTAGGGA,381,426,45,26,22168,12,0
22750,ACGTCGAATCTAGGGA,381,383,2,32,22173,0,0
22751,ACGTCGAATGTAGGGA,381,389,8,28,22177,1,0
22752,TCGTCGAATCTAGGGA,381,383,2,26,22179,0,0
22753,ACGTCGAATCTAGGGA,381,387,6,27,22180,0,0
22754,ACGTCGAATCTAGGGA,381,396,15,27,22188,3,0
22755,ACGTCGAATCTAGGGA,381,429,48,26,22190,11,0
22756,ACATCGAATCTAGGGA,381,383,2,31,22192,0,0
22757,ACGTCGAATCTAGGGA,381,385,4,27,22193,0,0
22758,ACGTCGAATCTAGGGA,381,388,7,28,22201,0,0
22759,ACGTCGATTCTGGGGA,381,417,36,27,22211,10,0
22760,ACGTCGAATCTTGGGA,381,381,0,29,22214,0,0
22761,ACGTCGAATCTAGGGA,381,390,9,29,22215,1,0
22762,ACGTCGAATCTAGGGA,381,381,0,31,22216,0,0
22763,ACGTCGAATCTAGGGA,381,384,3,25,22350,0,0
22764,ACGTCGAATCTAGGGA,381,381,0,27,22352,0,0
22765,ACGTCGAATCTAGGGA,381,383,2,26,22356,0,0
22766,ACGTCGAATCTAGGGA,381,384,3,27,22359,0,0
22767,ACGTCGAATCTAGGGA,381,396,15,28,22361,3,0
22768,ACGTCGAATCTAGGGA,381,390,9,28,22364,1,0
22769,ACGTCGAATCTAGGGA,381,384,3,32,22365,0,0
22770,ACGTCGAATCTAGGGA,381,394,13,30,22366,2,0
22771,ACGTCGAATCTAGGGA,381,383,2,27,22369,0,0
22772,ACGTCGAATCTAGGGA,381,385,4,32,22370,0,0
22773,ACGTCGAGTCTAGGGA,381,393,12,32,22371,2,0
22774,ACCTCGATTCTGGGGA,381,394,13,27,22372,2,0
22775,ACGTCGAATCTAGGGA,381,385,4,29,22374,0,0
22776,ACGTCGAATCTTGGGA,381,384,3,29,22375,0,0
22777,ACGTCGAATCTAGGGA,381,384,3,29,22376,0,0
22778,ACGTCAAATCTAGGGA,381,384,3,25,22384,0,0
22779,ACGTTGAATCTAGGGA,381,384,3,32,22385,0,0
22780,ACGTCGAATCTAGGGA,381,384,3,23,22386,0,0
22781,ACGTCGAATCTAGGGA,381,384,3,28,22390,0,0
22782,ACGTCGATTGTGGGGA,381,384,3,26,22391,0,0
22783,ACGTCGAAAGCAGGGA,381,383,2,26,22394,0,0
22784,ACGTCGACTCTAGAGA,382,395,13,26,19778,2,0
22785,ACGTCGAATCTAGGGA,382,383,1,25,20124,0,0
22786,ACGTCGAATCTAGGGA,382,384,2,23,20446,0,0
22787,ACGTCGAGTCTAGGGA,382,391,9,30,20653,1,0
22788,ACGTCGATTCTGGGGA,382,385,3,25,20719,0,0
22789,ACGTCGAATCTAGGGA,382,383,1,27,20825,0,0
22790,ACGTCGAATCTAGGGA,382,386,4,27,20987,0,0
22791,ACGTCGAAAGCAGGGA,382,386,4,24,21176,0,0
22792,ACGTCGAATCTAGGGA,382,382,0,26,21359,0,0
22793,ACGTCGAAAGCAGGGA,382,388,6,24,21364,0,0
22794,ACGTCGATTGTGGGGA,382,386,4,25,21625,0,0
22795,ACGTCGAAAGCAGGGA,382,389,7,25,21627,0,0
22796,ACGTCGAATCGAGGGA,382,410,28,27,21689,7,0
22797,ACGTCGAAAGCAGGGA,382,386,4,24,21700,0,0
22798,ACGTCGATTCTGGGGA,382,391,9,27,21707,1,0
22799,ACGTCGAATCTAGGGA,382,382,0,31,21713,0,0
22800,ACGTCGACTCTAGGGA,382,389,7,28,21714,0,0
22801,ACGTCGAATGTAGGGA,382,392,10,26,21718,1,0
22802,ACGTCGAATCTAGGGT,382,387,5,24,21722,0,0
22803,ACGTCGAATCTAGGGA,382,396,14,27,21723,3,0
22804,ACGTCGAATCTAGGGA,382,415,33,27,21724,9,0
22805,ACGTCGATTCTGGGGA,382,394,12,27,21730,2,0
22806,ACGTCGAATCTAGGGT,382,384,2,24,21741,0,0
22807,ACGTCGAATCTAGGGA,382,387,5,27,21743,0,0
22808,ACGTCGAATCTAGGGA,382,388,6,33,21750,0,0
22809,ACGTCGAATCTAGGGA,382,389,7,24,21752,0,0
22810,ACGTCGATTCTGGGGA,382,393,11,24,21862,2,0
22811,ACGTCGAATCTAGGGA,382,397,15,28,21869,3,0
22812,ACGTCGAATGTAGGGA,382,391,9,27,21872,1,0
22813,ACGTCGAATCTAGGGA,382,402,20,27,21881,5,0
22814,ACGTCAAATCTAGGGT,382,382,0,24,21882,0,0
22815,TCGTCGAATCTAGGGA,382,408,26,26,21890,7,0
22816,ACGTCGAATCTAGGGA,382,402,20,27,21898,5,0
22817,ACGTCGATTCTGGGGA,382,454,72,26,21899,11,0
22818,ACGTCGAATCTAGGGA,382,386,4,27,22039,0,0
22819,ACGTCGAATCTAGGGA,382,389,7,26,22043,0,0
22820,ACGTCGAATCTAGGGA,382,396,14,30,22045,3,0
22821,ACGTCGAATCTAGGGA,382,390,8,28,22047,1,0
22822,TCGTCGAATCTAGGGA,382,382,0,26,22054,0,0
22823,ACGTCGAATCTAGGGA,382,386,4,27,22056,0,0
22824,ACGTCGAATCTAGGGA,382,387,5,27,22058,0,0
22825,ACGTCTAATCTAGGGT,382,383,1,24,22059,0,0
22826,ACGTCGAATCTTGGGA,382,385,3,22,22062,0,0
22827,ACGTCGAATCTAGGGA,382,385,3,27,22066,0,0
22828,ACGTCGAATCTAGGGA,382,385,3,33,22086,0,0
22829,ACGTCGAATGTAGGGA,382,385,3,29,22090,0,0
22830,TCGTCGAATCTAGGGA,382,385,3,26,22233,0,0
22831,ACGTCGAATCTAGGGA,382,385,3,27,22235,0,0
22832,ACGTCGAATCTTGGGA,382,385,3,22,22238,0,0
22833,TCGTCGAATCTAGGGA,382,385,3,26,22239,0,0
22834,ACGTCGAATCTAGGGT,382,385,3,24,22242,0,0
22835,ACGTCGAATGTAGCGA,382,384,2,28,22247,0,0
22836,ACGTCGAATCTAGGGT,382,383,1,24,22250,0,0
22837,ACGTCGAATCTAGGGA,382,384,2,30,22251,0,0
22838,ACGTCGAATCTAGGGA,382,385,3,30,22517,0,0
22839,TCGTCGAATCTAGGGA,382,385,3,26,22521,0,0
22840,ACGACGAATGTAGGGA,382,383,1,28,22524,0,0
22841,ACGTCGAATCTAGGGA,382,385,3,27,22525,0,0
22842,ACGTCGAGTCTAGGGA,382,385,3,32,22526,0,0
22843,ACGTCGAATCTAGGGA,382,385,3,28,22527,0,0
22844,ACGTCGAATCTAGGGA,382,385,3,28,22528,0,0
22845,ACGTCGAATCTAGGGA,382,383,1,27,22531,0,0
22846,ACGTCGAATCTAGGGA,382,384,2,32,22532,0,0
22847,ACGTCGAATTTAGGGA,383,421,38,25,20004,10,0
22848,ACGTCGACTCTAGGGA,383,408,25,25,20557,6,0
22849,ACGTCGATTCTGGGGA,383,435,52,25,21209,10,0
22850,ACGTCGAATCTAGGGA,383,388,5,25,21579,0,0
22851,ACGTCGAGTCTAGGGA,383,384,1,31,21594,0,0
22852,ACGTCGAATCTAGGGA,383,387,4,27,21598,0,0
22853,ACGTCGAATCTAGGGA,383,390,7,31,21612,0,0
22854,ACGTCGAATCTAGGGA,383,384,1,24,21620,0,0
22855,ACGTCGAATCTAGGGA,383,393,10,31,21770,1,0
22856,ACGTCGAGTCTAGGGA,383,393,10,31,21774,1,0
22857,ACGTCGAATCTAGGGA,383,396,13,28,21782,2,0
22858,ACGTCGAGTCTAGGGA,383,389,6,28,21786,0,0
22859,ACGTCGAATCTAGGGA,383,385,2,30,21787,0,0
22860,ACGTCGAATGTAGGGA,383,387,4,27,21938,0,0
22861,ACGTCGAATCTAGGGA,383,383,0,26,21941,0,0
22862,ACGTCGAATCTAGGGA,383,397,14,27,21958,3,0
22863,ACGTCGATTGTGGGGA,383,396,13,28,21972,2,0
22864,ACGTCGAATCTAGGGA,383,410,27,24,21975,7,0
22865,TCGTCGAATCTAGGGA,383,411,28,28,22115,7,0
22866,ACGTCGAAAGCAGGGA,383,388,5,24,22227,0,0
22867,ACGTCGAATCTAGGGA,383,402,19,26,22252,4,0
22868,ACGTTGACTCTAGAGA,383,387,4,27,22272,0,0
22869,ACGTCGAATCTAGGGA,383,390,7,24,22275,0,0
22870,ACGTCGAATCTAGGGA,383,405,22,28,22284,5,0
22871,TCGTCGAATCTAGGGA,383,394,11,28,22286,2,0
22872,ACGTCGAAAGCAGGGA,383,394,11,25,22288,2,0
22873,ACGTCGAATCTAGGGA,383,384,1,27,22289,0,0
22874,ACGTCGAAAGCAGGGA,383,386,3,25,22290,0,0
22875,ACGTCGACTCTAGGGA,383,385,2,26,22291,0,0
22876,ACGTCGATTGTGGGGA,383,392,9,26,22296,1,0
22877,ACGTCGAATCTAGGGA,383,383,0,25,22298,0,0
22878,ACGTCGAATCTAGGGA,383,383,0,32,22305,0,0
22879,ACGTCGAATGTAGGGA,383,383,0,27,22308,0,0
22880,ACGTCGACTCTAGAGA,383,390,7,27,22443,0,0
22881,ACGTCGAATCTAGGGA,383,396,13,26,22444,2,0
22882,ACGTCGAATCTAGGGA,383,417,34,24,22445,9,0
22883,ACGTTGAATCTAGGGA,383,386,3,30,22447,0,0
22884,ACGTCGAATCTAGGGA,383,384,1,22,22449,0,0
22885,ACGTCGAATCTAGGGA,383,386,3,28,22450,0,0
22886,TCGTCGAATCTAGGGA,383,387,4,28,22452,0,0
22887,ACGTCGAAGGCAGGGA,383,383,0,25,22454,0,0
22888,ACGTCGAATCTAGGGA,383,409,26,27,22455,7,0
22889,ACGTCGATTGTGGGGA,383,397,14,28,22457,3,0
22890,ACGTCGAATCTAGGGA,383,388,5,27,22458,0,0
22891,ACGTCGATTGTGGGGA,383,384,1,26,22459,0,0
22892,ACGTCGATTCTGGGGA,383,401,18,28,22464,4,0
22893,ACGTCGAATGTAGGGA,383,392,9,28,22467,1,0
22894,ACGTGGAATCTAGGGT,383,385,2,25,22469,0,0
22895,ACGTCGATTCTGGGGA,383,387,4,28,22472,0,0
22896,ACATCGAATCTAGGGA,383,409,26,30,22478,6,0
22897,TCGTCGAATCTAGGGA,383,386,3,28,22479,0,0
22898,ACGTCGAAAGCAGGGA,383,386,3,25,22481,0,0
22899,ACGTCGATTCTGGGGA,383,383,0,27,22491,0,0
22900,ACGTCGAAAGCAGGGA,383,386,3,25,22496,0,0
22901,ACGTCGAATCTAGGGA,383,386,3,27,22498,0,0
22902,ACGTCGAATCTAGGGA,383,386,3,29,22499,0,0
22903,TCGTCGAATCTAGGGA,383,385,2,27,22502,0,0
22904,ACGTCTAATCTAGGGT,383,386,3,25,22505,0,0
22905,ACGTCGAATCTAGGGA,383,386,3,29,22511,0,0
22906,ACGTAGAATCTAGGGA,383,386,3,29,22513,0,0
22907,ACGTCGAATCTAGGGA,383,386,3,34,22514,0,0
22908,ACGTCGAATGTAGGGA,383,386,3,30,22515,0,0
22909,ACGTCGAATCTAGGGA,384,413,29,26,19744,8,0
22910,ACGTCGAAAGCAGGGA,384,387,3,23,20403,0,0
22911,ACGTCGATTCTGGGGA,384,401,17,26,20757,4,0
22912,ACGTCGAATCTAGGGA,384,404,20,22,20913,5,0
22913,ACGTCGAATCTTGGGA,384,388,4,21,21133,0,0
22914,ACGTCGAATCTAGGGT,384,402,18,23,21465,4,0
22915,ACGTCGAATCTTGGGA,384,406,22,26,21761,5,0
22916,ACGTCGATTCTGGGGA,384,385,1,23,21812,0,0
22917,ACGTCGAATCTAGGGA,384,390,6,26,21819,0,0
22918,ACGTCGAATCTAGGGA,384,402,18,32,21824,4,0
22919,ACGTCGAATGTAGGGA,384,389,5,26,21828,0,0
22920,ACGTCGAATCTAGGGA,384,384,0,26,21983,0,0
22921,ACGTCGAATCTAGGGA,384,390,6,26,21987,0,0
22922,ACGTCGAATCTAGGGA,384,404,20,32,22173,5,0
22923,ACGTCGAATCTAGGGA,384,386,2,27,22180,0,0
22924,ACATCGAATCTAGGGA,384,401,17,31,22192,4,0
22925,ACGTCGAATCTAGGGA,384,389,5,27,22193,0,0
22926,ACGTCGAATCTAGGTA,384,385,1,28,22201,0,0
22927,ACGTCGAATCTTGGGA,384,387,3,29,22214,0,0
22928,ACGTCGAATCTAGGGA,384,394,10,29,22215,1,0
22929,ACGTCGAATCGAGGGA,384,395,11,25,22350,2,0
22930,ACGTCGAATCTAGGGA,384,387,3,27,22352,0,0
22931,ACGTCGAATCTAGGGA,384,398,14,28,22364,3,0
22932,ACGTCGAATCTAGGGA,384,398,14,32,22365,3,0
22933,ACGTCGAATCTAGGGA,384,399,15,27,22369,3,0
22934,ACGTCGAATCTAGGGA,384,387,3,32,22370,0,0
22935,ACCTCGATTCTGGGGA,384,386,2,27,22372,0,0
22936,ACGTCGAATCTTGGGA,384,387,3,29,22375,0,0
22937,ACGTCGAATCTAGGGA,384,387,3,29,22376,0,0
22938,ACGTTGAATCTAGGGA,384,387,3,32,22385,0,0
22939,ACGTCGAATCTAGGGA,384,386,2,23,22386,0,0
22940,ACGTCGAATCTAGGGA,384,387,3,28,22390,0,0
22941,ACGTCGATTGTGGGGA,384,386,2,26,22391,0,0
22942,ACGTCGAAAGCAGGGA,384,387,3,26,22394,0,0
22943,ACGTCGAGTCTAGGGA,384,387,3,32,22533,0,0
22944,ACGTCGACTCTAGAGA,385,390,5,26,19778,0,0
22945,ACGTCGATTCTGGGGA,385,388,3,25,20719,0,0
22946,ACGTCGAATCTAGGGA,385,386,1,27,20825,0,0
22947,ACGTCGAATCTAGGGA,385,408,23,27,20987,6,0
22948,ACGTCGAATCTAGGGA,385,402,17,26,21359,4,0
22949,ACGTCGAAAGCAGGGA,385,387,2,24,21364,0,0
22950,ACGTCGAGTCGAGGGA,385,388,3,27,21689,0,0
22951,ACGTCGAAAGCAGGGA,385,393,8,24,21700,1,0
22952,ACGTCGATTCTGGGGA,385,396,11,27,21707,2,0
22953,ACGTCGAATCTAGGGA,385,386,1,31,21713,0,0
22954,ACGTCGACTCTAGGGA,385,393,8,28,21714,1,0
22955,ACGTCGAATGTAGGGA,385,395,10,26,21718,1,0
22956,ACGTCGAATCTAGGGT,385,396,11,24,21722,2,0
22957,ACGTCGAATCTAGGGA,385,403,18,27,21723,4,0
22958,ACGTCGAATCTAGGGA,385,399,14,27,21724,3,0
22959,ACGTCGAATCTAGGGA,385,390,5,27,21743,0,0
22960,ACGTCGAATCTAGGGA,385,388,3,33,21750,0,0
22961,ACGTCGAATCTAGGGA,385,393,8,24,21752,1,0
22962,ACGTCGATTCTGGGGA,385,387,2,24,21862,0,0
22963,ACGTCGAATCTAGGGA,385,394,9,28,21869,1,0
22964,ACGTCGAATGTAGGGA,385,389,4,27,21872,0,0
22965,TCGTCGAATCTAGGGA,385,396,11,26,21890,1,0
22966,ACGTCGAATCTAGGGA,385,386,1,27,21898,0,0
22967,ACGTCGAATCTAGGGA,385,388,3,27,22039,0,0
22968,ACGTCGAATCTAGGGA,385,388,3,26,22043,0,0
22969,ACGTCGAATCTAGGGA,385,388,3,30,22045,0,0
22970,ACGTCGAATCTAGGGA,385,387,2,28,22047,0,0
22971,ACGTCTAATCTAGGGT,385,388,3,24,22059,0,0
22972,ACGTCGAATCTTGGGA,385,388,3,22,22062,0,0
22973,ACGTCGAATCTAGGGA,385,388,3,33,22086,0,0
22974,ACGTCGAATGTAGGGA,385,388,3,29,22090,0,0
22975,TCGTCGAATCTAGGGA,385,388,3,26,22233,0,0
22976,ACGTCGAATCTAGGGA,385,388,3,27,22235,0,0
22977,ACGTCGAATCTTGGGA,385,388,3,22,22238,0,0
22978,TCGTCGAATCTAGGGA,385,388,3,26,22239,0,0
22979,ACGTCGAATCTAGGGT,385,388,3,24,22242,0,0
22980,ACGTCGAATCTAGGGA,385,388,3,30,22251,0,0
22981,ACGTCGAATCTAGGGA,385,388,3,30,22517,0,0
22982,TCGTCGAATCTAGGGA,385,385,0,26,22521,0,0
22983,ACGTCGAATCTAGGGA,385,388,3,27,22525,0,0
22984,ACGTCGAGTCTAGGGA,385,388,3,32,22526,0,0
22985,ACGTCGAATCTAGGGA,385,388,3,28,22528,0,0
22986,ACGTCGAATCTAGGGA,385,388,3,27,22531,0,0
22987,ACGTCGAATCTAGGGA,385,388,3,32,22532,0,0
22988,ACGTCGAATCTAGGGA,385,388,3,27,22558,0,0
22989,ACGTCGAATCTAGGGA,385,385,0,30,22560,0,0
22990,ACGTCGAATCTAGGGA,385,388,3,23,22563,0,0
22991,ACGTCGAATCTAGGGA,385,388,3,27,22565,0,0
22992,ACGTCGAATCTAGGGT,385,388,3,24,22566,0,0
22993,ACGTCGAATCTAGGGA,385,386,1,31,22570,0,0
22994,ACGTCGACTCTAGGGA,385,388,3,27,22571,0,0
22995,ACGTCGAATCTAGGGA,385,385,0,30,22577,0,0
22996,ACGTCGAAAGTAGGGA,385,388,3,26,22581,0,0
22997,ACGTCGAATCTAGGGA,385,388,3,33,22583,0,0
22998,ACGTCGAATCTAGGGA,385,388,3,27,22587,0,0
22999,ACGTCGAATCAAGGGA,385,388,3,32,22589,0,0
23000,ACGTCGAATCTAGGGA,385,388,3,33,22594,0,0
23001,ACGTCGAATCTAGGGA,385,388,3,28,22597,0,0
23002,TCGTCGAATCTAGGGA,385,388,3,28,22598,0,0
23003,ACATCGAATCTAGGGA,385,388,3,32,22600,0,0
23004,ACGTCGAATCTAGGGA,385,388,3,33,22602,0,0
23005,ACGTCGAATCTAGGGA,386,397,11,25,20004,2,0
23006,ACGTCGATTCTGGGGA,386,395,9,25,21209,1,0
23007,ACGTCGAATCTAGGGA,386,390,4,25,21579,0,0
23008,ACGTCGAGTCTAGGGA,386,400,14,31,21594,3,0
23009,ACGTCGAATCTAGGGA,386,386,0,31,21612,0,0
23010,ACGTCGAATCTAGGGA,386,389,3,24,21620,0,0
23011,ACGTCGAATCTAGGGA,386,386,0,31,21770,0,0
23012,ACGTCGAATCTAGGGA,386,396,10,28,21782,1,0
23013,ACGTCGATTGTGGGGA,386,401,15,28,21972,3,0
23014,ACGTCGAATCTAGGGA,386,402,16,24,21975,3,0
23015,TCGTCGAATCTAGGGA,386,393,7,28,22115,0,0
23016,ACGTCGAAAGCAGGGA,386,393,7,24,22227,0,0
23017,ACGTCGAATCTAGGGA,386,411,25,26,22252,6,0
23018,ACGTCGAATCTAGGGA,386,417,31,24,22275,8,0
23019,ACGTCGAATCTAGGGA,386,396,10,28,22284,1,0
23020,TCGTCGAATCTAGGGA,386,387,1,28,22286,0,0
23021,ACGTCGAATCTAGGGA,386,409,23,27,22289,6,0
23022,ACGTCGAAAGCAGGGA,386,398,12,25,22290,2,0
23023,ACGTCGACTCTAGGGA,386,386,0,26,22291,0,0
23024,ACGTCGATTGTGGGGA,386,401,15,26,22296,3,0
23025,ACGTCGAATCTAGGGA,386,391,5,25,22298,0,0
23026,ACGTCGACTCTAGAGA,386,402,16,27,22443,3,0
23027,ACGTCGAATCTAGGGA,386,386,0,24,22445,0,0
23028,ACGTCGAATCTAGGGA,386,400,14,22,22449,3,0
23029,ACGTCGAATCTAGGGA,386,395,9,28,22450,1,0
23030,TCGTCGAATCTAGGGA,386,416,30,28,22452,8,0
23031,ACGTCGAATCTAGGGA,386,390,4,27,22455,0,0
23032,ACGTCGATTGTGGGGA,386,409,23,28,22457,6,0
23033,ACGTCGAATCTAGGGA,386,388,2,27,22458,0,0
23034,ACGTCGATTCTGGGGA,386,392,6,28,22464,0,0
23035,ACGTCGAATGTAGGGA,386,386,0,28,22467,0,0
23036,ACGTGGAATCTAGGGT,386,394,8,25,22469,1,0
23037,ACGTCGATTCTGGGGA,386,404,18,28,22472,4,0
23038,ACATCGAATCTAGGGA,386,407,21,30,22478,5,0
23039,ACGTCGAAAGCAGGGA,386,392,6,25,22496,0,0
23040,ACGTCGAATCTAGGGA,386,386,0,27,22498,0,0
23041,TCGTCGAATCTAGGGA,386,387,1,27,22502,0,0
23042,ACGTCGAATCTAGGGA,386,386,0,29,22511,0,0
23043,ACGTAGAATCTAGGGA,386,389,3,29,22513,0,0
23044,ACGTCGAATCTAGGGA,386,395,9,34,22514,1,0
23045,ACGTCGAATGTAGGGA,386,397,11,30,22515,2,0
23046,ACGTCGAATCTAGGGA,386,389,3,26,22612,0,0
23047,ACGTCGAATCTAGGGA,386,388,2,24,22613,0,0
23048,ACGTCGAGTCTAGGGA,386,392,6,31,22614,0,0
23049,ACGTCGATTCTGGGGA,386,403,17,26,22615,4,0
23050,ACGTCGAATCTAGGGA,386,396,10,22,22616,1,0
23051,ACGTCGAATCTAGGGA,386,392,6,28,22617,0,0
23052,TCGTCGAATCTAGGGA,386,387,1,28,22619,0,0
23053,ACGTCGAATCTAGGGA,386,396,10,27,22621,1,0
23054,ACGTCGAAAGCAGGGA,386,391,5,25,22622,0,0
23055,ACGTCGATTGTGGGGA,386,387,1,26,22624,0,0
23056,ACGTCGAATCGAGGGA,386,395,9,28,22626,1,0
23057,ACGTCGAATGTAGGGA,386,387,1,28,22631,0,0
23058,ACGTCGAATCTAGGGT,386,393,7,25,22633,0,0
23059,ACGTCGAATCTAGGGA,386,391,5,28,22634,0,0
23060,ACGTCGAATCTAGGGA,386,407,21,27,22727,5,0
23061,ACGTCGAATCTAGGGA,386,394,8,30,22729,0,0
23062,ACGTCGAATCTAGGGA,386,393,7,23,22731,0,0
23063,ACGTCGAATCTTGGGA,386,399,13,22,22733,2,0
23064,TCGTCGAATCTAGGGA,386,389,3,26,22734,0,0
23065,ACGTCGAATCTAGGGT,386,419,33,24,22736,8,0
23066,ACGTCGAATCTAGGGA,386,401,15,30,22737,2,0
23067,ACGTCGAATCTTGGGA,386,386,0,27,22738,0,0
23068,ACGTCGAATCTAGGGA,386,392,6,27,22741,0,0
23069,ACGTCGAATCTAGGGA,386,403,17,33,22742,3,0
23070,ACGTCGAATGTAGGGA,386,398,12,27,22743,1,0
23071,ACGTCGAATCTAGGGA,386,386,0,27,22744,0,0
23072,ACGTCGAATCTAGGGA,386,388,2,25,22747,0,0
23073,ACGTCGAATCTAGGGA,386,411,25,27,22749,6,0
23074,ACGTCGAATCTAGGGA,387,398,11,26,19744,2,0
23075,ACGTCGATTCTGGGGA,387,387,0,26,20757,0,0
23076,ACGTCGAATCTAGGGA,387,407,20,22,20913,5,0
23077,ACGTCGAATCTTGGGA,387,393,6,21,21133,0,0
23078,ACGTCGAATCTAGGGT,387,413,26,23,21465,7,0
23079,ACGTCGAATCTTGGGA,387,399,12,26,21761,2,0
23080,ACGTCGAATCTAGGGA,387,392,5,26,21819,0,0
23081,ACGTCGAATCTAGGGA,387,387,0,32,21824,0,0
23082,ACGTCGAATCTAGGGA,387,421,34,26,21983,9,0
23083,ACGTCGAATCTAGGGA,387,424,37,32,22173,9,0
23084,ACGTCGAATCTAGGGA,387,389,2,27,22180,0,0
23085,ACATCGAATCTAGGGA,387,408,21,31,22192,5,0
23086,ACGTCGAATCTAGGGA,387,403,16,28,22201,3,0
23087,ACGTCGAATCTAGGGA,387,402,15,29,22215,3,0
23088,ACGTCGAATCTAGGGA,387,390,3,27,22352,0,0
23089,ACGTCGAATCTAGGGA,387,388,1,32,22365,0,0
23090,ACGTCGAATCTAGGGA,387,390,3,27,22369,0,0
23091,ACGTCGAATCTAGGGA,387,388,1,32,22370,0,0
23092,ACCTCGATTCTGGGGA,387,390,3,27,22372,0,0
23093,ACGTCGAATCTTGGGA,387,390,3,29,22375,0,0
23094,ACGTTGAATCTAGGGA,387,390,3,32,22385,0,0
23095,ACGTCGAATCTAGGGA,387,389,2,23,22386,0,0
23096,ACGTCGATTGTGGGGA,387,390,3,26,22391,0,0
23097,ACGTCGAAAGCAGGGA,387,390,3,26,22394,0,0
23098,ACGTCGAGTCTAGGGA,387,390,3,32,22533,0,0
23099,ACGTCGAATCTAGGGA,387,390,3,28,22635,0,0
23100,ACGTCGAATCTAGGGA,387,390,3,30,22683,0,0
23101,ACGTCGAATCTAGGGA,387,390,3,26,22684,0,0
23102,ACGTCGACTCTAGGGA,387,390,3,26,22685,0,0
23103,ACTACGAATGTAGGGA,387,390,3,28,22689,0,0
23104,ACGTCGAGTCTAGGGA,387,390,3,32,22690,0,0
23105,ACGTCGAATCTAGGGA,387,390,3,28,22696,0,0
23106,ACGTCGAATCTAGGGA,387,390,3,29,22697,0,0
23107,ACGTCGAATCTAGGGA,387,389,2,31,22699,0,0
23108,ACGTCGAATGTAGGGA,387,388,1,28,22700,0,0
23109,ACGTCGACTCTAGAGA,387,390,3,28,22701,0,0
23110,ACGTCGAATCTAGGGA,387,390,3,28,22704,0,0
23111,ACGTCGAAAGCAGGGA,387,388,1,26,22705,0,0
23112,ACGTCGAAAGCAGGGA,387,390,3,25,22710,0,0
23113,ACGTCGAATCTAGGGA,387,389,2,27,22713,0,0
23114,ACGTCGGAAGCAGGGA,387,390,3,26,22717,0,0
23115,ACGTCGAATCTAGGGA,387,390,3,28,22719,0,0
23116,ACGTCGATTGTGGGGA,387,390,3,27,22722,0,0
23117,ACGTCGAATGTAGGGA,387,390,3,28,22726,0,0
23118,ACGTCGACTCTAGAGA,388,397,9,26,19778,1,0
23119,ACGTCGATTCTGGGGA,388,391,3,25,20719,0,0
23120,ACGTCGAATCTAGGGA,388,388,0,27,20825,0,0
23121,ACGTCGAATCTAGGGA,388,397,9,26,21359,1,0
23122,ACGTCGAAAGCAGGGA,388,391,3,24,21364,0,0
23123,ACGTCGAATCGAGGGA,388,414,26,27,21689,7,0
23124,ACGTCGAAAGCAGGGA,388,389,1,24,21700,0,0
23125,ACGTCGATTCTGGGGA,388,388,0,27,21707,0,0
23126,ACGTCGAATCTAGGGA,388,402,14,31,21713,3,0
23127,ACGTCGACTCTAGGGA,388,394,6,28,21714,0,0
23128,ACGTCGAATGTAGGGA,388,395,7,26,21718,0,0
23129,ACGACGAATCTAGGGA,388,396,8,27,21723,1,0
23130,ACGTCGAATCTAGGGA,388,396,8,27,21743,1,0
23131,ACGTCGAATCTAGGGA,388,399,11,33,21750,2,0
23132,ACGTCGAATCTAGGGA,388,406,18,28,21869,4,0
23133,ACGTCGAATGTAGGGA,388,388,0,27,21872,0,0
23134,TCGTCGAATCTAGGGA,388,388,0,26,21890,0,0
23135,ACGTCGAATCTAGGGA,388,394,6,27,21898,0,0
23136,ACGTCGAATCTAGGGA,388,395,7,27,22039,0,0
23137,ACGTCGAATCTAGGGA,388,398,10,26,22043,1,0
23138,ACGTCGAATCTAGGGA,388,389,1,30,22045,0,0
23139,ACGTCGAATCTAGGGA,388,400,12,28,22047,2,0
23140,ACGTCTAATCTAGGGT,388,395,7,24,22059,0,0
23141,ACGTCGAATCTTGGGA,388,404,16,22,22062,3,0
23142,ACGTCGAATCTAGGGA,388,419,31,33,22086,8,0
23143,ACGTCGAATGTAGGGA,388,392,4,29,22090,0,0
23144,TCGTCGAATCTAGGGA,388,401,13,26,22233,2,0
23145,ACGTCGAATCTTGGGA,388,399,11,22,22238,2,0
23146,TCGTCGAATCTAGGGA,388,408,20,26,22239,5,0
23147,ACGTCGAATCTAGGGA,388,403,15,30,22251,3,0
23148,ACGTCGAATCTAGGGA,388,406,18,30,22517,3,0
23149,TCGTCGAATCTAGGGA,388,414,26,26,22521,6,0
23150,ACGTCGAATCTAGGTA,388,401,13,27,22525,2,0
23151,ACGTCGAGTCTAGGGA,388,389,1,32,22526,0,0
23152,ACGTCGAATCTAGGGA,388,389,1,27,22531,0,0
23153,ACGTCGAATCTAGGGA,388,392,4,32,22532,0,0
23154,ACGTCGAATCTAGGGA,388,416,28,27,22558,7,0
23155,ACGTCGAATCTAGGGA,388,398,10,30,22560,1,0
23156,ACGTCGAATCTAGGGA,388,395,7,23,22563,0,0
23157,ACGTCGAATCTAGGGA,388,390,2,27,22565,0,0
23158,ACGTCGAATCTAGGGT,388,389,1,24,22566,0,0
23159,ACGTCGAATCTAGGGA,388,406,18,31,22570,3,0
23160,ACGTCGAAAGTAGGGA,388,394,6,26,22581,0,0
23161,ACGTCGAATCTAGGGA,388,393,5,27,22587,0,0
23162,ACGTCGAATCAAGGGA,388,388,0,32,22589,0,0
23163,ACGTCGAATCTAGGGA,388,400,12,33,22594,1,0
23164,ACGTCGAATCTAGGGA,388,396,8,28,22597,0,0
23165,TCGTCGAATCTAGGGA,388,411,23,28,22598,5,0
23166,ACATCGAATCTAGGGA,388,395,7,32,22600,0,0
23167,ACGTCGAATCTAGGGA,388,397,9,33,22602,0,0
23168,ACGTCGAATGTAGGGA,388,390,2,29,22751,0,0
23169,ACGTCGAATCTTGGGA,388,390,2,28,22754,0,0
23170,ACGTCGAATCTAGGGA,388,407,19,27,22755,4,0
23171,ACGTCGATTCTGGGGA,388,402,14,28,22759,2,0
23172,ACGTCGAATCTAGGGA,388,389,1,30,22761,0,0
23173,ACGTCGAATCTAGGGA,388,401,13,29,22767,2,0
23174,ACGTCGAATCTAGGGA,388,404,16,29,22768,3,0
23175,ACGTCGAATCTAGGGA,388,392,4,31,22770,0,0
23176,ACGTCGAGTCTAGGGA,388,391,3,33,22773,0,0
23177,ACCTCGATTCTGGGGA,388,391,3,28,22774,0,0
23178,ACGTCGAATCTAGGGA,389,392,3,25,20004,0,0
23179,ACGTCGAATCTAGGGA,389,397,8,25,21579,1,0
23180,ACGTCGAGTCTAGGGA,389,407,18,31,21594,4,0
23181,ACGTCGAATCTAGGGA,389,390,1,31,21612,0,0
23182,ACGTCGAATCTAGGGA,389,392,3,24,21620,0,0
23183,ACGTCGAATCTAGGGA,389,392,3,31,21770,0,0
23184,ACGTCGATTGTGGGGA,389,392,3,28,21972,0,0
23185,ACGTCGAATCTAGGGA,389,392,3,24,21975,0,0
23186,TCGTCGAATCTAGGGA,389,389,0,28,22115,0,0
23187,ACGTCGAAAGCAGGGA,389,392,3,24,22227,0,0
23188,ACGTCGAATCTAGGGA,389,392,3,26,22252,0,0
23189,TCGTCGAATCTAGGGA,389,392,3,28,22286,0,0
23190,ACGTCGAATCTAGGGA,389,392,3,27,22289,0,0
23191,ACGTCGAAAGCAGGGA,389,391,2,25,22290,0,0
23192,ACGTCGACTCTAGGGA,389,392,3,26,22291,0,0
23193,ACGTCGAATCTAGGGA,389,392,3,25,22298,0,0
23194,ACGTCGACTCTAGAGA,389,389,0,27,22443,0,0
23195,ACGTCGAATCTAGGGA,389,392,3,22,22449,0,0
23196,ACGTCGAATCTAGGGA,389,392,3,28,22450,0,0
23197,TCGTCGAATCTAGGGA,389,389,0,28,22452,0,0
23198,ACGTCGAATCTAGGGA,389,389,0,27,22455,0,0
23199,ACGTCGAATCTAGGGA,389,392,3,27,22458,0,0
23200,ACGTCGATTCTGGGGA,389,391,2,28,22464,0,0
23201,ACGTGGAATCTAGGGT,389,392,3,25,22469,0,0
23202,ACGTCGATTCTGGGGA,389,392,3,28,22472,0,0
23203,ACGTCGACAGCAGGGA,389,392,3,25,22496,0,0
23204,ACGTCGAATCTAGGGA,389,392,3,27,22498,0,0
23205,TCGTCGAATCTAGGGA,389,392,3,27,22502,0,0
23206,ACGTCGAATCTAGGGA,389,392,3,29,22511,0,0
23207,ACGTAGAATCTAGGGA,389,390,1,29,22513,0,0
23208,ACGTCGAATCTAGGGA,389,392,3,26,22612,0,0
23209,ACGTCGAATCTAGGGA,389,392,3,24,22613,0,0
23210,ACGTCGATTCTGGGGA,389,392,3,26,22615,0,0
23211,ACGTCGAATCTAGGGA,389,392,3,22,22616,0,0
23212,ACGTCGAATCTAGGGA,389,392,3,28,22617,0,0
23213,TCGTCGAATCTAGGGA,389,392,3,28,22619,0,0
23214,ACGTCGAATCTAGGGA,389,392,3,27,22621,0,0
23215,ACGTCGAATCTAGGGT,389,389,0,25,22633,0,0
23216,ACGTCGAATCTAGGGA,389,392,3,23,22731,0,0
23217,ACGTCGAATCTTGGGA,389,392,3,22,22733,0,0
23218,TCGTCGAATCTAGGGA,389,390,1,26,22734,0,0
23219,ACGTCGAATCTAGGGT,389,392,3,24,22736,0,0
23220,ACGTCGAATCTAGGGA,389,392,3,30,22737,0,0
23221,ACGTCGAATCTTGGGA,389,390,1,27,22738,0,0
23222,ACGTCGAATCTAGGGA,389,392,3,33,22742,0,0
23223,ACGTCGAATGTAGGGA,389,391,2,27,22743,0,0
23224,ACGTCGAATCTAGGGA,389,392,3,27,22744,0,0
23225,ACGTCGAATCTAGGGA,389,389,0,25,22747,0,0
23226,ACGTCGAATCTAGGGA,389,392,3,27,22749,0,0
23227,ACGTCGACTCTAGAGA,389,392,3,27,22784,0,0
23228,ACGTCGAGTCTAGGGA,389,391,2,31,22787,0,0
23229,ACGTCGAATCGAGGGA,389,392,3,28,22796,0,0
23230,ACGTCGATTCTGGGGA,389,392,3,28,22798,0,0
23231,ACGTCGAATGTAGGGA,389,392,3,27,22801,0,0
23232,ACGTCGAATCTAGGGA,389,390,1,28,22803,0,0
23233,ACGTCGAATCTAGGGA,389,392,3,28,22804,0,0
23234,ACGTCGATTCTGGGGA,389,390,1,28,22805,0,0
23235,ACGTCGATTCTGGGGA,389,390,1,25,22810,0,0
23236,ACGTCGAATCTAGGGA,389,392,3,29,22811,0,0
23237,ACGTCGAATGTAGGGA,389,389,0,28,22812,0,0
23238,ACGTCGAATCTAGGGA,389,392,3,28,22813,0,0
23239,TCGTCGAATCTAGGGA,389,392,3,27,22815,0,0
23240,ACGTCGAATCTAGGGA,389,392,3,28,22816,0,0
23241,ACGTCGATTCTGGGGA,389,392,3,27,22817,0,0
23242,ACGTCGAATCTAGGGA,389,392,3,31,22820,0,0
23243,ACGTCGAATCTAGGGA,389,392,3,29,22821,0,0
23244,AAGTCGAATCTAGGGA,390,396,6,26,19744,0,0
23245,ACGTCGATTCTGGGGA,390,399,9,26,20757,1,0
23246,ACGTCGAATCTTGGGA,390,390,0,21,21133,0,0
23247,ACGTCGAATCTAGGGT,390,397,7,23,21465,0,0
23248,ACGTCGAATCTTGGGA,390,396,6,26,21761,0,0
23249,ACGTCGAATCTAGGGA,390,397,7,26,21819,0,0
23250,ACGTCGAATCTAGGGA,390,399,9,32,21824,1,0
23251,ACGTCGAATCTAGGGA,390,404,14,32,22173,3,0
23252,ACGTCGAATCTAGGGA,390,391,1,27,22180,0,0
23253,ACGTCGAATCTAGGGA,390,391,1,27,22352,0,0
23254,ACGTCGAATCGAGGGA,390,390,0,32,22365,0,0
23255,ACGTCGAATCTAGGGA,390,410,20,27,22369,5,0
23256,ACGTCGAATCTAGGGA,390,406,16,32,22370,3,0
23257,ACCTCGATTCTGGGGA,390,414,24,27,22372,6,0
23258,ACGTTGAATCTAGGGA,390,392,2,32,22385,0,0
23259,ACGTCGAATCTAGGGA,390,407,17,23,22386,4,0
23260,ACGTCGATTGTGGGGA,390,396,6,26,22391,0,0
23261,ACGTCGAAAGCAGGGA,390,393,3,26,22394,0,0
23262,ACGTCGAATCTAGGGA,390,395,5,28,22635,0,0
23263,ACGTCGAATCTAGGGA,390,423,33,26,22684,8,0
23264,ACGTCGACTCTAGGGA,390,401,11,26,22685,2,0
23265,ACGTCGAGTCTAGGGA,390,432,42,32,22690,8,0
23266,ACGTCGAATCTAGGGA,390,394,4,29,22697,0,0
23267,ACGTCGAATCTAGGGA,390,405,15,31,22699,3,0
23268,ACGTCGAATGTAGGGA,390,395,5,28,22700,0,0
23269,ACGTCGACTCTAGAGA,390,397,7,28,22701,0,0
23270,ACGTCGAAAGCAGGGA,390,392,2,26,22705,0,0
23271,ACGTCGAAAGCAGGGA,390,421,31,25,22710,8,0
23272,ACGTCGAATCTAGGGA,390,399,9,27,22713,1,0
23273,ACGTCGGAAGCACGGA,390,402,12,26,22717,2,0
23274,ACGTCGAATCTAGGGA,390,412,22,28,22719,5,0
23275,ACGTCGAATTTAGGGA,390,392,2,26,22847,0,0
23276,ACGTCGACTCTAGGGA,390,393,3,26,22848,0,0
23277,ACGTCGATTCTGGGGA,390,395,5,26,22849,0,0
23278,ACGTCGAATCTAGGGA,390,391,1,32,22855,0,0
23279,ACGTCGAGTCTAGGGA,390,403,13,32,22856,2,0
23280,ACGTCGAATCTAGGGA,390,395,5,29,22857,0,0
23281,ACGTCGAATCTAGGGA,390,407,17,28,22862,3,0
23282,ACGTCGATTGTGGGGA,390,392,2,29,22863,0,0
23283,ACGTCGAACCTAGGGA,390,407,17,25,22864,3,0
23284,TCGTCGAATCTAGGGA,390,396,6,29,22865,0,0
23285,ACGTCGAATCTAGGGA,390,397,7,27,22867,0,0
23286,ACGTCGAATCTAGGGA,390,400,10,29,22870,1,0
23287,TCGTCGAATCTAGGGA,390,407,17,29,22871,3,0
23288,ACGTCGAAAGCAGGGA,390,396,6,26,22872,0,0
23289,ACGTCGATTGTGGGGA,390,397,7,27,22876,0,0
23290,ACGTCGAATCTAGGGA,390,402,12,27,22881,1,0
23291,ACGTCGAATCTAGGGA,390,391,1,25,22882,0,0
23292,ACGTCGAATCTAGGGA,390,411,21,28,22888,4,0
23293,ACGTCGATTGTGGGGA,390,390,0,29,22889,0,0
23294,ACGTCGATTCTGGGGA,390,392,2,29,22892,0,0
23295,ACGTCGAATGTAGGGA,390,410,20,29,22893,4,0
23296,ACGTCGACTCTAGAGA,391,405,14,26,19778,3,0
23297,ACGTCGATTCTGGGGA,391,417,26,25,20719,7,0
23298,ACGTCGAATCTAGGGA,391,397,6,27,20825,0,0
23299,ACGTCGAATCTAGGGA,391,397,6,26,21359,0,0
23300,ACGTCGAAAGCAGGGA,391,412,21,24,21364,5,0
23301,ACGTCGAATCGAGGGA,391,417,26,27,21689,7,0
23302,ACGTCGAAAGCAGGGA,391,393,2,24,21700,0,0
23303,ACGTCGATTCTGGGGA,391,399,8,27,21707,0,0
23304,ACGTCGAATCTAGGGC,391,416,25,31,21713,6,0
23305,ACGTCGACTCTAGGGA,391,411,20,28,21714,4,0
23306,ACGTCGAATCTAGGGA,391,391,0,33,21750,0,0
23307,ACGTCGAATCTAGGGA,391,391,0,28,21869,0,0
23308,ACGTCGAATGTAGGGA,391,392,1,27,21872,0,0
23309,ACGTCGAATCTAGGGA,391,408,17,27,21898,3,0
23310,ACGTCGAATCTAGGGA,391,393,2,27,22039,0,0
23311,ACGTCGAATCTAGGGA,391,398,7,26,22043,0,0
23312,ACGTCGAATCTAGGGA,391,407,16,28,22047,3,0
23313,ACGTCGAATCTTGGGA,391,399,8,22,22062,0,0
23314,ACGTCGAATCTAGGGA,391,429,38,33,22086,7,0
23315,ACGTCGAATGTAGGGA,391,391,0,29,22090,0,0
23316,ACGTCGAATCTTGGGA,391,396,5,22,22238,0,0
23317,TCGTCGAATCTAGGGA,391,393,2,26,22239,0,0
23318,ACGTCGAATCTAGGGA,391,405,14,30,22251,2,0
23319,TCGTCGAATCTAGGGA,391,399,8,26,22521,0,0
23320,ACGTCGAATCTAGGGA,391,429,38,27,22531,7,0
23321,ACGTCGAATCTAGGGA,391,391,0,32,22532,0,0
23322,ACGTCGAATCTAGGGA,391,397,6,27,22558,0,0
23323,ACGTCGAATCTAGGGA,391,394,3,30,22560,0,0
23324,ACGTCGAATCTAGGGA,391,394,3,23,22563,0,0
23325,ACGTCGAATCTAGGGA,391,394,3,27,22565,0,0
23326,ACGTCGAATCTAGGGT,391,394,3,24,22566,0,0
23327,ACCTCGAATCTAGGGA,391,394,3,31,22570,0,0
23328,ACGTCGAAAGTAGGGA,391,394,3,26,22581,0,0
23329,ACGTCGAATCTAGGGA,391,391,0,27,22587,0,0
23330,ACGTCGAATCAAGGGA,391,394,3,32,22589,0,0
23331,ACGTCGAATCAAGGGA,391,394,3,33,22594,0,0
23332,ACGTCGAATCTAGGGA,391,394,3,28,22597,0,0
23333,ACATCGAATCTAGGGA,391,394,3,32,22600,0,0
23334,ACGTCGAATCTAGGGA,391,394,3,33,22602,0,0
23335,ACGTCGAATCTAGGGA,391,391,0,28,22754,0,0
23336,ACGTCGAATCTAGGGA,391,394,3,27,22755,0,0
23337,ACGTCGATTCTGGGGA,391,394,3,28,22759,0,0
23338,ACGTCGAATCTAGGGA,391,394,3,29,22767,0,0
23339,ACGTCGAATCTAGGGA,391,394,3,31,22770,0,0
23340,ACGTCGAGTCTAGGGA,391,394,3,33,22773,0,0
23341,ACCTCGATTCTGGGGA,391,394,3,28,22774,0,0
23342,ACATCGAATCTAGGGA,391,392,1,31,22896,0,0
23343,ACGTCGAATCTAGGGA,391,394,3,27,22909,0,0
23344,ACGTCGATTCTGGGGA,391,394,3,27,22911,0,0
23345,ACGTCGAATCTAGGGA,391,394,3,23,22912,0,0
23346,ACGTCGAATCTAGGGT,391,394,3,24,22914,0,0
23347,ACGTCGAATCTTGGGA,391,394,3,27,22915,0,0
23348,ACGTCGAATCTAGGGA,391,391,0,33,22918,0,0
23349,ACGTCGAATCTAGGGA,391,394,3,33,22922,0,0
23350,ACATCGAATCTAGGGA,391,392,1,32,22924,0,0
23351,ACGTCGAATCTAGGGA,391,394,3,30,22928,0,0
23352,ACGTCGAATCGAGGGA,391,394,3,26,22929,0,0
23353,ACGTCGAATCTAGGGA,391,394,3,29,22931,0,0
23354,ACGTCGAATCTAGGGA,391,394,3,33,22932,0,0
23355,ACGTCGAATCTAGGGA,392,396,4,25,20004,0,0
23356,ACGTCGAATCTAGGGA,392,398,6,25,21579,0,0
23357,ACGTCGAGTCTAGGGA,392,400,8,31,21594,1,0
23358,ACGTCGAATCTAGGGA,392,401,9,31,21612,1,0
23359,ACGTCGAATCTAGGGA,392,397,5,24,21620,0,0
23360,ACGTCGAATCTAGGGA,392,410,18,31,21770,4,0
23361,ACGTCGATTGTGGGGA,392,392,0,28,21972,0,0
23362,TCGTCGAATCTAGGGA,392,399,7,28,22115,0,0
23363,ACGTCGAATCTAGGGA,392,410,18,26,22252,4,0
23364,TCGTCGAATCTAGGGA,392,392,0,28,22286,0,0
23365,ACGTCGAATCTAGGGA,392,398,6,27,22289,0,0
23366,ACGTCGAAAGCAGGGA,392,398,6,25,22290,0,0
23367,ACGTCGACTCTAGGGA,392,397,5,26,22291,0,0
23368,ACGTCGAATCTAGGGA,392,397,5,25,22298,0,0
23369,ACGTCGACTCTAGAGA,392,411,19,27,22443,4,0
23370,ACGTCGAATCTAGGGA,392,398,6,22,22449,0,0
23371,TCGTCGAATCTAGGGA,392,393,1,28,22452,0,0
23372,ACGTCGAATCTAGGGA,392,404,12,27,22455,1,0
23373,ACGTCGAATCTAGGGA,392,401,9,27,22458,0,0
23374,ACGTCGATTCTGGGGA,392,433,41,28,22464,7,0
23375,ACGTCGATTCTGGGGA,392,413,21,28,22472,4,0
23376,ACGTCGAAAGCAGGGA,392,404,12,25,22496,1,0
23377,ACGTCGAATCTAGGGA,392,397,5,27,22498,0,0
23378,ACGTCGAATCTAGGGA,392,402,10,29,22511,1,0
23379,ACGTAGAATCTAGGGA,392,413,21,29,22513,4,0
23380,ACGTCGAATCTAGGGA,392,413,21,26,22612,4,0
23381,ACGTCGAATCTAGGGA,392,408,16,24,22613,3,0
23382,ACGTCGAATCTAGGGA,392,395,3,22,22616,0,0
23383,ACGTCGAATCTAGGGA,392,392,0,28,22617,0,0
23384,TCGTCGAATCTAGGGA,392,410,18,28,22619,3,0
23385,ACGTCGAATCTAGGGA,392,393,1,27,22621,0,0
23386,ACGTCGAATCTAGGGT,392,392,0,25,22633,0,0
23387,ACGTCGAATCTAGGGA,392,400,8,23,22731,0,0
23388,ACGTCGAATCTTGGGA,392,395,3,22,22733,0,0
23389,TCGTCGAATCTAGGGA,392,407,15,26,22734,2,0
23390,ACGTCGAATCTAGGGT,392,395,3,24,22736,0,0
23391,ACGTCGAATCTAGGGA,392,407,15,30,22737,2,0
23392,ACGTCGAATCTTGGGA,392,392,0,27,22738,0,0
23393,ACGTCGAATCTAGGGA,392,414,22,25,22747,5,0
23394,ACGTCGAATCTAGGGA,392,396,4,27,22749,0,0
23395,ACGTCGACTCTAGAGA,392,395,3,27,22784,0,0
23396,ACGTCGAATCGAGGGA,392,392,0,28,22796,0,0
23397,ACGTCGAATGTAGGGA,392,392,0,28,22803,0,0
23398,ACGTCGAATCTAGGGA,392,395,3,28,22804,0,0
23399,ACGTCGATTCTGGGGA,392,395,3,28,22805,0,0
23400,ACGTCGATTCTGGGGA,392,395,3,25,22810,0,0
23401,ACGTCGAATCTAGGGA,392,395,3,29,22811,0,0
23402,ACGTCGAATCTAGGGA,392,395,3,28,22813,0,0
23403,TCGTCGAATCTAGGGA,392,394,2,27,22815,0,0
23404,ACGTCGAATCTAGGGA,392,395,3,28,22816,0,0
23405,ACGTCGATTCTGGGGA,392,394,2,27,22817,0,0
23406,ACGTCGAATCTAGGGA,392,395,3,31,22820,0,0
23407,ACGTCGAATCTAGGGA,392,392,0,28,22933,0,0
23408,ACGTCGAATCTAGGGA,392,394,2,28,22947,0,0
23409,ACGTCGAATCTACGGA,392,395,3,27,22948,0,0
23410,ACGTCGAAAGCAGGGA,392,395,3,25,22951,0,0
23411,ACGTCGATTCTGGGGA,392,395,3,28,22952,0,0
23412,ACGTCGACTCTAGGGA,392,392,0,29,22954,0,0
23413,ACGTCGAATGTAGGGA,392,395,3,27,22955,0,0
23414,ACGTCGAATCTAGGGT,392,395,3,25,22956,0,0
23415,ACGTCGAATCTAGGGA,392,395,3,28,22957,0,0
23416,ACGTCGAATCTAGGGA,392,394,2,28,22958,0,0
23417,ACGTCGAATCTAGGGA,392,395,3,25,22961,0,0
23418,ACCTCGAATCTAGGGA,392,395,3,29,22963,0,0
23419,ACGTCGAATCTAGGGT,393,404,11,23,21465,2,0
23420,ACGTCGAATCTTGGGA,393,393,0,26,21761,0,0
23421,ACGTCGAATCTAGGGA,393,393,0,32,21824,0,0
23422,ACGTCGAATCTAGGGA,393,398,5,27,22180,0,0
23423,ACGTCGAATCTAGGGA,393,401,8,27,22352,1,0
23424,ACGTCGAATCTAGGGA,393,394,1,32,22365,0,0
23425,ACGTCGAATCTAGGGA,393,446,53,27,22369,7,0
23426,ACGTCGAATCTAGGGA,393,398,5,23,22386,0,0
23427,ACGTCGATTGTGGGGA,393,412,19,26,22391,4,0
23428,ACGTCGAATCTAGGGA,393,395,2,28,22635,0,0
23429,ACGTCGACTCTAGGGA,393,399,6,26,22685,0,0
23430,ACGTCGAATCTAGGGA,393,412,19,29,22697,4,0
23431,ACGTCGAATCTAGGGA,393,393,0,31,22699,0,0
23432,ACGTCGAAAGCAGGGA,393,418,25,26,22705,6,0
23433,ACGTCGAAAGCATGGA,393,403,10,25,22710,1,0
23434,ACGTCGAATCTAGGGA,393,405,12,27,22713,2,0
23435,ACGTCGGAAGCAGGGA,393,417,24,26,22717,6,0
23436,ACGTCGAATTTAGGGA,393,398,5,26,22847,0,0
23437,ACGTCGACTCTAGGGA,393,402,9,26,22848,0,0
23438,ACGTCGATTCTGGGGA,393,393,0,26,22849,0,0
23439,ACGTCGAATCTAGGGA,393,411,18,29,22857,3,0
23440,ACGTCGAATCTAGGGA,393,394,1,28,22862,0,0
23441,ACGTCGATTGTGGGGA,393,412,19,29,22863,4,0
23442,ACGTCGAATCTAGCGA,393,400,7,25,22864,0,0
23443,TCGTCGAATCTAGGGA,393,401,8,29,22865,0,0
23444,ACGTCGAATCTAGGGA,393,397,4,27,22867,0,0
23445,ACGTCGAATCTAGGGA,393,402,9,29,22870,0,0
23446,TCGTCGAATCTAGGGA,393,403,10,29,22871,1,0
23447,ACGTCGAAAGCAGGGA,393,420,27,26,22872,6,0
23448,ACGTCGAATCTAGGGA,393,397,4,27,22881,0,0
23449,ACGTCGAATCTAGGGA,393,396,3,25,22882,0,0
23450,ACGTCGAATCTAGGGA,393,396,3,28,22888,0,0
23451,ACGTCGATTGTGGGGA,393,396,3,29,22889,0,0
23452,ACGTCGATTCTGGGGA,393,393,0,29,22892,0,0
23453,TCGTCGAATCTAGGGA,393,396,3,27,22965,0,0
23454,ACGTCGAATCTAGGGA,393,396,3,26,23005,0,0
23455,ACGTCGATTCTGGGGA,393,396,3,26,23006,0,0
23456,ACGTCGAGTCTAGGGA,393,396,3,32,23008,0,0
23457,ACGTCGAATCTAGGGA,393,396,3,29,23012,0,0
23458,ACGTCGATTGTGGGGA,393,395,2,29,23013,0,0
23459,ACGTCGAATCTAGGGA,393,396,3,25,23014,0,0
23460,ACGTCGAATCTAGGGA,393,396,3,27,23017,0,0
23461,ACGTCGAATCTAGGGA,393,396,3,25,23018,0,0
23462,ACGTCGAATCTAGGGA,393,394,1,29,23019,0,0
23463,ACGTCGAATCTAGGGA,393,395,2,28,23021,0,0
23464,ACGTCGAAAGCAGGGA,393,396,3,26,23022,0,0
23465,ACGTCGATTGTGGGGA,393,396,3,27,23024,0,0
23466,ACGTCGACTCTAGAGA,393,394,1,28,23026,0,0
23467,ACGTCGAATCTAGGGA,393,393,0,23,23028,0,0
23468,ACGTCGAATCTAGGGA,393,396,3,29,23029,0,0
23469,TCGTCGAATCTAGGGA,393,395,2,29,23030,0,0
23470,ACGTCGATTGTGGGGA,393,394,1,29,23032,0,0
23471,ACGTGGAATCTAGGGT,393,396,3,26,23036,0,0
23472,ACGTCGATTCTGGGGA,393,396,3,29,23037,0,0
23473,ACATCGAATCTAGGGA,393,394,1,31,23038,0,0
23474,ACGTCGAATCTAGGGA,393,396,3,35,23044,0,0
23475,ACGTCGAATGTAGGGA,393,396,3,31,23045,0,0
23476,ACGTCGATTCTGGGGA,393,396,3,27,23049,0,0
23477,ACGTCGAATCTAGGGA,393,396,3,23,23050,0,0
23478,ACGTCGAATCTAGGGA,393,393,0,28,23053,0,0
23479,ACGTCGAATCGAGGGA,393,396,3,29,23056,0,0
23480,ACGTCGAATCTAGGGA,393,396,3,28,23060,0,0
23481,ACGTCGACTCTAGAGA,394,435,41,26,19778,7,0
23482,ACGTCGATTCTGGGGA,394,399,5,25,20719,0,0
23483,ACGTCGAATCTAGGGA,394,419,25,27,20825,6,0
23484,ACGTCGAATCTAGGGA,394,399,5,26,21359,0,0
23485,ACGTCGAATCGAGGGA,394,404,10,27,21689,1,0
23486,ACGTCGAAAGCAGGGA,394,395,1,24,21700,0,0
23487,ACGTCGATTCTGGGGA,394,397,3,27,21707,0,0
23488,ACGTCGAATCTAGGGA,394,398,4,31,21713,0,0
23489,ACGTCCACTCTAGGGA,394,394,0,28,21714,0,0
23490,ACGTCGAATCTAGGGA,394,400,6,33,21750,0,0
23491,ACGTCGAATCTAGGGA,394,416,22,28,21869,5,0
23492,ACGTCGAATGTAGGGA,394,409,15,27,21872,3,0
23493,ACGTCGAATCTAGGGA,394,397,3,27,22039,0,0
23494,ACGTCGAATCTAGGGA,394,401,7,33,22086,0,0
23495,ACGTCGAATGTAGGGA,394,399,5,29,22090,0,0
23496,ACGTCGAATCTTGGGA,394,396,2,22,22238,0,0
23497,TCGTCGAATCTAGGGA,394,400,6,26,22239,0,0
23498,TCGTCGAATCTAGGGA,394,400,6,26,22521,0,0
23499,ACGTCGAATCTAGGGA,394,397,3,27,22531,0,0
23500,ACGTCGAATCTAGGGA,394,395,1,32,22532,0,0
23501,ACGTCGAATCTAGGGA,394,416,22,27,22558,5,0
23502,ACGTCGAATCTAGGGA,394,419,25,30,22560,6,0
23503,ACGTCGAATCTAGGGA,394,410,16,27,22565,3,0
23504,ACGTCGAATCTAGGGT,394,420,26,24,22566,7,0
23505,ACGTCGAATCTAGGGA,394,403,9,31,22570,1,0
23506,ACGTCGAAAGTAGGGA,394,396,2,26,22581,0,0
23507,ACGTCGAATCAAGGGA,394,404,10,32,22589,1,0
23508,ACGTCGAATCTAGGGA,394,397,3,33,22594,0,0
23509,ACGTCGAATCTAGGGA,394,401,7,28,22597,0,0
23510,ACGTCGAATCTAGGGA,394,395,1,33,22602,0,0
23511,ACGTCGAATCTAGGGA,394,397,3,28,22754,0,0
23512,CCGTCGAATCTAGGGA,394,402,8,27,22755,0,0
23513,ACGTCGATTCTGGGGA,394,403,9,28,22759,0,0
23514,ACGTCGAATCTAGGGA,394,395,1,29,22767,0,0
23515,ACATCGAATCTAGGGA,394,400,6,31,22896,0,0
23516,ACGTCGAATCTAGGGA,394,396,2,27,22909,0,0
23517,ACGTCGATTCTGGGGA,394,402,8,27,22911,0,0
23518,ACGTCGAATCTAGGGA,394,395,1,23,22912,0,0
23519,ACGTCGAATCTAGGGT,394,408,14,24,22914,2,0
23520,ACGTCGAATCTTGGGA,394,405,11,27,22915,1,0
23521,ACGTCGAATCTAGGGA,394,398,4,33,22918,0,0
23522,ACGTCGAATCTAGGGA,394,395,1,33,22922,0,0
23523,ACATCGAATCTAGGGA,394,397,3,32,22924,0,0
23524,ACGTCGAATCGAGGGA,394,397,3,26,22929,0,0
23525,ACGTCGAATCTAGGGA,394,397,3,29,22931,0,0
23526,ACGTCGAATCTAGGGA,394,397,3,33,22932,0,0
23527,ACGTCGAATCTAGGGA,394,394,0,27,23074,0,0
23528,ACGTCGAATCTAGGGA,394,397,3,23,23076,0,0
23529,ACGTCGAATCTAGGGT,394,397,3,24,23078,0,0
23530,ACGTCGAATCTTGGGA,394,396,2,27,23079,0,0
23531,ACGTCGAATCTAGGGA,394,397,3,27,23082,0,0
23532,ACGTCGAATCTAGGGA,394,397,3,33,23083,0,0
23533,ACATCGAATCTAGGGA,394,397,3,32,23085,0,0
23534,ACGTCGAATCTAGGGA,394,397,3,29,23086,0,0
23535,ACGTCGAATCTAGGGA,395,397,2,31,21612,0,0
23536,ACGTCGAATCTAGGGA,395,425,30,24,21620,6,0
23537,ACGTCGAATCTAGGGA,395,396,1,31,21770,0,0
23538,ACGTCGATTGTGGGGA,395,401,6,28,21972,0,0
23539,TCGTCGAATCTAGGGA,395,402,7,28,22115,0,0
23540,ACGTCGAATCTAGGGA,395,399,4,26,22252,0,0
23541,TCGTCGAATCTAGGGA,395,428,33,28,22286,6,0
23542,ACGTCGAATCTAGGGA,395,398,3,27,22289,0,0
23543,ACGTCGAATCTAGGGA,395,407,12,25,22298,2,0
23544,ACGTCGACTCTAGAGA,395,401,6,27,22443,0,0
23545,ACGTCGAATCTAGGGA,395,407,12,22,22449,2,0
23546,TCGTCGAATCTAGGGA,395,396,1,28,22452,0,0
23547,ACGTCGAATCTAGGGA,395,408,13,27,22455,2,0
23548,ACGTCGAATCTAGGGA,395,399,4,27,22458,0,0
23549,ACGTCGATTCTGGGGA,395,398,3,28,22464,0,0
23550,ACGTCGAAAGCAGGGA,395,405,10,25,22496,1,0
23551,ACGTCGAATCTAGGGA,395,398,3,27,22498,0,0
23552,ACGTTGAATCTAGGGA,395,398,3,29,22511,0,0
23553,ACGTAGAATCTAGGGA,395,398,3,29,22513,0,0
23554,ACGTCGAATCTAGGGA,395,398,3,26,22612,0,0
23555,ACGTCGAATCTAGGGA,395,398,3,24,22613,0,0
23556,ACGTCGATTCTAGGGA,395,398,3,28,22617,0,0
23557,TCGTCAAATCTAGGGA,395,397,2,28,22619,0,0
23558,ACGTCGAATCTAGGGA,395,398,3,27,22621,0,0
23559,ACGTCGAATCTAGGGT,395,395,0,25,22633,0,0
23560,ACGTCGAATCTAGGGA,395,397,2,23,22731,0,0
23561,TCGTCGAATCTAGGGA,395,398,3,26,22734,0,0
23562,ACGTCGGATCTAGGGT,395,395,0,24,22736,0,0
23563,ACGTCGAATCTAGGGA,395,398,3,30,22737,0,0
23564,ACGTCGAATCTTGGGA,395,398,3,27,22738,0,0
23565,ACGTCGAATCTAGGGA,395,398,3,25,22747,0,0
23566,ACGTCGAATCTAGGGA,395,398,3,27,22749,0,0
23567,ACGTCGAATCGAGGGA,395,398,3,28,22796,0,0
23568,ACGTCGAATCTAGGGA,395,397,2,28,22803,0,0
23569,ACGTCGAATCTAGGGA,395,397,2,28,22804,0,0
23570,ACGTCGAATCTAGGGA,395,397,2,29,22811,0,0
23571,ACGTCGAATCTAGGGA,395,398,3,28,22813,0,0
23572,TCGTCGAATCTAGGGA,395,396,1,27,22815,0,0
23573,ACGTCGAATCTAGGGA,395,398,3,28,22816,0,0
23574,ACGTCGATTCTGGGGA,395,398,3,27,22817,0,0
23575,ACGTCGAATCTAGGGA,395,398,3,31,22820,0,0
23576,ACGTCGAATCTAGGGA,395,398,3,28,22933,0,0
23577,ACGTCGAATCTAGGGA,395,398,3,28,22947,0,0
23578,ACGTCGAATCTAGGGA,395,398,3,27,22948,0,0
23579,ACGTCGATTCTGGGGA,395,397,2,28,22952,0,0
23580,ACGTCGAATCTAGGGT,395,398,3,25,22956,0,0
23581,ACGTCGAATCTAGGGA,395,398,3,28,22957,0,0
23582,ACGTCGAATCTAGGGA,395,398,3,28,22958,0,0
23583,ACGTCGAATCTTGGGA,395,398,3,23,23063,0,0
23584,ATGTCGAATCTAGGGT,395,395,0,25,23065,0,0
23585,ACGTCGAATCTAGGGA,395,398,3,31,23066,0,0
23586,ACGTCGAATCTAGGGA,395,396,1,34,23069,0,0
23587,ACGTCGAATGTAGGGA,395,395,0,28,23070,0,0
23588,ACGTCGAATCTAGGGA,395,398,3,28,23073,0,0
23589,ACGTCGAATCTAGGGA,395,397,2,30,23087,0,0
23590,ACGTCGACTCTAGAGA,395,397,2,27,23118,0,0
23591,ACGTCGAATCTAGGGA,395,398,3,27,23121,0,0
23592,ACGTCGAATCGAGGGA,395,395,0,28,23123,0,0
23593,ACGTCGAATCTAGGGA,395,398,3,32,23126,0,0
23594,ACGACGAATCTAGGGA,395,398,3,28,23129,0,0
23595,ACGTCGAATCTAGGGA,395,398,3,28,23130,0,0
23596,ACGTCGAATCTAGGGA,395,398,3,34,23131,0,0
23597,ACGTCGAATCTAGGGA,395,398,3,29,23132,0,0
23598,ACGTCGAATCTAGGGA,395,398,3,27,23137,0,0
23599,ACGTCGAATCTAGGGA,395,398,3,29,23139,0,0
23600,ACGTCGAATCTTGGGA,395,398,3,23,23141,0,0
23601,ACGTCGAATCTAGGGA,395,398,3,34,23142,0,0
23602,TCGTCGAATCTAGGGA,395,398,3,27,23144,0,0
23603,AGGTCGAATCTTGGGA,395,398,3,23,23145,0,0
23604,TCGTCGAATCTAGGGA,395,397,2,27,23146,0,0
23605,ACGTCGAATCTAGGGA,395,398,3,31,23147,0,0
23606,ACGTCGAATCTTGGGA,396,398,2,26,21761,0,0
23607,ACGTCGAATCTAGGGA,396,404,8,27,22180,1,0
23608,ACGTCGAATCTAGGGA,396,399,3,27,22369,0,0
23609,ACGTCGAATCTAGGGA,396,410,14,28,22635,3,0
23610,ACGTCGACTCTAGGGA,396,418,22,26,22685,5,0
23611,ACGTCGAATCAAGGGA,396,402,6,29,22697,0,0
23612,ACGTCGAATCTAGGGA,396,421,25,31,22699,6,0
23613,ACGTCGAAAGCAGGGA,396,399,3,26,22705,0,0
23614,ACGTCGAAAGCAGGGA,396,420,24,25,22710,6,0
23615,ACGTCGAATCTAGGGA,396,446,50,27,22713,6,0
23616,ACGTCGGAAGCAGGGA,396,403,7,26,22717,0,0
23617,ACGTCGAATTTAGGGA,396,399,3,26,22847,0,0
23618,ACGTCGACTCTAGGGA,396,398,2,26,22848,0,0
23619,ACGTCGATTCTGGGGA,396,397,1,26,22849,0,0
23620,ACGTCGAATCTAGGGA,396,396,0,28,22862,0,0
23621,ACGTCGAATCTAGGGA,396,425,29,25,22864,6,0
23622,TCGTCGAATCTAGGGA,396,400,4,29,22865,0,0
23623,ACGTCGAATCTATGGA,396,403,7,27,22867,0,0
23624,ACGTCGAATCTAGGGA,396,399,3,29,22870,0,0
23625,ACGTCGAATCTAGGGA,396,399,3,25,22882,0,0
23626,ACGTCGAATCTAGGGA,396,411,15,28,22888,3,0
23627,ACGTCGATTGTGGGGA,396,403,7,29,22889,0,0
23628,ACGTCGATTCTGGGGA,396,399,3,29,22892,0,0
23629,ACGTCGAATCTAGGGA,396,409,13,26,23005,2,0
23630,ACGTCGAGTCTAGGGA,396,396,0,32,23008,0,0
23631,GCGTCGATTGTGGGGA,396,423,27,29,23013,6,0
23632,ACGTCGAATCTAGGGA,396,422,26,25,23014,6,0
23633,ACGTCGAATCTAGGGA,396,398,2,27,23017,0,0
23634,ACGTCGAATCTAGGGA,396,402,6,25,23018,0,0
23635,ACGTCGAATCTAGGGA,396,421,25,28,23021,6,0
23636,ACGTCGAAAGCAGGGA,396,397,1,26,23022,0,0
23637,ACGTCGATTGTGGGGA,396,398,2,27,23024,0,0
23638,ACGTCGACTCTAGAGA,396,399,3,28,23026,0,0
23639,ACGTCGAATCTAGGGA,396,399,3,23,23028,0,0
23640,TCGTCGAATCTAGGGA,396,397,1,29,23030,0,0
23641,ACGTCGATTGTGGGGA,396,399,3,29,23032,0,0
23642,ACGTCGATTCTGGGGA,396,407,11,29,23037,2,0
23643,ACATCGAATCTAGGGA,396,408,12,31,23038,2,0
23644,ACGTCGAATGTAGGGA,396,422,26,31,23045,6,0
23645,ACGTCGATTCTGGGGA,396,417,21,27,23049,5,0
23646,ACGTCGAATCTAGGGA,396,409,13,28,23060,2,0
23647,ACGTCGAATCTAGGGA,396,397,1,26,23179,0,0
23648,ACGTCGAGTCTAGGGA,396,403,7,32,23180,0,0
23649,ACGTCGACTCTAGAGA,397,398,1,26,19778,0,0
23650,ACGTCGATTCTGGGGA,397,404,7,25,20719,1,0
23651,ACGTCGAATCTAGGGA,397,397,0,26,21359,0,0
23652,ACGTCGAATCGAGGGA,397,411,14,27,21689,3,0
23653,ACGTCGAAAGCAGGGA,397,410,13,24,21700,3,0
23654,ACGTCGAATCTAGGGA,397,399,2,31,21713,0,0
23655,ACGTCGACTCTAGGGA,397,410,13,28,21714,3,0
23656,ACGTCGAATCTAGGGA,397,399,2,33,21750,0,0
23657,ACGTCGAATCTAGGGA,397,398,1,28,21869,0,0
23658,ACGTCGAATCTAGGGA,397,401,4,27,22039,0,0
23659,ACGTCGAATCTAGGGA,397,412,15,33,22086,4,0
23660,TCGTCGAATCTAGGGA,397,399,2,26,22521,0,0
23661,ACGTCGAATCTAGGGA,397,411,14,27,22531,3,0
23662,ACGTCGAATCTAGGGA,397,417,20,27,22565,5,0
23663,ACGTCGAATCTAGGGT,397,410,13,24,22566,2,0
23664,ACGTCGAATCTAGGGA,397,408,11,31,22570,2,0
23665,ACGTCGAAAGTAGGGA,397,410,13,26,22581,2,0
23666,ACGTCGAATCAAGGGA,397,399,2,32,22589,0,0
23667,ACGTCGAATCTAGGGA,397,404,7,28,22597,0,0
23668,ACGTCGAATCTAGGGA,397,403,6,33,22602,0,0
23669,ACGTCGAATCTAGGGA,397,401,4,27,22755,0,0
23670,ACGTCGATTCTGGGGA,397,411,14,28,22759,3,0
23671,ACATCGAATCTAGGGA,397,409,12,31,22896,2,0
23672,ACGTCGAATCTAGGGA,397,401,4,27,22909,0,0
23673,ACGTCGATTCTGGGGA,397,402,5,27,22911,0,0
23674,ACGTCGAATCTAGGGA,397,422,25,23,22912,6,0
23675,ACGTCGAATCTAGGGT,397,406,9,24,22914,1,0
23676,ACGTCGAATCTTGGGA,397,397,0,27,22915,0,0
23677,ACGTCGAATCTAGGGA,397,408,11,33,22918,1,0
23678,ACGTCGAATCTAGGGA,397,400,3,33,22922,0,0
23679,ACATCGAATCTAGGGA,397,400,3,32,22924,0,0
23680,ACGTCGAATCTAGGGA,397,398,1,29,22931,0,0
23681,ACGTCGAATCTAGGGA,397,400,3,33,22932,0,0
23682,ACGTCGAATCTAGGGA,397,398,1,27,23074,0,0
23683,ACGTCGAATCTAGGGA,397,400,3,23,23076,0,0
23684,ACGTCGAATCTAGGGT,397,397,0,24,23078,0,0
23685,ACGTCGAATCTTGGGA,397,400,3,27,23079,0,0
23686,ACGTCGAATCTAGGGA,397,399,2,27,23082,0,0
23687,ACGTCGAATCTAGGGA,397,400,3,33,23083,0,0
23688,ACATCGAATCTAGGGA,397,400,3,32,23085,0,0
23689,ACGTCGAATCTAGGGA,397,400,3,29,23086,0,0
23690,ACGTCGAATCTAGGGA,397,400,3,31,23148,0,0
23691,TCGTCGAATCTAGGGA,397,400,3,27,23149,0,0
23692,ACGTCGAATCTAGGTA,397,400,3,28,23150,0,0
23693,ACGTCGAATCTAGGGA,397,400,3,28,23154,0,0
23694,ACGTCGAATCTAGGGA,397,399,2,31,23155,0,0
23695,ACGTCGAATCTAGGGA,397,397,0,32,23159,0,0
23696,ACGTCGAATCTAGGGA,397,400,3,34,23163,0,0
23697,TCGTCGAATCTAGGGA,397,400,3,29,23165,0,0
23698,ACGTCGAATCTAGGGA,397,400,3,28,23170,0,0
23699,ACGTCGATTCTGGGGA,397,400,3,29,23171,0,0
23700,ACGTCGAATCTAGGGA,397,400,3,30,23173,0,0
23701,ACGTCGAATCTAGGGA,397,400,3,30,23174,0,0
23702,ACGTCGATTCTGGGGA,397,398,1,27,23245,0,0
23703,ACGTCGAATCTAGGGA,397,399,2,33,23250,0,0
23704,ACGTCGAATCTAGGGA,397,400,3,33,23251,0,0
23705,ACGTCGAATCTAGGGA,397,400,3,28,23255,0,0
23706,ACGTCGAATCTAGGGA,397,400,3,33,23256,0,0
23707,ACCTCGATTCTGGGGA,397,400,3,28,23257,0,0
23708,ACGACGAATCTAGGGA,397,397,0,24,23259,0,0
23709,ACGTCGAATCTAGGGA,397,400,3,27,23263,0,0
23710,ACGTCGACTCTAGGGA,397,400,3,27,23264,0,0
23711,ACGTCGAGTCTAGGGA,397,400,3,33,23265,0,0
23712,ACGTCGAATCTAGGGA,397,397,0,32,23267,0,0
23713,ACGTCGAAAGCAGGGA,397,398,1,26,23271,0,0
23714,ACGTCGAATCTAGGGA,397,400,3,28,23272,0,0
23715,ACGTCGGAAGCACGGA,397,397,0,27,23273,0,0
23716,ACGTCGAATCTAGGGA,398,443,45,31,21612,5,0
23717,ACGTCGAATCTAGGGA,398,409,11,24,21620,2,0
23718,ACGTCGAATCTAGGGA,398,404,6,31,21770,0,0
23719,ACGTCGATTGTGGGGA,398,404,6,28,21972,0,0
23720,TCGTCGAATCTAGGGA,398,432,34,28,22115,5,0
23721,ACGTCGAATCTAGGGA,398,400,2,26,22252,0,0
23722,TCGTCGAATCTAGGGA,398,398,0,28,22286,0,0
23723,ACGTCGAATCTAGGGA,398,402,4,27,22289,0,0
23724,ACGTCGAAACTAGGGA,398,406,8,25,22298,1,0
23725,ACGTCGAATCTAGGGA,398,400,2,22,22449,0,0
23726,TCGTCGAATCTAGGGA,398,400,2,28,22452,0,0
23727,ACGTCGAATCTAGGGA,398,421,23,27,22455,5,0
23728,ACGTCGAATCTAGGGA,398,418,20,27,22458,5,0
23729,ACGTCGATTCTGGGGA,398,398,0,28,22464,0,0
23730,ACGTCGAAAGCAGGGA,398,413,15,25,22496,3,0
23731,ACGTCGAATCTAGGGA,398,398,0,27,22498,0,0
23732,ACGTCGAATCTAGGGA,398,426,28,29,22511,5,0
23733,ACGTCGAATCTAGGGA,398,398,0,26,22612,0,0
23734,ACGTCGAATCTAGGGA,398,401,3,28,22617,0,0
23735,TCGTCGAATCTAGGGA,398,407,9,28,22619,1,0
23736,ACGTCGAATCTAGGGA,398,401,3,27,22621,0,0
23737,ACGTCGAATCTAGGGT,398,403,5,25,22633,0,0
23738,ACGTCGAATCTAGGGT,398,418,20,24,22736,5,0
23739,ACGTCGAATCTTGGGA,398,406,8,27,22738,1,0
23740,ACGTCGAATCTAGGGA,398,415,17,25,22747,4,0
23741,ACGTCGAATCTAGGGA,398,410,12,27,22749,2,0
23742,ACGTCGAATCGAGGGA,398,410,12,28,22796,2,0
23743,ACGTCGAATCTAGGGA,398,407,9,28,22804,1,0
23744,ACGTCGAATCTAGGGA,398,404,6,28,22813,0,0
23745,TCGTCGAATCTAGGGA,398,412,14,27,22815,3,0
23746,ACGTCGAATCTAGGGA,398,403,5,28,22816,0,0
23747,ACGTCGATTCTGGGGA,398,407,9,27,22817,1,0
23748,ACGTCGAATCTAGGGA,398,408,10,28,22933,1,0
23749,ACGTCGAAGCTAGGGA,398,401,3,28,22947,0,0
23750,ACGTCGAATCTAGGGA,398,408,10,27,22948,1,0
23751,ACGTCGAATCTAGGGA,398,400,2,28,22957,0,0
23752,ACGTCGAATCTAGGGA,398,416,18,28,22958,4,0
23753,ACGTCGAATCTTGGGA,398,425,27,23,23063,5,0
23754,ACGTCGAATCTAGGGT,398,412,14,25,23065,3,0
23755,ACGTCGAATCTAGGGA,398,401,3,31,23066,0,0
23756,ACGTCGAATCTAGGGA,398,410,12,34,23069,2,0
23757,ACGTCGAATCTAGGGA,398,406,8,28,23073,1,0
23758,ACGTCGAATCTAGGGA,398,399,1,30,23087,0,0
23759,ACGTCGAATCGAGGGA,398,402,4,28,23123,0,0
23760,ACGTCGAATCTAGGGA,398,402,4,32,23126,0,0
23761,ACGTCGAATCTAGGGA,398,401,3,34,23131,0,0
23762,ACGTCGAATCTAGGGA,398,401,3,29,23132,0,0
23763,ACGTCGAATCTAGGGA,398,401,3,29,23139,0,0
23764,ACGTCGAATCTTGGGA,398,400,2,23,23141,0,0
23765,ACGTCGAATCTAGGGA,398,401,3,34,23142,0,0
23766,TCGTCGAATCTAGGGA,398,401,3,27,23144,0,0
23767,ACGTCGAATCTTGGGA,398,401,3,23,23145,0,0
23768,TCGTCGAATCTAGGGA,398,401,3,27,23146,0,0
23769,ACGTCGAATCTAGGGA,398,401,3,31,23147,0,0
23770,ACGTCGACTCTAGAGA,398,398,0,27,23296,0,0
23771,ACGTCGATTCTGGGGA,398,401,3,26,23297,0,0
23772,ACGTCGAAAGCAGGGA,398,401,3,25,23300,0,0
23773,ACGTCGAATCGAGGGA,398,401,3,28,23301,0,0
23774,ACGTCGAATCTTGGGA,399,414,15,26,21761,3,0
23775,ACGTCGAATCTAGGGA,399,399,0,27,22180,0,0
23776,ACGTCGAATCTAGGGA,399,408,9,27,22369,1,0
23777,ACGTCGAATCTAGGGA,399,417,18,28,22635,4,0
23778,ACGTCGAAAGCAGGGA,399,407,8,26,22705,1,0
23779,ACGTCGAATCTAGGGA,399,399,0,27,22713,0,0
23780,ACGTCGAATTTAGGGA,399,439,40,26,22847,5,0
23781,ACGTCGACTCTAGGGA,399,402,3,26,22848,0,0
23782,ACGTCGATTCTGGGGA,399,402,3,26,22849,0,0
23783,ACGTCGAATCTAGGGA,399,413,14,25,22864,3,0
23784,TCGTCGAATCTAGGGA,399,407,8,29,22865,1,0
23785,ACGTCGAATCTAGGGA,399,426,27,27,22867,5,0
23786,ACGTCGAATCTAGGGA,399,427,28,29,22870,5,0
23787,ACGTCGAATCTAGGGA,399,403,4,25,22882,0,0
23788,ACGTCGAATCTAGGGA,399,409,10,28,22888,1,0
23789,ACGTCGATTCTGGGGA,399,400,1,29,22892,0,0
23790,ACGTCGAGTCTAGGGA,399,401,2,32,23008,0,0
23791,ACGTCGATTGTGGGGA,399,400,1,29,23013,0,0
23792,ACGTCGAATCTAGGGA,399,419,20,25,23014,4,0
23793,ACGTCGAATCTAGGGA,399,402,3,27,23017,0,0
23794,ACGTCGAATCTAGGGA,399,402,3,25,23018,0,0
23795,ACGTCGAATCTAGGGA,399,402,3,28,23021,0,0
23796,ACGTCGATTGTGGGGA,399,402,3,27,23024,0,0
23797,ACGTCGACTCTAGAGA,399,402,3,28,23026,0,0
23798,ACGTCGAATCTAGGGA,399,402,3,23,23028,0,0
23799,TCGTCGAATCTAGGGA,399,399,0,29,23030,0,0
23800,ACGTCGATTGTGGGGA,399,402,3,29,23032,0,0
23801,ACGTCGATTCTGGGGA,399,402,3,29,23037,0,0
23802,ACATCGAATCTAGGGA,399,402,3,31,23038,0,0
23803,ACGTCGATTCTGGGGA,399,402,3,27,23049,0,0
23804,ACGTCGAATCTAGGGA,399,402,3,28,23060,0,0
23805,ACGTCGAGTCTAGGGA,399,400,1,32,23180,0,0
23806,ACGGCGAATCTAGGGA,399,402,3,29,23274,0,0
23807,ACGTCGAGTCTAGGGA,399,402,3,33,23279,0,0
23808,ACGTCGAATCTAGGGA,399,402,3,29,23281,0,0
23809,ACGTCGAACCTAGGGA,399,399,0,26,23283,0,0
23810,ACGTCGAATCTAGGGA,399,402,3,30,23286,0,0
23811,TCGTCGAATCTAGGGA,399,402,3,30,23287,0,0
23812,ACGTCGAATCTAGGGA,399,402,3,28,23290,0,0
23813,ACGTCGAATCTAGGGA,399,401,2,29,23292,0,0
23814,ACGTCGAATGTAGGGA,399,402,3,30,23295,0,0
23815,ACGTCGAGTCTAGGGA,399,402,3,32,23357,0,0
23816,ACGTCGAATCTAGGGA,399,399,0,32,23358,0,0
23817,ACGTCGAATCTAGGGA,399,400,1,32,23360,0,0
23818,ACGTCGAATCTAGGGA,399,402,3,27,23363,0,0
23819,ACGTCGATTCTGGGGA,400,427,27,25,20719,5,0
23820,ACGTCGAATCTAGGGA,400,400,0,31,21713,0,0
23821,ACGTCGACTCTAGGGA,400,409,9,28,21714,1,0
23822,ACGTCGAATCTAGGGA,400,405,5,33,21750,0,0
23823,ACGTCGAATCTAGGGA,400,406,6,28,21869,0,0
23824,ACGTCGAATCTAGGGA,400,403,3,27,22039,0,0
23825,ACGTCGAATCTAGGGA,400,412,12,33,22086,2,0
23826,TCGTCGAATCTAGGGA,400,400,0,26,22521,0,0
23827,ACGTCGAATCTAGGGA,400,434,34,27,22565,5,0
23828,ACGTCGAATCTAGGGT,400,401,1,24,22566,0,0
23829,ACGTCGAAAGTAGGGA,400,403,3,26,22581,0,0
23830,ACGTCGAATCTAGGGA,400,418,18,33,22602,4,0
23831,ACGTCGAATCTAGGGA,400,400,0,27,22755,0,0
23832,GCGTCGATTCTGGGGA,400,400,0,28,22759,0,0
23833,ACATCGAATCTAGGGA,400,414,14,31,22896,3,0
23834,ACGTCGAATCTAGGGA,400,419,19,27,22909,4,0
23835,ACGTCGATTCTGGGGA,400,413,13,27,22911,2,0
23836,ACGTCGAATCTAGGGA,400,406,6,23,22912,0,0
23837,ACGTCGAATCTAGGGT,400,423,23,24,22914,5,0
23838,ACGTCGAATCTTGGGA,400,411,11,27,22915,2,0
23839,ACGTCGAATCTAGGGA,400,401,1,33,22918,0,0
23840,ACGTCGAATCTAGGGA,400,408,8,33,22922,1,0
23841,ACATCGAATCTAGGGA,400,418,18,32,22924,4,0
23842,ACGTCGAATCTAGGGA,400,403,3,23,23076,0,0
23843,ACGTCGAATCTAGGGT,400,412,12,24,23078,2,0
23844,ACGTCGAATCTAGGGA,400,419,19,27,23082,4,0
23845,ACGTCGAATCTAGGGA,400,405,5,33,23083,0,0
23846,ACATCGAATCTAGGGA,400,401,1,32,23085,0,0
23847,ACGTCGAATCTAGGGA,400,410,10,29,23086,1,0
23848,ACGTCGAATCTAGGGA,400,413,13,31,23148,2,0
23849,TCGTCGAATCTAGGGA,400,409,9,27,23149,1,0
23850,ACGTCGAATCTAGGTA,400,406,6,28,23150,0,0
23851,ACGTCGAATCTAGGGA,400,401,1,28,23154,0,0
23852,ACGTCGAATCTAGGGA,400,406,6,32,23159,0,0
23853,TCGTCGAATCTAGGGA,400,402,2,29,23165,0,0
23854,ACGTCGAATCTAGGGA,400,406,6,28,23170,0,0
23855,ACGTCGATTCTGGGGA,400,400,0,29,23171,0,0
23856,ACGTCGAATCTAGGGA,400,405,5,30,23173,0,0
23857,ACGTCGAATCTAGGGA,400,408,8,30,23174,1,0
23858,ACGTCGAATCTAGGGA,400,403,3,33,23251,0,0
23859,ACGTCGAATCTAGGGA,400,402,2,28,23255,0,0
23860,ACGTCGAATCTAGGGA,400,417,17,33,23256,4,0
23861,ACCTCGATTCTGGGGA,400,400,0,28,23257,0,0
23862,ACGTCGAATCTAGGGA,400,401,1,24,23259,0,0
23863,ACGTCGAATCTAGGGA,400,403,3,27,23263,0,0
23864,ACGTCGACTCTAGGGA,400,420,20,27,23264,5,0
23865,ACGTCGAGTCTAGGGA,400,411,11,33,23265,2,0
23866,ACGTCAAATCTAGGGA,400,404,4,32,23267,0,0
23867,ACGTCGAAAGCACGGA,400,403,3,26,23271,0,0
23868,ACGTCGGAAGCACGGA,400,408,8,27,23273,1,0
23869,ACGTCGAATCTAGGGC,400,402,2,32,23304,0,0
23870,ACGTCGACTCTAGGGA,400,413,13,29,23305,2,0
23871,ACGTCGAATCTAGGGA,400,405,5,28,23309,0,0
23872,ACGTCGAATCTAGGGA,400,446,46,29,23312,5,0
23873,ACGTCGAATCTAGGGA,400,400,0,34,23314,0,0
23874,ACGTCGAATCTAGGGA,400,403,3,31,23318,0,0
23875,ACGTCGAATCTAGGGA,400,401,1,28,23320,0,0
23876,ACGTCGAATCTAGGGT,400,402,2,24,23419,0,0
23877,ACGTCGAATCTAGGGA,400,400,0,28,23423,0,0
23878,ACGTCGAATCTAGGGA,400,403,3,28,23425,0,0
23879,ACGTCGATTGTGGGGA,400,400,0,27,23427,0,0
23880,ACGTCGAATCTAGGGA,400,402,2,30,23430,0,0
23881,ACGTCGAAAGCAGGGA,400,403,3,27,23432,0,0
23882,ACGTCGAAAGCATGGA,400,403,3,26,23433,0,0
23883,ACGTCGAATCTAGGGA,400,403,3,28,23434,0,0
23884,ACGTCGGAAGCAGGGA,400,403,3,27,23435,0,0
23885,ACGTCGAATCTAGGGA,401,414,13,31,21612,2,0
23886,ACGTCGAATCTAGGGA,401,407,6,24,21620,0,0
23887,ACGTCGAATCTAGGGA,401,402,1,31,21770,0,0
23888,ACGTCGATTGTGGGGA,401,410,9,28,21972,1,0
23889,TCGTCGAATCTAGGGA,401,412,11,28,22115,2,0
23890,ACGTCGAATCTAGGGA,401,417,16,26,22252,3,0
23891,ACGTCGAATCTAGGGA,401,407,6,25,22298,0,0
23892,ACGTCGAATCTAGGGA,401,409,8,22,22449,1,0
23893,ACGTCGAATCTAGGGA,401,406,5,27,22458,0,0
23894,ACGTCGAAAGCAGGGA,401,402,1,25,22496,0,0
23895,ACGTCGAATCTAGGGA,401,404,3,29,22511,0,0
23896,TCGTCGAATCTAGGGA,401,402,1,28,22619,0,0
23897,ACGTCGAATCTAGGGT,401,417,16,25,22633,3,0
23898,ACGTCGAATCTAGGGT,401,410,9,24,22736,1,0
23899,ACGTCGAATCTTGGGA,401,404,3,27,22738,0,0
23900,ACGTCGAATCTAGGGA,401,404,3,25,22747,0,0
23901,ACGTCGAATCTAGGGA,401,404,3,27,22749,0,0
23902,ACGTCGAATCGAGGGA,401,404,3,28,22796,0,0
23903,ACGTCGAATCTAGGGA,401,404,3,28,22804,0,0
23904,ACGTCGAATCTAGGGA,401,404,3,28,22813,0,0
23905,TCGTCGAATCTAGGGA,401,404,3,27,22815,0,0
23906,ACGTCGAATCTAGGGA,401,402,1,28,22816,0,0
23907,ACGTCGATTCTGGGGA,401,403,2,27,22817,0,0
23908,ACGTCGAATCTAGGGA,401,401,0,28,22947,0,0
23909,ACGTCGAATCTAGGGA,401,404,3,27,22948,0,0
23910,ACGTCGAATCTAGGGA,401,404,3,28,22957,0,0
23911,ACGTCGAATCTAGGGT,401,404,3,25,23065,0,0
23912,ACGTCGAATCTAGGGA,401,404,3,34,23069,0,0
23913,ACGTCGAATCTAGGGA,401,401,0,28,23073,0,0
23914,ACGTCGAATCTAGGGA,401,402,1,30,23087,0,0
23915,ACGTCGAATCGAGGGA,401,404,3,28,23123,0,0
23916,ACGTCGAATCTAGGGA,401,404,3,32,23126,0,0
23917,ACGTCGAATCTAGGGA,401,404,3,29,23132,0,0
23918,ACGTCGAATCTTGGGA,401,403,2,23,23141,0,0
23919,ACGTCGAATCTAGGGA,401,404,3,34,23142,0,0
23920,TCGTCGAATCTAGGGA,401,404,3,27,23146,0,0
23921,ACGTCGAATCTAGGGA,401,404,3,31,23147,0,0
23922,ACGTCGACTCTAGAGA,401,404,3,27,23296,0,0
23923,ACGTCGATTCTGGGGA,401,401,0,26,23297,0,0
23924,ACGTCGAAAGCAGGGA,401,404,3,25,23300,0,0
23925,ACGTCGAATCGAGGGA,401,404,3,28,23301,0,0
23926,ACGTCGACTCTAGAGA,401,404,3,28,23369,0,0
23927,ACGTCGAATCTAGGGA,401,404,3,28,23372,0,0
23928,ACGTCGATTCTGGGGA,401,404,3,29,23374,0,0
23929,ACGTCGATTCTGGGGA,401,404,3,29,23375,0,0
23930,AAGTCGAAAGCAGGGA,401,401,0,26,23376,0,0
23931,ACGTCGAATCTAGGGA,401,404,3,30,23378,0,0
23932,GCGTAGAATCTAGGGA,401,404,3,30,23379,0,0
23933,ACGTCGAATCTAGGGA,401,403,2,27,23380,0,0
23934,ACGTCGAATCTAGGGA,401,404,3,25,23381,0,0
23935,TCGTCGAATCTAGGGA,401,404,3,29,23384,0,0
23936,TCGTCGAATCTAGGGA,401,404,3,27,23389,0,0
23937,ACGTCGAATCTAGGGA,401,404,3,31,23391,0,0
23938,ACGTCGCATCTAGGGA,401,404,3,26,23393,0,0
23939,ACGTCGACTCTAGAGA,401,404,3,27,23481,0,0
23940,ACGTCGAATCTAGGGA,401,404,3,28,23483,0,0
23941,ACGTCGAATCGAGGGA,401,401,0,28,23485,0,0
23942,ACGTCGAATCTAGGGA,401,404,3,29,23491,0,0
23943,ACGTCGAATGTAGGGA,401,401,0,28,23492,0,0
23944,ACGTCGAATCTAGGGA,401,404,3,28,23501,0,0
23945,ACGTCGAATCTAGGGA,401,403,2,31,23502,0,0
23946,ACGTCGAATCTAGGGA,401,403,2,28,23503,0,0
23947,ACGTCGAATCTAGGGT,401,402,1,25,23504,0,0
23948,ACGTCGAATCTAGGGA,401,404,3,32,23505,0,0
23949,ACGTCGAATCTTGGGA,402,408,6,26,21761,0,0
23950,ACGTCGAATCTAGGGA,402,402,0,27,22180,0,0
23951,ACGTCGAATCTAGGGA,402,406,4,27,22369,0,0
23952,ACGTCGAATCTAGGGA,402,407,5,28,22635,0,0
23953,ACGTCGAAAGCAGGGA,402,406,4,26,22705,0,0
23954,ACGTCGAATCTAGGGA,402,412,10,27,22713,1,0
23955,ACGTCGAATTTAGGGA,402,403,1,26,22847,0,0
23956,ACGTCGACTCTAGGGA,402,402,0,26,22848,0,0
23957,ACGTCGATTCTGGGGA,402,410,8,26,22849,1,0
23958,ACGTCGAATCTAGGGA,402,408,6,25,22864,0,0
23959,TCGTCGAATCTAGGGA,402,435,33,29,22865,4,0
23960,ACGTCGAATCTAGGGA,402,411,9,29,22870,1,0
23961,ACGTCGAATCTAGGGA,402,406,4,25,22882,0,0
23962,ACGTCGAATCTAGGGA,402,410,8,28,22888,1,0
23963,ACGTCGAATCTAGGGA,402,402,0,27,23017,0,0
23964,ACGTCGAATCTAGGGA,402,425,23,25,23018,4,0
23965,ACGTCGAATCTAGGGA,402,403,1,28,23021,0,0
23966,TCGTCGAATCTAGGGA,402,403,1,29,23030,0,0
23967,ACGTCGATTGTGGGGA,402,412,10,29,23032,1,0
23968,ACGTCGATTCTGGGGA,402,402,0,29,23037,0,0
23969,ACATCGAATCTAGGGA,402,426,24,31,23038,4,0
23970,ACGTCGATTCTGGGGA,402,405,3,27,23049,0,0
23971,ACGTCGAATCTAGGGA,402,406,4,28,23060,0,0
23972,ACGTCTAGTCTAGGGA,402,414,12,32,23180,2,0
23973,ACGTCGAATCTAGGGA,402,438,36,29,23274,4,0
23974,ACGTCGAGTCTAGGGA,402,403,1,33,23279,0,0
23975,ACGTCGAATCTAGGGA,402,408,6,29,23281,0,0
23976,ACGTCGAACCTAGGGA,402,408,6,26,23283,0,0
23977,TCGTCGAATCTAGGGA,402,405,3,30,23287,0,0
23978,ACGTCGAATCTAGGGA,402,415,13,29,23292,2,0
23979,ACGTCGAATGTAGGGA,402,416,14,30,23295,3,0
23980,ACGTCGAATCTAGGGA,402,428,26,32,23360,4,0
23981,ACGTCGAATCTAGGGA,402,404,2,27,23363,0,0
23982,ACGTCGAATCTAGGGA,402,420,18,30,23439,4,0
23983,ACGTCGATTGTGGGGA,402,416,14,30,23441,3,0
23984,TCGTCGAATCTAGGGA,402,420,18,30,23446,4,0
23985,ACGTCGAAAGCAGGGA,402,411,9,27,23447,1,0
23986,ACGTCGAATCAAGGGA,402,402,0,33,23507,0,0
23987,ACGTCGAATCTAGGGA,402,412,10,25,23536,1,0
23988,TCGTCGAATCTAGGGA,402,407,5,29,23541,0,0
23989,ACGTCGAATCTAGGGA,402,418,16,26,23543,3,0
23990,ACGTCGAATCTAGGGA,402,403,1,23,23545,0,0
23991,ACGTCGAATCTAGGGA,402,414,12,28,23547,1,0
23992,ACGTCGAAAGCAGGGA,402,417,15,26,23550,2,0
23993,ACGTCGATTCTGGGGA,402,405,3,26,23650,0,0
23994,ACGTCGAATCGAGGGA,402,404,2,28,23652,0,0
23995,ACGTCGAAAGCAGGGA,402,405,3,25,23653,0,0
23996,ACGTCGACTCTAGGGA,402,423,21,29,23655,3,0
23997,ACGTCGAATCTAGGGA,402,406,4,34,23659,0,0
23998,ACGTCGAATCTAGGGA,402,412,10,28,23661,1,0
23999,ACGTCGATTCTGGGGA,403,405,2,25,20719,0,0
24000,ACGTCGAATCTAGGGA,403,403,0,31,21713,0,0
24001,ACGTCGACTCTAGGGA,403,403,0,28,21714,0,0
24002,ACGTCGAATCTAGGGA,403,410,7,33,21750,0,0
24003,ACGTCGAATCTAGGGA,403,446,43,28,21869,4,0
24004,ACGTCGAATCTAGGGA,403,417,14,33,22086,3,0
24005,ACGTCGAATCTAGGGA,403,404,1,27,22565,0,0
24006,ACGTCGAATCTAGGGT,403,406,3,24,22566,0,0
24007,ACGTCGAATCTAGGGA,403,410,7,33,22602,0,0
24008,ACGTCGAATCTAGGGA,403,421,18,27,22755,4,0
24009,ACGTCGATTCTGGGGA,403,421,18,28,22759,4,0
24010,ACATCGAATCTAGGGA,403,410,7,31,22896,0,0
24011,ACGTCGAATCTAGGGA,403,417,14,27,22909,3,0
24012,ACGTCGAATCTAGGGA,403,411,8,23,22912,1,0
24013,ACGTCGAATCTTGGGA,403,405,2,27,22915,0,0
24014,ACGTCGAATCTAGGGA,403,403,0,33,22922,0,0
24015,ACGTCGAATCTAGGGA,403,408,5,23,23076,0,0
24016,ACGTCGAATCTAGGGT,403,417,14,24,23078,3,0
24017,ACGTCGAATCTAGGGA,403,414,11,27,23082,2,0
24018,ACGTCGAATCTAGGGA,403,404,1,33,23083,0,0
24019,ACATCGAATCTAGGGA,403,408,5,32,23085,0,0
24020,ACGTCGAATCTAGGGA,403,406,3,31,23148,0,0
24021,TCGTCGAATCTAGGGA,403,418,15,27,23149,3,0
24022,ACGTCGAATCTAGGGA,403,413,10,28,23154,1,0
24023,ACGTCGAATCTAGGGA,403,414,11,32,23159,1,0
24024,TCGTCGAATCTAGGGA,403,403,0,29,23165,0,0
24025,ACGTCGAATCTAGGGA,403,409,6,28,23170,0,0
24026,ACGTCGAATCTAGGGA,403,411,8,30,23174,0,0
24027,ACGTCGAATCTAGGGA,403,420,17,33,23251,3,0
24028,ACGTCGAATCTAGGGA,403,416,13,28,23255,2,0
24029,ACGTCGAATCTAGGGA,403,436,33,33,23256,3,0
24030,ACCTCGATTCTGGGGA,403,421,18,28,23257,3,0
24031,ACGTCGAATCTAGGGA,403,410,7,24,23259,0,0
24032,ACGTCGAATCTAGGGA,403,417,14,27,23263,2,0
24033,ACGTCGAGTCTAGGGA,403,403,0,33,23265,0,0
24034,ACGTCGAATCTAGGGA,403,407,4,32,23267,0,0
24035,ACGTCGAAAGCAGGGA,403,406,3,26,23271,0,0
24036,ACGTCGAATCTAGGGC,403,406,3,32,23304,0,0
24037,ACGTCGACTCTAGGGA,403,406,3,29,23305,0,0
24038,ACGTCGAATCTAGGGA,403,404,1,28,23309,0,0
24039,ACGTCGAATCTAGGGA,403,406,3,29,23312,0,0
24040,ACGTCGAATCTAGGGA,403,406,3,34,23314,0,0
24041,ACGTCGAATCTAGGGA,403,406,3,31,23318,0,0
24042,ACGTCGAATCTAGGGA,403,406,3,28,23320,0,0
24043,ACGTCGAATCTAGGGT,403,404,1,24,23419,0,0
24044,ACGTCGAATCTAGGGA,403,406,3,28,23425,0,0
24045,ACGTCGATTGTGGGGA,403,406,3,27,23427,0,0
24046,ACGTCGAATCTAGGGA,403,404,1,30,23430,0,0
24047,ACGTCGAAAGCGGGGA,403,406,3,27,23432,0,0
24048,ACGTCGAATCTAGGGA,403,406,3,28,23434,0,0
24049,ACGTCGGAAGCAGGGA,403,406,3,27,23435,0,0
24050,ACGTCGAATCTAGGGT,403,405,2,25,23519,0,0
24051,ACGTCGAATCTTGGGA,403,405,2,28,23520,0,0
24052,ACGTCGAATCTAGGGA,403,406,3,28,23607,0,0
24053,ACGTCGAATCTAGGGA,403,406,3,29,23609,0,0
24054,ACGTCGACTCTAGGGA,403,406,3,27,23610,0,0
24055,ACGTCGAATCTAGGGA,403,406,3,32,23612,0,0
24056,ACGTCGAAAGCAGGGA,403,406,3,26,23614,0,0
24057,ACGTCGAATCTAGGGA,403,406,3,28,23615,0,0
24058,ACGTCGAATCTAGGGA,403,406,3,26,23621,0,0
24059,ACGTCGAATCTAGGGA,403,406,3,29,23626,0,0
24060,ACGTCGAATCTAGGGA,403,406,3,27,23629,0,0
24061,GCGTCGATTGTGGGGA,403,406,3,30,23631,0,0
24062,ACGTCGAATCTAGGGA,403,406,3,26,23632,0,0
24063,ACGTCGAATCTAGGGA,403,406,3,29,23635,0,0
24064,ACGTCGATTCTCGGGA,403,406,3,30,23642,0,0
24065,ACATCGAATCTAGGGA,403,405,2,32,23643,0,0
24066,ACGTCGAATGTAGGGA,403,406,3,32,23644,0,0
24067,ACGTCGATTCTGGGGA,403,406,3,28,23645,0,0
24068,ACGTCGAATCTAGGGA,403,404,1,29,23646,0,0
24069,ACGTCGAATCTAGGGA,404,413,9,31,21612,1,0
24070,ACGTCGAATCTAGGGA,404,429,25,24,21620,3,0
24071,ACGTCGAATCTAGGGA,404,404,0,31,21770,0,0
24072,TCGTCGAATCTAGGGA,404,407,3,28,22115,0,0
24073,ACGTCGAATCTAGGGA,404,421,17,22,22449,3,0
24074,ACGTCGAATCTAGGGA,404,426,22,29,22511,3,0
24075,ACGTCGAATCTAGGGT,404,416,12,25,22633,2,0
24076,ACGTCGAATCTTGGGA,404,433,29,27,22738,3,0
24077,ACGTCGAATCTAGGGA,404,408,4,25,22747,0,0
24078,ACGTCGAATCTAGGGA,404,417,13,27,22749,2,0
24079,ACGTCGAATCGAGGGA,404,422,18,28,22796,3,0
24080,ACGTCGAATCTAGGGA,404,424,20,28,22804,3,0
24081,TCGTCGAATCTAGGGA,404,407,3,27,22815,0,0
24082,ACGTCGATTCTGGGGA,404,408,4,27,22817,0,0
24083,ACGTCGAATCTAGGGA,404,412,8,28,22947,1,0
24084,ACGTCGGATCTAGGGT,404,444,40,25,23065,3,0
24085,ACGTCGAATCTAGGGA,404,404,0,28,23073,0,0
24086,ACGTCGAATCGAGGGA,404,405,1,28,23123,0,0
24087,ACGTCGAATCTAGGGA,404,409,5,29,23132,0,0
24088,ACGTCGAATCTAGGGA,404,416,12,34,23142,2,0
24089,TCGTCGAATCTAGGGA,404,428,24,27,23146,3,0
24090,ACGTCGACTCTAGAGA,404,404,0,27,23296,0,0
24091,ACGTCGATTCTGGGGA,404,411,7,26,23297,0,0
24092,ACGTCGAAAGCAGGGA,404,409,5,25,23300,0,0
24093,ACGTCGAATCGAGGGA,404,452,48,28,23301,3,0
24094,ACGTCGACTCTAGAGA,404,405,1,28,23369,0,0
24095,ACGTCGATTCTGGGGA,404,417,13,29,23374,2,0
24096,ACGTCGATTCTGGGGA,404,419,15,29,23375,2,0
24097,ACGTAGAATCTAGGGA,404,406,2,30,23379,0,0
24098,ACGTCGAATCTAGGGA,404,416,12,27,23380,1,0
24099,ACGTCGAATCTAGGGA,404,406,2,25,23381,0,0
24100,TCGTCGAATCTAGGGA,404,447,43,29,23384,3,0
24101,TCGTCGAATCTAGGGA,404,406,2,27,23389,0,0
24102,ACGTCGAATCTAGGGA,404,411,7,31,23391,0,0
24103,ACGTCGAATCTAGGGA,404,408,4,26,23393,0,0
24104,ACGTCGACTCTAGAGA,404,411,7,27,23481,0,0
24105,ACGTCGAATCTAGGGA,404,406,2,28,23483,0,0
24106,ACGTCGAATCTAGGGA,404,421,17,29,23491,3,0
24107,ACGTCGAATGTAGGGA,404,419,15,28,23492,2,0
24108,ACGTCGAATCTAGGGA,404,404,0,28,23501,0,0
24109,ACGTCGAATCTAGGGA,404,426,22,31,23502,3,0
24110,ACGTCGAATCTAGGGA,404,413,9,28,23503,0,0
24111,ACGTCGAATCTAGGGT,404,413,9,25,23504,0,0
24112,ACGTCGAATCTAGGGA,404,406,2,28,23662,0,0
24113,ACGTCGAATCTAGGGT,404,407,3,25,23663,0,0
24114,ACGTCGAATCTAGGGA,404,409,5,32,23664,0,0
24115,ACGTCGAAAGTAGGGA,404,420,16,27,23665,3,0
24116,ACGTCGATTCTGGGGA,404,412,8,29,23670,0,0
24117,ACATCGAATCTAGGGA,404,405,1,32,23671,0,0
24118,ACGTCGAATCTAGGGA,404,408,4,24,23674,0,0
24119,ACGTCGAATCTAGGGT,404,407,3,25,23675,0,0
24120,ACGTCGAATCTTGGGA,405,445,40,26,21761,3,0
24121,ACGCCGAATCTAGGGA,405,438,33,27,22180,3,0
24122,ACGTCGAATCTAGGGA,405,408,3,27,22369,0,0
24123,ACGTCGAAGCTAGGGA,405,408,3,28,22635,0,0
24124,ACGTCGAAAGCAGGGA,405,408,3,26,22705,0,0
24125,ACGTCGAATTTAGGGA,405,406,1,26,22847,0,0
24126,ACGTCGACTCTAGGGA,405,408,3,26,22848,0,0
24127,ACGTCGATTCTGGGGA,405,408,3,26,22849,0,0
24128,ACGTCGAATCTAGGGA,405,408,3,25,22864,0,0
24129,TCGTCGAATCTAGGGA,405,408,3,29,22865,0,0
24130,ACGTCGAATCTAGGGA,405,408,3,25,22882,0,0
24131,ACGTCGAATCTAGGGA,405,408,3,28,22888,0,0
24132,ACGTCGAATCTAGGGA,405,408,3,27,23017,0,0
24133,ACGTCGAATCTAGGGA,405,408,3,25,23018,0,0
24134,ACGTCGAATCTAGGGA,405,408,3,28,23021,0,0
24135,TCGTCGAATCTAGGGA,405,408,3,29,23030,0,0
24136,ACGTCGATTGTGGGGA,405,406,1,29,23032,0,0
24137,ACATCGAATCTAGGGA,405,408,3,31,23038,0,0
24138,ACGTCGAATCTAGGGA,405,408,3,28,23060,0,0
24139,ACGTCGAGTCTAGGGA,405,405,0,32,23180,0,0
24140,ACGTCGAATCTAGGGA,405,408,3,29,23274,0,0
24141,ACGTCGAATCTAGGGA,405,408,3,29,23281,0,0
24142,ACGTCGAACCTAGGGA,405,408,3,26,23283,0,0
24143,TCGTCGAATCTAGGGA,405,408,3,30,23287,0,0
24144,ACGTCGAATCTAGGGA,405,408,3,29,23292,0,0
24145,ACGTCGAATGTAGGGA,405,405,0,30,23295,0,0
24146,ACGTCGAATCTAGGGA,405,408,3,32,23360,0,0
24147,ACGTCGAATCTAGGGA,405,408,3,27,23363,0,0
24148,ACGTCGAATCTAGGGA,405,408,3,30,23439,0,0
24149,ACGTCGATTGTGGGGA,405,406,1,30,23441,0,0
24150,ACGTCGAAAGCAGGGA,405,408,3,27,23447,0,0
24151,ACGTCGAATCTAGGGA,405,408,3,25,23536,0,0
24152,TCGTCGAATCTAGGGA,405,408,3,29,23541,0,0
24153,ACGTCGAATCTAGGGA,405,408,3,26,23543,0,0
24154,ACGTCGAATCTAGGGA,405,408,3,23,23545,0,0
24155,ACGTCGAATCTAGGGA,405,406,1,28,23547,0,0
24156,ACGTCGAATCGAGGGA,405,406,1,28,23652,0,0
24157,ACGTCGAAAGCAGGGA,405,408,3,25,23653,0,0
24158,ACGTCGACTCTAGGGA,405,408,3,29,23655,0,0
24159,ACGTCGAATCTAGGGA,405,407,2,34,23659,0,0
24160,ACGTCGAATCTAGGGA,405,408,3,28,23661,0,0
24161,ACGTCGAATCTAGGGA,405,408,3,34,23677,0,0
24162,ACGTCGAATCAAGGGA,405,408,3,32,23716,0,0
24163,ACGTCGAATCTAGGGA,405,408,3,25,23717,0,0
24164,TCGTCGAATCTAGGGA,405,407,2,29,23720,0,0
24165,ACGTCGAAACTAGGGA,405,408,3,26,23724,0,0
24166,ACGTCGAATCTAGGGA,405,408,3,28,23727,0,0
24167,ACGTCGAATCTAGGGA,405,408,3,28,23728,0,0
24168,ACGTCGAAAGCAGGGA,405,408,3,26,23730,0,0
24169,ACGTCGAATCTAGGGA,405,408,3,30,23732,0,0
24170,TCGTCGAATCTAGGGA,405,405,0,29,23735,0,0
24171,ACGTCGAATCTAGGGT,405,408,3,25,23738,0,0
24172,ACGTCGAATCTTGGGA,405,408,3,28,23739,0,0
24173,ACGTCGAATCTACGGA,405,408,3,26,23740,0,0
24174,ACGTCGAATCTAGGGA,405,408,3,28,23741,0,0
24175,ACGTCGAATCGAGGGA,405,405,0,29,23742,0,0
24176,ACGTCGAATCTAGGGA,405,408,3,29,23743,0,0
24177,TCGTCGAATCTAGGGA,405,406,1,28,23745,0,0
24178,ACGTCGATTCTGGGGA,405,408,3,28,23747,0,0
24179,ACGTCGAATCTAGGGA,405,408,3,29,23748,0,0
24180,ACGTCGAATCTAGGGA,405,408,3,28,23750,0,0
24181,ACGTCGAATCTAGGGA,405,408,3,29,23752,0,0
24182,ACGTCGAATCTTGGGA,405,408,3,24,23753,0,0
24183,ACGTCGAATCTAGGGT,405,408,3,26,23754,0,0
24184,ACGTCGAATCTAGGGA,405,408,3,35,23756,0,0
24185,ACGTCGAATCTAGGGA,405,408,3,29,23757,0,0
24186,ACGTCGATTCTGGGGA,406,424,18,25,20719,3,0
24187,ACGTCGAATCTAGGGA,406,420,14,31,21713,3,0
24188,ACGTCGACTCTAGGGA,406,412,6,28,21714,0,0
24189,ACGTCGAATCTAGGGA,406,417,11,33,21750,2,0
24190,ACGTCGAATCTAGGGA,406,408,2,33,22086,0,0
24191,ACGTCGAATCTAGGGA,406,414,8,27,22565,1,0
24192,ACGTCGAATCTAGGGA,406,410,4,33,22602,0,0
24193,ACGTCGAATCTAGGGA,406,421,15,27,22755,3,0
24194,ACGTCGATTCTGGGGA,406,426,20,28,22759,3,0
24195,ACATCGGATCTAGGGA,406,409,3,31,22896,0,0
24196,ACGTCGAATCTAGGGA,406,411,5,27,22909,0,0
24197,ACGTCGAATCTAGGGA,406,411,5,23,23076,0,0
24198,ACGTCGAATCTAGGGT,406,416,10,24,23078,1,0
24199,ACGTCGAAGCTAGGGA,406,426,20,27,23082,3,0
24200,ACGTCGAATCTAGGGA,406,409,3,33,23083,0,0
24201,ACATCGAACCTAGGGA,406,417,11,32,23085,2,0
24202,TCGTCGAATCTAGGGA,406,415,9,27,23149,1,0
24203,ACGTCGAATCTAGGGA,406,407,1,28,23154,0,0
24204,TCGTCGAATCTAGGGA,406,409,3,29,23165,0,0
24205,ACGTCGAATCTAGGGA,406,411,5,28,23170,0,0
24206,ACGTCGAATCTAGGGA,406,407,1,28,23255,0,0
24207,ACCTCGATTCTGGGGA,406,417,11,28,23257,2,0
24208,ACGTCGAATCTAGGGA,406,412,6,24,23259,0,0
24209,ACGTCGAATCTAGGGA,406,410,4,27,23263,0,0
24210,ACGTCGAGTCTAGGGA,406,408,2,33,23265,0,0
24211,ACGTCGAAAGCAGGGA,406,413,7,26,23271,0,0
24212,ACGTCGAATCTAGGGC,406,410,4,32,23304,0,0
24213,ACGTCGACTCTAGGGA,406,410,4,29,23305,0,0
24214,ACGTCGAATCTAGGGA,406,417,11,28,23309,2,0
24215,ACGTCGAATCTAGGGA,406,406,0,29,23312,0,0
24216,ACGTCGAATCTAGGGA,406,426,20,34,23314,3,0
24217,ACGTCGAATCTAGGGA,406,410,4,28,23320,0,0
24218,ACGTCGAATCTAGGGA,406,413,7,28,23425,0,0
24219,ACGTCGATTGTGGGGA,406,406,0,27,23427,0,0
24220,ACGTCGAATCTAGGGA,406,410,4,30,23430,0,0
24221,ACGACGAAAGCAGGGA,406,406,0,27,23432,0,0
24222,ACGTCGGAAGCAGGGA,406,409,3,27,23435,0,0
24223,ACGTCGAATCTAGGGT,406,410,4,25,23519,0,0
24224,ACGTCGAATCTAGGGA,406,417,11,29,23609,2,0
24225,ACGTCGACTCTAGGGA,406,408,2,27,23610,0,0
24226,ACGTCGAATCTAGGGA,406,408,2,32,23612,0,0
24227,ACGTCGAAAGCAGGGA,406,406,0,26,23614,0,0
24228,ACGTCGAATCTAGGGA,406,417,11,28,23615,2,0
24229,ACGTCGAATCTAGGGA,406,423,17,26,23621,2,0
24230,ACGTCGAATCTAGGGA,406,415,9,29,23626,0,0
24231,ACGTCGAATCTAGGGA,406,417,11,27,23629,1,0
24232,GCGTCGATTGTGGGGA,406,409,3,30,23631,0,0
24233,ACGTCGAATCTAGGGA,406,418,12,26,23632,1,0
24234,ACGTCGAATCTAGGGA,406,435,29,29,23635,2,0
24235,ACGTCGATTCTGGGGA,406,407,1,30,23642,0,0
24236,ACATCGAATCTAGGGA,406,409,3,32,23643,0,0
24237,ACGTCGAATGTAGGGA,406,416,10,32,23644,1,0
24238,ACGTCGATTCTGGGGA,406,439,33,28,23645,2,0
24239,ACGTCGAATCTAGGGA,406,431,25,29,23646,2,0
24240,ACGTCGAATCTTGGGA,406,449,43,27,23774,2,0
24241,ACGTCGAATCTAGGGA,406,412,6,28,23776,0,0
24242,ACGTCGAATCTAGGGA,406,410,4,29,23777,0,0
24243,ACGTCGAAAGCAGGGA,406,415,9,27,23778,0,0
24244,ACGTCGAATTTAGGGA,406,410,4,27,23780,0,0
24245,ACGTCGAATCTAGGGA,406,437,31,26,23783,2,0
24246,TCGTCGAATCTAGGGA,406,409,3,30,23784,0,0
24247,ACGTCGAATCTAGGGA,406,409,3,28,23785,0,0
24248,ACGTCGAATCTAGGGA,406,410,4,30,23786,0,0
24249,ACGTCGAATCTAGGGA,406,407,1,29,23788,0,0
24250,ACGTCGAATCTAGGGA,407,414,7,31,21612,0,0
24251,ACGTCGAATCTAGGGA,407,407,0,24,21620,0,0
24252,TCGTCGAATCTAGGGA,407,424,17,28,22115,2,0
24253,ACGTCGAATCTAGGGA,407,413,6,22,22449,0,0
24254,ACGTCGAATCTAGGGA,407,408,1,29,22511,0,0
24255,ACGTCGAATCTAGGGT,407,415,8,25,22633,1,0
24256,ACGTCGAATCTAGGGA,407,412,5,25,22747,0,0
24257,ACGTCGAATCTAGGGA,407,409,2,27,22749,0,0
24258,ACGTCGAATCGAGGGA,407,421,14,28,22796,2,0
24259,ACGTCGAATCTAGGGA,407,409,2,28,22804,0,0
24260,TCGTCGAATCTAGGGA,407,420,13,27,22815,2,0
24261,ACGTCGATTCTGGGGA,407,410,3,27,22817,0,0
24262,ACGTCGAATCTAGGGA,407,434,27,28,22947,2,0
24263,ACGTCGAATCTAGGGT,407,407,0,25,23065,0,0
24264,ACGTCGAATCTAGGGA,407,430,23,28,23073,2,0
24265,ACGTCGAATCGAGGGA,407,426,19,28,23123,2,0
24266,ACGTCGAATCTAGGGA,407,408,1,34,23142,0,0
24267,TCGTCGAATCTAGGGA,407,421,14,27,23146,2,0
24268,ACGTCGATTCTGGGGA,407,407,0,26,23297,0,0
24269,ACGTCGAAAGCAGGGA,407,408,1,25,23300,0,0
24270,ACGTCGAATCGAGGGA,407,407,0,28,23301,0,0
24271,ACGTCGACTCTAGAGT,407,425,18,28,23369,2,0
24272,ACGTCGATTCTGGGGA,407,410,3,29,23374,0,0
24273,ACGTCGATTCTGGGGA,407,422,15,29,23375,2,0
24274,ACGTAGAATCTAGGGA,407,407,0,30,23379,0,0
24275,ACGTCGAATCTAGGGA,407,410,3,27,23380,0,0
24276,ACGTCGAATCTAGGGA,407,416,9,25,23381,1,0
24277,TCGTCGAATCTAGGGA,407,408,1,29,23384,0,0
24278,ACGTCGAATCTAGGGA,407,416,9,26,23393,1,0
24279,ACGTCGACTCTAGAGA,407,418,11,27,23481,2,0
24280,ACGTCGAATCTAGGGA,407,417,10,28,23483,1,0
24281,ACGTCGAATCTAGGGA,407,408,1,29,23491,0,0
24282,ACGTCGAATGTAGGGA,407,408,1,28,23492,0,0
24283,ACGTCGAATCTAGGGA,407,412,5,28,23501,0,0
24284,ACGTCGAATCTAGGGA,407,408,1,31,23502,0,0
24285,ACGTCGAATCTAGGGA,407,415,8,28,23503,1,0
24286,ACGTCGAATCTAGGGT,407,411,4,25,23504,0,0
24287,CCGTCGAATCTAGGGA,407,441,34,28,23662,2,0
24288,ACGTCGAATCTAGGGT,407,409,2,25,23663,0,0
24289,ACGTCGAATCTAGGGA,407,410,3,32,23664,0,0
24290,ACGTCGAAAGTAGGGA,407,407,0,27,23665,0,0
24291,ACGTCGATTCTGGGGA,407,428,21,29,23670,2,0
24292,ACATCGAATCTAGGGA,407,413,6,32,23671,0,0
24293,ACGTCGAATCTAGGGA,407,410,3,24,23674,0,0
24294,ACGTCGAATCTAGGGA,407,410,3,26,23792,0,0
24295,ACGTCGATTCTGGGGA,407,410,3,26,23819,0,0
24296,ACGTCGACTCTAGGGA,407,410,3,29,23821,0,0
24297,ACGTCGAATCTAGGGA,407,407,0,34,23825,0,0
24298,ACGTCGAATCTAGGGA,407,410,3,28,23827,0,0
24299,ACGTCGAATCTAGGGA,407,410,3,34,23830,0,0
24300,ACATCGAATCTAGGGA,407,409,2,32,23833,0,0
24301,ACGTCGAATCTAGGGA,407,407,0,28,23834,0,0
24302,ACGTCGATTCTGGGGA,407,410,3,28,23835,0,0
24303,ACGTCGAATCTAGGGT,407,407,0,25,23837,0,0
24304,ACGTCGAATCTTGGGA,407,410,3,28,23838,0,0
24305,ACGTCGAATCTAGGGA,407,409,2,34,23840,0,0
24306,ACATCGAATCTAGGGA,407,408,1,33,23841,0,0
24307,ACGTCGAATCTAGGGT,407,410,3,25,23843,0,0
24308,ACGTCGAATCTAGGGA,407,410,3,28,23844,0,0
24309,ACGTCGAATCTAGGGA,407,410,3,30,23847,0,0
24310,ACGTCGAATCTAGGGA,407,408,1,32,23848,0,0
24311,TCGTCGAATCTAGGGA,407,410,3,28,23849,0,0
24312,ACGTCGAATCTAGGGA,407,410,3,31,23857,0,0
24313,ACGTCGAATCTAGGGA,407,407,0,34,23860,0,0
24314,ACGTCGACTCTAGGGA,407,410,3,28,23864,0,0
24315,ACGTCGAGTCTAGGGA,407,407,0,34,23865,0,0
24316,ACGTCGGAAGCACGGA,407,410,3,28,23868,0,0
24317,ACGTCGACTCTAGGGA,407,410,3,30,23870,0,0
24318,ACGTCGAATCTAGGGA,407,408,1,30,23872,0,0
24319,ACGTCGAATCTAGGGA,408,409,1,27,22369,0,0
24320,ACGTCGAATCTAGGGA,408,421,13,28,22635,2,0
24321,ACGTCGAAAGCAGGGA,408,414,6,26,22705,0,0
24322,ACGTCGAATTTAGGGA,408,422,14,26,22847,2,0
24323,ACGTCGATTCTGGGGA,408,409,1,26,22849,0,0
24324,ACGTCGAATCTAGGGA,408,421,13,25,22864,2,0
24325,TCGTCGAATCTAGGGA,408,416,8,29,22865,1,0
24326,ACGTCGAATCTAGGGA,408,439,31,25,22882,2,0
24327,ACGTCGAATCTAGGGA,408,423,15,28,22888,2,0
24328,ACGTCGAATCTAGGGA,408,408,0,27,23017,0,0
24329,ACGTCGAATCTAGGGA,408,414,6,25,23018,0,0
24330,ACGTCGAATCTAGGGA,408,412,4,28,23021,0,0
24331,TCGTCGAATCTAGGGA,408,413,5,29,23030,0,0
24332,ACGTCGATTGTGGGGA,408,410,2,29,23032,0,0
24333,ACGTCGAATCTAGGGA,408,422,14,29,23274,2,0
24334,ACGTCGAATCTAGGGA,408,427,19,29,23292,2,0
24335,ACGTCGAATGTAGGGA,408,411,3,30,23295,0,0
24336,ACGTCGAATCTAGGGA,408,418,10,32,23360,1,0
24337,ACGTCGAATCTAGGGA,408,408,0,27,23363,0,0
24338,ACGTCGAATCTAGGGA,408,416,8,30,23439,1,0
24339,ACGTCGATTGTGGGGA,408,416,8,30,23441,1,0
24340,ACGTCGAAAGCAGGGA,408,415,7,27,23447,0,0
24341,ACGTCGAATCTAGGGA,408,418,10,25,23536,1,0
24342,TCGTCGAATCTAGGGA,408,419,11,29,23541,2,0
24343,ACGTCGAATCGAGGGA,408,413,5,28,23652,0,0
24344,ACGTCGAAAGCAGGGA,408,409,1,25,23653,0,0
24345,ACGTCGACTCTAGGGA,408,408,0,29,23655,0,0
24346,ACGTCGAATCTAGGGA,408,408,0,34,23659,0,0
24347,ACGTCGAATCTAGGGA,408,420,12,28,23661,2,0
24348,ACGTCGAATCTAGGGA,408,411,3,32,23716,0,0
24349,ACGTCGAATCTAGGGA,408,411,3,25,23717,0,0
24350,TCGTCGAATCTAGGGA,408,411,3,29,23720,0,0
24351,ACGTCGAATCTAGGGA,408,411,3,28,23727,0,0
24352,ACGTCGAATCTAGGGA,408,411,3,28,23728,0,0
24353,ACGTCGAAAGCAGGGA,408,411,3,26,23730,0,0
24354,ACGTCGAATCTAGGGA,408,411,3,30,23732,0,0
24355,ACGTCGAATCTAGGGT,408,408,0,25,23738,0,0
24356,ACGTCGAATCTAGGGA,408,409,1,26,23740,0,0
24357,ACGTCGAATCTAGGGA,408,408,0,28,23741,0,0
24358,ACGTCGAATCGAGGGA,408,411,3,29,23742,0,0
24359,TCGTCGAATCTAGGGA,408,411,3,28,23745,0,0
24360,ACGTCGAATCTAGGGA,408,411,3,29,23752,0,0
24361,ACGTCGAATCTTGGGA,408,409,1,24,23753,0,0
24362,ACGTCGAATCTAGGGT,408,411,3,26,23754,0,0
24363,ACGTCGAATCTAGGGA,408,411,3,35,23756,0,0
24364,ACGTCGAATCTAGGGA,408,411,3,32,23885,0,0
24365,ACGTCGATTGTGGGGA,408,411,3,29,23888,0,0
24366,TCGTCGAATCTAGGGA,408,411,3,29,23889,0,0
24367,ACGTCGAATCTAGGGA,408,411,3,27,23890,0,0
24368,ACGTCGAATCTAGGGA,408,411,3,23,23892,0,0
24369,ACGTCGAATCTAGGGT,408,408,0,26,23897,0,0
24370,ACGTCGAATCTAGGGT,408,411,3,25,23898,0,0
24371,ACGTCGATTCTGGGGG,409,413,4,25,20719,0,0
24372,ACGTCGAATCTAGGGA,409,412,3,31,21713,0,0
24373,ACGTCGACTCTAGGGA,409,410,1,28,21714,0,0
24374,ACGTCGAATCTAGGGA,409,420,11,33,22086,2,0
24375,ACGTCGAATCTAGGGA,409,418,9,27,22565,1,0
24376,ACGTCGAATCTAGGGA,409,422,13,27,22755,2,0
24377,ACGTCGATTCTGGGGA,409,420,11,28,22759,2,0
24378,ACGTCGAATCTAGGGA,409,417,8,27,22909,1,0
24379,ACGTCGAATCTAGGGT,409,420,11,24,23078,2,0
24380,ACGTCGAATCTAGGGA,409,426,17,27,23082,2,0
24381,ACGTCGAATCTAGGGA,409,416,7,33,23083,0,0
24382,TCGTCGAATCTAGGGA,409,415,6,27,23149,0,0
24383,ACGTCGAATCTAGGGA,409,412,3,28,23154,0,0
24384,TCGTCGAATCTAGGGA,409,412,3,29,23165,0,0
24385,ACGTCGAATCTAGGGA,409,411,2,28,23255,0,0
24386,ACCTCGATTCTGGGGA,409,419,10,28,23257,1,0
24387,ACGTCGAATCTAGGGA,409,418,9,27,23263,1,0
24388,ACGTCGAGTCTAGGGA,409,419,10,33,23265,1,0
24389,ACGTCGAAAGCAGGGA,409,413,4,26,23271,0,0
24390,ACGTCGAATCTAGGGC,409,415,6,32,23304,0,0
24391,ACGTCGACTCTAGGGA,409,418,9,29,23305,1,0
24392,ACGTCGAATCTAGGGA,409,412,3,34,23314,0,0
24393,ACGTCGAATCTAGGGA,409,422,13,28,23320,2,0
24394,ACGTCGAATCTAGGGA,409,429,20,28,23425,2,0
24395,ACGTCGATTGTGGGGA,409,415,6,27,23427,0,0
24396,ACGTCGAATCTAGGGA,409,415,6,30,23430,0,0
24397,ACGTCGAAAGCAGGGA,409,437,28,27,23432,2,0
24398,ACGTCGGAAGCAGGGA,409,409,0,27,23435,0,0
24399,ACGTCGAATCTAGGGA,409,433,24,29,23609,2,0
24400,ACGTCGACTCTAGGGA,409,411,2,27,23610,0,0
24401,ACGTCGAATCTAGGGA,409,410,1,32,23612,0,0
24402,ACGTCGAAAGCAGGGA,409,412,3,26,23614,0,0
24403,ACGTCGAATCTAGGGA,409,409,0,28,23615,0,0
24404,ACGTCGAATCTAGGGA,409,412,3,26,23621,0,0
24405,ACGTCGAATCTAGGGA,409,412,3,29,23626,0,0
24406,GCGTCGATTGTGGGGA,409,411,2,30,23631,0,0
24407,ACGTCGAATCTAGGGA,409,412,3,26,23632,0,0
24408,ACGTCGAATCTAGGGA,409,412,3,29,23635,0,0
24409,ACGTCGAATGTAGGGA,409,412,3,32,23644,0,0
24410,ACGTCGATTCTGGGGA,409,412,3,28,23645,0,0
24411,ACGTCGAATCTTGGGA,409,412,3,27,23774,0,0
24412,ACGTCGAATCTAGGGA,409,412,3,29,23777,0,0
24413,ACGTCGAATTTAGGGA,409,411,2,27,23780,0,0
24414,ACGTCGAATCTAGGGA,409,412,3,26,23783,0,0
24415,ACGTCGAATCTAGGGA,409,412,3,28,23785,0,0
24416,ACGTCGAATCTAGGGA,409,409,0,30,23786,0,0
24417,ACGTCGAATCTAGGGA,409,412,3,28,23954,0,0
24418,ACGTCGATTCTGGGGA,409,412,3,27,23957,0,0
24419,TCGTCGAATCTAGGGA,409,412,3,30,23959,0,0
24420,ACGTCGAATCTAGGGA,409,411,2,30,23960,0,0
24421,ACGTCGAATCTAGGGA,409,409,0,29,23962,0,0
24422,ACGTCGAATCTAGGGA,409,412,3,26,23964,0,0
24423,ACGTCGATTGTGGGGA,409,412,3,30,23967,0,0
24424,ACATCGAATCTAGGGA,409,409,0,32,23969,0,0
24425,ACGTCTAGTCTAGGGA,409,412,3,33,23972,0,0
24426,ACGTCGAATCTAGGGA,409,411,2,30,23973,0,0
24427,ACGTCGAATCTAGGGA,409,412,3,30,23978,0,0
24428,ACGTCGAATGTAGGGA,409,412,3,31,23979,0,0
24429,ACGTCGAATCTAGGGA,409,412,3,33,23980,0,0
24430,ACGTCGAATCTAGGGA,409,412,3,31,23982,0,0
24431,ACGTCGATTGTGGGGA,409,412,3,31,23983,0,0
24432,TCGTCGAATCTAGGGA,409,412,3,31,23984,0,0
24433,ACGTCGAAAGCAGGGA,409,412,3,28,23985,0,0
24434,ACGTCGAATCTAGGGA,410,430,20,31,21612,1,0
24435,ACGTCGAATCTAGGGA,410,413,3,22,22449,0,0
24436,ACGTCGAATCTAGGGA,410,416,6,29,22511,0,0
24437,ACGTCGAATCTAGGGA,410,435,25,25,22747,1,0
24438,ACGTCGAATCTAGGGA,410,420,10,27,22749,1,0
24439,ACGTCGAATCTAGGGA,410,413,3,28,22804,0,0
24440,ACGTCGATTCTGGGGA,410,430,20,27,22817,1,0
24441,ACGTCGAATCTAGGGT,410,419,9,25,23065,1,0
24442,ACGTCGAATCTAGGGA,410,433,23,28,23073,1,0
24443,ACGTCGAATCGAGGGA,410,418,8,28,23123,1,0
24444,ACGTCGAATCTAGGGA,410,424,14,34,23142,1,0
24445,ACGTCGATTCTGGGGA,410,428,18,26,23297,1,0
24446,ACGTCGAAAGCAGGGA,410,411,1,25,23300,0,0
24447,ACGTCGAATCGAGGGA,410,422,12,28,23301,1,0
24448,ACGTCGACTCTAGAGA,410,415,5,28,23369,0,0
24449,ACGTCGATTCTGGGGA,410,428,18,29,23374,1,0
24450,ACGTCGATTCTGGGGA,410,415,5,29,23375,0,0
24451,ACGTAGAATCTAGGGA,410,413,3,30,23379,0,0
24452,ACGTCGAATCTAGGGA,410,410,0,27,23380,0,0
24453,ACGTCGAATCTAGGGA,410,421,11,26,23393,1,0
24454,ACGTCGACTCTAGAGA,410,413,3,27,23481,0,0
24455,ACGTCGAATCTAGGGA,410,432,22,28,23483,1,0
24456,ACGTCGAATCTAGGGA,410,426,16,29,23491,1,0
24457,ACGTCGAATCTAGGGA,410,412,2,28,23501,0,0
24458,ACGTCGAATCTAGGGA,410,429,19,31,23502,1,0
24459,ACGTCGAATCTAGGGT,410,421,11,25,23504,1,0
24460,ACGTCGAATCTAGGGA,410,448,38,28,23662,1,0
24461,ACGTCGATTCTGGGGA,410,425,15,29,23670,1,0
24462,ACGTCGAATCTAGGGA,410,420,10,24,23674,1,0
24463,ACGTCGAATCTAGGGA,410,411,1,26,23792,0,0
24464,ACGTCGATTCTGGGGA,410,410,0,26,23819,0,0
24465,ACGTCGAATCTAGGGA,410,439,29,34,23825,1,0
24466,ACGTCGAATCTAGGGA,410,419,9,28,23827,1,0
24467,ACGTCGAATCTAGGGA,410,419,9,34,23830,1,0
24468,ACATCGAATCTAGGGA,410,410,0,32,23833,0,0
24469,ACGTCGAATCTAGGGA,410,412,2,28,23834,0,0
24470,ACTTCGATTCTGGGGA,410,411,1,28,23835,0,0
24471,ACGTCGAATCTAGGGT,410,411,1,25,23837,0,0
24472,ACGTCGAATCTTGGGA,410,416,6,28,23838,0,0
24473,ACATCGAATCTAGGGA,410,417,7,33,23841,0,0
24474,ACGTCGAATCTAGGGT,410,423,13,25,23843,1,0
24475,ACGTCGAATCTAGGGA,410,446,36,28,23844,1,0
24476,ACGTCGAATCTAGGGA,410,411,1,32,23848,0,0
24477,ACGTCGAATCTAGGGA,410,412,2,34,23860,0,0
24478,ACGTCGACTCTAGGGA,410,421,11,28,23864,1,0
24479,ACGTCGAGTCTAGGGA,410,411,1,34,23865,0,0
24480,ACGTCGACTCTAGGGA,410,410,0,30,23870,0,0
24481,ACGTCGAATCTAGGGA,410,422,12,30,23872,1,0
24482,ACGTCGAATCTAGGGA,410,414,4,29,24003,0,0
24483,ACGTCGAATCTAGGGA,410,422,12,34,24004,1,0
24484,ACGTCGAATCTAGGGA,410,411,1,28,24008,0,0
24485,ACGTCGATTCTGGGGA,410,413,3,29,24009,0,0
24486,ACGTCGAATCTAGGGA,410,414,4,28,24011,0,0
24487,ACGTCGAATCTAGGGA,410,413,3,24,24012,0,0
24488,ACGTCGAATCTAGGGT,410,413,3,25,24016,0,0
24489,ACGTCGAATCTAGGGA,410,413,3,28,24017,0,0
24490,TCGTCGAATCTAGGGA,410,413,3,28,24021,0,0
24491,ACGTCGAATCTAGGGA,411,415,4,27,22369,0,0
24492,ACGTCGAATCTAGGGA,411,418,7,28,22635,0,0
24493,ACGTCGAAAGCAGGGA,411,413,2,26,22705,0,0
24494,ACGTCGAATTTAGGGA,411,427,16,26,22847,1,0
24495,ACGTCGATTCTGGGGA,411,416,5,26,22849,0,0
24496,ACGTCGAATCTAGGGA,411,412,1,25,22882,0,0
24497,ACGTCGAATCTAGGGA,411,413,2,25,23018,0,0
24498,TCGTCGAATCTAGGGA,411,424,13,29,23030,1,0
24499,ACGTCGAATCTAGGGA,411,416,5,29,23274,0,0
24500,ACGTCGATTGTGGGGA,411,414,3,30,23441,0,0
24501,ACGTCGAAAGCAGGGA,411,414,3,27,23447,0,0
24502,ACGTCGAATCTAGGGA,411,414,3,25,23536,0,0
24503,TCGTCGAATCTAGGGA,411,412,1,29,23541,0,0
24504,ACGTCGAATCTAGGGA,411,414,3,34,23659,0,0
24505,ACGTCGAATCTAGGGA,411,414,3,32,23716,0,0
24506,TCGTCGAATCTAGGGA,411,414,3,29,23720,0,0
24507,ACGTCGAATCTAGGGT,411,414,3,28,23727,0,0
24508,ACGTCGAATCTAGGGA,411,414,3,28,23728,0,0
24509,ACGTCGAAAGCAGGGA,411,414,3,26,23730,0,0
24510,ACGTCGAATCTAGGGA,411,414,3,30,23732,0,0
24511,ACGTCGAATCTAGGGT,411,414,3,25,23738,0,0
24512,ACGTCGAATCTAGGGA,411,414,3,26,23740,0,0
24513,TCGTCGAATCTAGGGA,411,414,3,28,23745,0,0
24514,ACGTCGAATCTAGGGA,411,414,3,29,23752,0,0
24515,ACGTCGAATCTTGGGA,411,413,2,24,23753,0,0
24516,ACGTCGGATCTAGGGT,411,414,3,26,23754,0,0
24517,ACGTCGAATCTAGGGA,411,414,3,32,23885,0,0
24518,TCGTCGAATCTAGGGA,411,414,3,29,23889,0,0
24519,ACGTCGAATCTAGGGA,411,414,3,27,23890,0,0
24520,ACGTCGAATCTAGGGT,411,414,3,26,23897,0,0
24521,ACGTCGAATCTAGGGA,411,414,3,26,23987,0,0
24522,ACGTCGAATCTAGGGA,411,414,3,27,23989,0,0
24523,ACGTCGAATCTAGGGA,411,412,1,29,23991,0,0
24524,ACGTCGAAAGCAGGGA,411,412,1,27,23992,0,0
24525,ACGTCGACTCTAGGGA,411,414,3,30,23996,0,0
24526,ACGTCGAATCTAGGGA,411,414,3,29,23998,0,0
24527,ACGTCGAATCTAGGGA,411,411,0,32,24069,0,0
24528,ACGTCGAATCTAGGGA,411,414,3,25,24070,0,0
24529,ACGTCGAATCTAGGGA,411,414,3,23,24073,0,0
24530,ACGTCGAATCTAGGGA,411,412,1,30,24074,0,0
24531,ACGTCGAATCTAGGGT,411,414,3,26,24075,0,0
24532,ACGTCGAATCTTGGGA,411,414,3,28,24076,0,0
24533,ACGTCGAATCTAGGGA,411,414,3,28,24078,0,0
24534,ACGTCGAATCGAGGGA,411,414,3,29,24079,0,0
24535,ACGTCGAATCTAGGGA,411,414,3,29,24080,0,0
24536,ACGTCGAATCTAGGGA,411,413,2,29,24083,0,0
24537,ACGTCGGATCTAGGGT,411,414,3,26,24084,0,0
24538,ACGTCGAATCTAGGGA,411,414,3,35,24088,0,0
24539,TCGTCGAATCTAGGGA,411,411,0,28,24089,0,0
24540,ACGTCGATTCTGGGGA,412,417,5,25,20719,0,0
24541,ACGTCGAATCTAGGGA,412,416,4,31,21713,0,0
24542,ACGTCGACTCTAGGGA,412,414,2,28,21714,0,0
24543,ACGTCGAATCTAGGGA,412,427,15,33,22086,0,0
24544,ACGTCGAATCTAGGGA,412,412,0,27,22565,0,0
24545,ACGTCGAATCTAGGGA,412,413,1,27,22755,0,0
24546,ACGTCGATTCTGGGGA,412,429,17,28,22759,0,0
24547,ACGTCGAATCTAGGGA,412,440,28,27,22909,0,0
24548,ACGTCGAATCTAGGGT,412,423,11,24,23078,0,0
24549,ACGTCGAATCTAGGGA,412,420,8,27,23082,0,0
24550,ACGTCGAATCTAGGGA,412,417,5,33,23083,0,0
24551,TCGTCGAATCTAGGGA,412,448,36,27,23149,0,0
24552,ACGTCGAATCTAGGGA,412,423,11,28,23154,0,0
24553,ACCTCGATTCTGGGGA,412,415,3,28,23257,0,0
24554,ACGTCGAATCTAGGGA,412,422,10,27,23263,0,0
24555,ACGTAGAGTCTAGGGA,412,425,13,33,23265,0,0
24556,ACGTCGAAAGCAGGGA,412,414,2,26,23271,0,0
24557,ACGTCGAATCTAGGGC,412,431,19,32,23304,0,0
24558,ACGTCGAATCTAGGGA,412,413,1,34,23314,0,0
24559,ACGTCGAATCTAGGGA,412,434,22,28,23320,0,0
24560,ACGTCGAATCTAGGAA,412,413,1,28,23425,0,0
24561,ACGTCGAAAGCAGGGA,412,420,8,27,23432,0,0
24562,ACGTCGGAAGCAGGGA,412,434,22,27,23435,0,0
24563,ACGTCGACTCTAGGGA,412,417,5,27,23610,0,0
24564,ACGTCGAATCTAGGGA,412,441,29,32,23612,0,0
24565,ACGTCGAAAGCAGGGA,412,418,6,26,23614,0,0
24566,ACGTCGAATCTAGGGA,412,415,3,28,23615,0,0
24567,ACGTCGAATCTAGGGA,412,444,32,26,23621,0,0
24568,GCGTCGATTGTGGGGA,412,427,15,30,23631,0,0
24569,ACGTCGAATCTAGGGA,412,422,10,26,23632,0,0
24570,ACGTCGAATCTAGGGA,412,418,6,29,23635,0,0
24571,ACGTCGAATGTAGGGA,412,420,8,32,23644,0,0
24572,ACGTCGATTCTGGGGA,412,414,2,28,23645,0,0
24573,ACGTCGAATCTTGGGA,412,420,8,27,23774,0,0
24574,ACGTCGAATCTAGGGA,412,423,11,29,23777,0,0
24575,ACGTCGAATTTAGGGA,412,414,2,27,23780,0,0
24576,ACGTCGAATCTAGGGA,412,439,27,26,23783,0,0
24577,ACGTCGAATCTAGGGA,412,419,7,28,23785,0,0
24578,ACGTCGAATCTAGGGA,412,417,5,30,23786,0,0
24579,TCGTCGAATCTAGGGA,412,430,18,30,23959,0,0
24580,ACGTCGAATCTAGGGA,412,413,1,26,23964,0,0
24581,ACATCGAACCTAGGGA,412,417,5,32,23969,0,0
24582,ACGTCTAGTCTAGGGA,412,432,20,33,23972,0,0
24583,ACGTCGAATCTAGGGA,412,426,14,30,23973,0,0
24584,ACGTCGAATCTAGGGA,412,414,2,30,23978,0,0
24585,ACGTCGAATGTAGGGA,412,423,11,31,23979,0,0
24586,ACGTCGAATCTAGGGA,412,413,1,33,23980,0,0
24587,ACGTCGAATCTAGGGA,412,432,20,31,23982,0,0
24588,ACGTCGATTGTGGGGA,412,418,6,31,23983,0,0
24589,TCGTCGAATCTAGGGA,412,415,3,31,23984,0,0
24590,ACGTCGAATCTAGGGA,412,413,1,29,24022,0,0
24591,ACGTCGAATCTAGGGA,412,417,5,33,24023,0,0
24592,ACGTCGAATCTAGGGA,412,418,6,34,24027,0,0
24593,ACGTCGAATCTAGGGA,412,438,26,29,24028,0,0
24594,ACGTCGAATCTAGGGA,412,417,5,34,24029,0,0
24595,ACCTCGATTCTGGGGA,412,419,7,29,24030,0,0
24596,ACGTCGAATCTAGGGA,412,436,24,28,24032,0,0
24597,ACGTCGAATCTTGGGA,412,417,5,27,24120,0,0
24598,ACGTCGAATCTAGGGA,413,426,13,31,21612,0,0
24599,ACGTCGAATCTAGGGA,413,416,3,25,22747,0,0
24600,ACGTCGAATCTAGGGA,413,414,1,27,22749,0,0
24601,ACGTCGAATCTAGGGA,413,422,9,28,22804,0,0
24602,ACGTCGATTCTGGGGA,413,417,4,27,22817,0,0
24603,ACGTCGAATCTAGGGT,413,439,26,25,23065,0,0
24604,ACGTCGAATCGAGGGA,413,416,3,28,23123,0,0
24605,ACGTCGAATCTAGGGA,413,419,6,34,23142,0,0
24606,ACGTCGATTCTGGGGA,413,419,6,26,23297,0,0
24607,ACGTCGAATCGAGGGA,413,413,0,28,23301,0,0
24608,ACGTCGATTCTGGGGA,413,416,3,29,23374,0,0
24609,ACGTCGAATCTAGGGA,413,416,3,26,23393,0,0
24610,ACGTCGACTCTAGAGA,413,416,3,27,23481,0,0
24611,ACGTCGAATCTAGGGA,413,416,3,28,23483,0,0
24612,ACGTCGAATCTAGGGA,413,414,1,29,23491,0,0
24613,ACGTCGAATCTAGGGA,413,416,3,28,23501,0,0
24614,ACGTCGAATCTAGGGA,413,416,3,31,23502,0,0
24615,ACGTCGAATCTAGGGT,413,416,3,25,23504,0,0
24616,ACGTCGAATCTAGGGA,413,413,0,28,23662,0,0
24617,ACGTCGAATCTAGGGA,413,416,3,24,23674,0,0
24618,ACGTCGAATCTAGGGA,413,416,3,26,23792,0,0
24619,ACGTCGATTCTGGGGA,413,413,0,26,23819,0,0
24620,ACGTCGAATCTAGGGA,413,414,1,28,23827,0,0
24621,ACGTCGAATCTAGGGA,413,416,3,34,23830,0,0
24622,ACATCGAATCTAGGGA,413,416,3,32,23833,0,0
24623,ACGTCGAATCTAGGGA,413,416,3,28,23834,0,0
24624,ACGTCGAATCTAGGGT,413,414,1,25,23837,0,0
24625,ACATCGAATCTAGGGA,413,416,3,33,23841,0,0
24626,ACGTCGAATCTAGGGA,413,416,3,28,23844,0,0
24627,ACGTCGAATCTAGGGA,413,413,0,34,23860,0,0
24628,ACGTCGACTCTAGGGA,413,416,3,28,23864,0,0
24629,ACGTCGAATCTAGGGA,413,416,3,30,23872,0,0
24630,ACGTCGAATCTAGGGA,413,416,3,29,24003,0,0
24631,ACGTCGAATCTAGGGA,413,416,3,34,24004,0,0
24632,ACGTCGAATCTAGGGA,413,416,3,28,24008,0,0
24633,ACGTCGATTCTGGGGA,413,416,3,29,24009,0,0
24634,ACGTCGAATCTAGGGA,413,416,3,28,24011,0,0
24635,ACGTCGAATCTAGGGT,413,416,3,25,24016,0,0
24636,ACGTCGAATCTAGGGA,413,416,3,28,24017,0,0
24637,TCGTCGAATCTAGGGA,413,416,3,28,24021,0,0
24638,ACGTCGAATCGAGGGA,413,416,3,29,24093,0,0
24639,ACGTCGATTCTGGGGA,413,414,1,30,24095,0,0
24640,ACGTCGATTCTGCGGA,413,416,3,30,24096,0,0
24641,ACGTCGAATCTAGGGA,413,414,1,28,24098,0,0
24642,TCGTCGAATCTAGGGA,413,416,3,30,24100,0,0
24643,ACGTCGAATCTAGGGA,413,416,3,30,24106,0,0
24644,ACGTCGAATGTAGGGA,413,416,3,29,24107,0,0
24645,ACGTCGAATCTAGGGA,413,416,3,32,24109,0,0
24646,ACGTAGAAAGTAGGGA,413,414,1,28,24115,0,0
24647,ACGCCGAATCTAGGGA,413,414,1,28,24121,0,0
24648,ACGTCGATTCTGGGGA,413,416,3,26,24186,0,0
24649,ACGTCGAATCTAGGGA,413,416,3,32,24187,0,0
24650,ACGTCGAATCTAGGGA,413,416,3,34,24189,0,0
24651,ACGTCGAATCTAGGGA,413,413,0,28,24191,0,0
24652,ACGTCGAATCTAGGGA,413,414,1,28,24193,0,0
24653,ACGTCGATTCTGGGGA,413,416,3,29,24194,0,0
24654,ACGTCGAATCTAGGGT,413,416,3,25,24198,0,0
24655,ACGTCGAAGCTAGGGA,413,414,1,28,24199,0,0
24656,ACAGCGAACCTAGGGA,413,415,2,33,24201,0,0
24657,TCGTCGAATCTAGGGA,413,416,3,28,24202,0,0
24658,ACCTCGATTCTGGGGA,413,413,0,29,24207,0,0
24659,ACGTCGAATCTAGGGA,413,416,3,29,24214,0,0
24660,ACGTCGAATCTAGGGA,413,416,3,35,24216,0,0
24661,ACGTCGAATCTAGGGA,413,416,3,30,24224,0,0
24662,ACGTCGAATCTAGGGA,413,413,0,29,24228,0,0
24663,ACGTCGAATCTAGGGA,414,455,41,27,22369,0,0
24664,ACGTCGAATCTAGGGA,414,422,8,28,22635,0,0
24665,ACGTCGAATTTAGGGA,414,414,0,26,22847,0,0
24666,ACGTCGATTCTGGGGA,414,415,1,26,22849,0,0
24667,ACGTCGAATCTAGGGA,414,415,1,25,22882,0,0
24668,ACGTCGAATCTAGGGA,414,420,6,25,23018,0,0
24669,TCGTCGAATCTAGGGA,414,420,6,29,23030,0,0
24670,ACGTCGAAAGCAGGGA,414,419,5,27,23447,0,0
24671,ACGTCGAATCTAGGGA,414,416,2,25,23536,0,0
24672,TCGTCGAATCTAGGGA,414,428,14,29,23541,0,0
24673,ACGTCGAATCTAGGGA,414,428,14,32,23716,0,0
24674,TCGTCGAATCTAGGGA,414,423,9,29,23720,0,0
24675,ACGTCGAATCTAGGGA,414,445,31,28,23727,0,0
24676,ACGTCGAATCTAGGGA,414,420,6,28,23728,0,0
24677,ACGTCGAATCTAGGGA,414,418,4,30,23732,0,0
24678,ACGTCGAATCTAGGGT,414,416,2,25,23738,0,0
24679,ACGTCGAATCTAGGGA,414,437,23,26,23740,0,0
24680,ACGTCGAATCTAGGGA,414,465,51,29,23752,0,0
24681,ACGTCGAATCTTGGGA,414,428,14,24,23753,0,0
24682,ACGTCGAATCTAGGGA,414,427,13,27,23890,0,0
24683,ACGTCGAATCTAGGGT,414,416,2,26,23897,0,0
24684,ACGTCGAATCTAGGGA,414,419,5,27,23989,0,0
24685,ACGTCGAAAGCAGGGA,414,422,8,27,23992,0,0
24686,ACGTCGACTCTAGGGA,414,414,0,30,23996,0,0
24687,ACGTCGAATCTAGGGA,414,445,31,25,24070,0,0
24688,ACGTCGAATCTCGGGA,414,418,4,23,24073,0,0
24689,ACGTCGAATCTAGGGA,414,418,4,30,24074,0,0
24690,ACGTCGAATCTAGGGT,414,424,10,26,24075,0,0
24691,ACGTCGAATCTTGGGA,414,418,4,28,24076,0,0
24692,ACGTCGAATCTAGGGA,414,415,1,28,24078,0,0
24693,ACGTCGAATCGAGGGA,414,414,0,29,24079,0,0
24694,ACGTCGAATCTAGGGA,414,415,1,29,24080,0,0
24695,ACGTCGGATCTAGGGT,414,442,28,26,24084,0,0
24696,ACGTCGAATCTAGGGA,414,416,2,35,24088,0,0
24697,TCGTCGAATCTAGGGA,414,420,6,28,24089,0,0
24698,TCGTCGAATCTAGGGA,414,422,8,29,24252,0,0
24699,ACGTCGAATCTAGGGT,414,423,9,26,24255,0,0
24700,ACGTCGAATCGAGGGA,414,418,4,29,24258,0,0
24701,TCGTCGAATCTAGGGA,414,415,1,28,24260,0,0
24702,ACGTCGAATCTAGGGA,414,415,1,29,24262,0,0
24703,ACGTCGAATCTAGGGA,414,465,51,29,24264,0,0
24704,ACGTCGAATCGAGGGA,414,452,38,29,24265,0,0
24705,TCGTTGAATCTAGGGA,414,420,6,28,24267,0,0
24706,ACGTCGACTCTAGAGT,414,414,0,29,24271,0,0
24707,ACGTCGATTCTGGGGA,414,426,12,30,24273,0,0
24708,ACGTCGAATCTAGGGA,414,441,27,26,24276,0,0
24709,ACGTCGAATCTAGGGA,414,415,1,27,24278,0,0
24710,ACGTCGACTCTAGAGA,414,426,12,28,24279,0,0
24711,ACGTCGAATCTAGGGA,414,423,9,29,24280,0,0
24712,ACGTCGAATCTAGGGA,414,427,13,29,24285,0,0
24713,ACGTCGATTCTGGGGA,415,422,7,25,20719,0,0
24714,ACGTCGACTCTAGGGA,415,434,19,28,21714,0,0
24715,ACGTCGAATCTAGGGA,415,417,2,33,22086,0,0
24716,ACGTCGAATCTAGGGA,415,416,1,27,22755,0,0
24717,ACGTCGATTCTGGGGA,415,434,19,28,22759,0,0
24718,ACGTCGAATCTAGGGA,415,422,7,27,23082,0,0
24719,ACGTCGAATCTAGGGA,415,419,4,33,23083,0,0
24720,AAGTCGAATCTAGGGA,415,428,13,28,23154,0,0
24721,ACGTCGAATCTAGGGA,415,421,6,27,23263,0,0
24722,ACGTCGAGTCTAGGGA,415,433,18,33,23265,0,0
24723,ACGTCGAAAGCAGGGA,415,439,24,26,23271,0,0
24724,ACGTCGAATCTAGGGC,415,415,0,32,23304,0,0
24725,ACGTCGAATCTAGGGA,415,415,0,34,23314,0,0
24726,ACGTCGAATCTAGGGA,415,425,10,28,23320,0,0
24727,ACGTCGAATCTAGGGA,415,416,1,28,23425,0,0
24728,ACGTCGAAAGCAGGGA,415,436,21,27,23432,0,0
24729,ACGTCGGAAGCAGGGA,415,417,2,27,23435,0,0
24730,ACGTCGACTCTAGGGA,415,425,10,27,23610,0,0
24731,ACGTCGAATCTAGGGA,415,418,3,32,23612,0,0
24732,ACGTCGAAAGCAGGGA,415,418,3,26,23614,0,0
24733,ACGTCGAATCTAGGGA,415,418,3,28,23615,0,0
24734,ACGTCGAATGTAGGGA,415,416,1,26,23621,0,0
24735,GCGTCGATTGTGGGGA,415,416,1,30,23631,0,0
24736,ACGTCGAATCTAGGGA,415,416,1,26,23632,0,0
24737,ACGTCGAATCTAGGGA,415,418,3,29,23635,0,0
24738,ACGTCGAATGTAGGGA,415,418,3,32,23644,0,0
24739,ACGTCGATTCTGGGGA,415,417,2,28,23645,0,0
24740,ACGTCGAATCTAGGGA,415,417,2,29,23777,0,0
24741,ACGTCGAATTTAGGGA,415,417,2,27,23780,0,0
24742,ACGTCGAATCTAGGGA,415,418,3,28,23785,0,0
24743,ACGTCGAATCTAGGGA,415,415,0,30,23786,0,0
24744,TCGTCGAATCTAGGGA,415,415,0,30,23959,0,0
24745,ACGTCGAATCTAGGGA,415,417,2,26,23964,0,0
24746,ACATCGAATCTAGGGA,415,415,0,32,23969,0,0
24747,ACGTCGAATCTAGGGA,415,418,3,30,23973,0,0
24748,ACGTCGAATGTAGGGA,415,416,1,31,23979,0,0
24749,ACGTCGAATCTAGGGA,415,418,3,33,23980,0,0
24750,ACGTCGAATCTAGGGA,415,418,3,31,23982,0,0
24751,ACGTCGATTGTGGGGA,415,418,3,31,23983,0,0
24752,TCGTCGAATCTAGGGA,415,418,3,31,23984,0,0
24753,ACGTCGAATCTAGGGA,415,418,3,34,24027,0,0
24754,ACGTCGAATCTAGGGG,415,415,0,29,24028,0,0
24755,ACGTCGAATCTAGGGA,415,417,2,34,24029,0,0
24756,ACCTCGATTCTGGGGA,415,416,1,29,24030,0,0
24757,ACGTCGAATCTAGGGA,415,418,3,28,24032,0,0
24758,ACGTCGAATCTTGGGA,415,418,3,27,24120,0,0
24759,ACGTCGAATCTAGGGA,415,418,3,27,24229,0,0
24760,ACGTCGAATCTAGGGA,415,418,3,28,24231,0,0
24761,ACGTCGAATCTAGGGA,415,418,3,27,24233,0,0
24762,ACGTCGAATCTAGGGA,415,416,1,30,24234,0,0
24763,ACGTCGAATGTAGGGA,415,418,3,33,24237,0,0
24764,ACGTCGATTCTGGGGA,415,418,3,29,24238,0,0
24765,ACGTCGAATCTAGGGA,415,418,3,30,24239,0,0
24766,ACGTCGAATCTTGGGA,415,417,2,28,24240,0,0
24767,ACGTCGAATCTAGGGA,415,417,2,27,24245,0,0
24768,ACGTCGAATCTAGGGA,415,418,3,29,24320,0,0
24769,ACGTCGAATTTAGGGA,415,418,3,27,24322,0,0
24770,ACGTCGAATCTAGGGA,415,418,3,26,24324,0,0
24771,TCGTCGAATCTAGGGA,415,416,1,30,24325,0,0
24772,ACGTCGAATCTAGGGA,415,418,3,26,24326,0,0
24773,ACGTCGAATCTAGGGA,415,418,3,29,24327,0,0
24774,ACGTCGAATCTAGGGA,415,418,3,30,24333,0,0
24775,ACGTCGAATCTAGGGA,415,418,3,30,24334,0,0
24776,ACGTCGAATCTAGGGA,415,418,3,33,24336,0,0
24777,ACGTCGAATCTAGGGA,415,418,3,31,24338,0,0
24778,ACGTCGATTGTGGGGA,415,415,0,31,24339,0,0
24779,ACGTCGAATCTAGGGA,415,416,1,26,24341,0,0
24780,TCGTCGAATCTAGGGA,415,418,3,30,24342,0,0
24781,ACGTCGAATCTAGGGA,415,416,1,29,24347,0,0
24782,ACGTCGAATCTAGGGA,416,445,29,31,21612,0,0
24783,ACGTCGAATCTAGGGA,416,419,3,27,22749,0,0
24784,ACGTCGATTCTGGGGA,416,436,20,27,22817,0,0
24785,ACGTCGAATCTAGGGT,416,431,15,25,23065,0,0
24786,ACGTCGAATCTAGGGA,416,453,37,34,23142,0,0
24787,AAGTCGATTCTGGGGA,416,459,43,26,23297,0,0
24788,ACGTCGAATCGAGGGA,416,420,4,28,23301,0,0
24789,ACGTCGATTCTGGGGA,416,425,9,29,23374,0,0
24790,ACGTCGACTCTAGAGA,416,424,8,27,23481,0,0
24791,ACGTCGAATCTAGGGA,416,429,13,28,23483,0,0
24792,ACGTCGAATCTAGGGA,416,450,34,31,23502,0,0
24793,ACGTCGAATCTAGCGT,416,418,2,25,23504,0,0
24794,ACGTCGAATCTAGGGA,416,418,2,28,23662,0,0
24795,ACGTCGAATCTAGGGA,416,432,16,24,23674,0,0
24796,ACGTCGAATCTAGGGA,416,434,18,26,23792,0,0
24797,ACGTCGATTCTGGGGA,416,427,11,26,23819,0,0
24798,ACGTCGAATCTAGGGA,416,420,4,28,23827,0,0
24799,ACGTCGAATCTAGGGA,416,421,5,34,23830,0,0
24800,ACGTCGAATCTAGGGA,416,418,2,28,23834,0,0
24801,ACGTCGAATCTAGGGT,416,442,26,25,23837,0,0
24802,ACATCGAATCTAGGGA,416,426,10,33,23841,0,0
24803,ACGTCGAATCTAGGGA,416,420,4,28,23844,0,0
24804,ACGTCGAATCTAGGGA,416,420,4,34,23860,0,0
24805,ACGTCGACTCTAGGGA,416,429,13,28,23864,0,0
24806,ACGTCGAATCTAGGGA,416,423,7,30,23872,0,0
24807,ACGTCGAATCTAGGGA,416,418,2,29,24003,0,0
24808,ACGTCGAATCTAGGGA,416,417,1,34,24004,0,0
24809,ACGTCGAATCTAGGGA,416,427,11,28,24008,0,0
24810,ACGTCGATTCTGGGGA,416,416,0,29,24009,0,0
24811,ACGTCGAATCTAGGGA,416,430,14,28,24011,0,0
24812,ACGTCGAATCTAGGGT,416,426,10,25,24016,0,0
24813,TCGTCGAATCTAGGGA,416,421,5,28,24021,0,0
24814,ACGTCGAATCGAGGGA,416,423,7,29,24093,0,0
24815,ACGTCGATTCTGGGGA,416,424,8,30,24095,0,0
24816,ACGTCGATTCTGGGGA,416,450,34,30,24096,0,0
24817,TCGTCGAATCTAGGGA,416,427,11,30,24100,0,0
24818,ACGTCGAATCTAGGGA,416,450,34,30,24106,0,0
24819,ACGTCGAATGTAGGGA,416,418,2,29,24107,0,0
24820,ACGTCGAATCTAGGGA,416,446,30,32,24109,0,0
24821,CCGTCGAAAGTAGGGA,416,431,15,28,24115,0,0
24822,ACGCCGAATCTAGGGA,416,418,2,28,24121,0,0
24823,ACGTCGATTCTGGGGA,416,419,3,26,24186,0,0
24824,ACGTCGAATCTAGGGA,416,424,8,32,24187,0,0
24825,ACGTCGAATCTAGGGA,416,419,3,34,24189,0,0
24826,ACGTCGAATCTAGGGA,416,417,1,28,24193,0,0
24827,ACGTCGATTCTGGGGA,416,418,2,29,24194,0,0
24828,ACGTCGAAGCTAGGGA,416,426,10,28,24199,0,0
24829,ACATCGAACCTAGGGA,416,416,0,33,24201,0,0
24830,ACCTCGATTCTGGGGA,416,417,1,29,24207,0,0
24831,ACGTCGAATCTAGGGA,416,421,5,29,24214,0,0
24832,ACGTCGAATCTAGGGA,416,425,9,35,24216,0,0
24833,ACGTCGAATCTAGGGA,416,416,0,30,24224,0,0
24834,ACGTCGAATCTAGGGA,416,437,21,29,24228,0,0
24835,CCGTCGAATCTAGGGA,416,438,22,29,24287,0,0
24836,ACGTCGATTCTGGGGA,416,425,9,30,24291,0,0
24837,ACGTCGAATCTAGGGA,416,437,21,34,24374,0,0
24838,ACGTCGAATCTAGGGA,416,430,14,28,24375,0,0
24839,ACGTCGAATCTAGGGA,416,460,44,28,24376,0,0
24840,ACGTCGATTCTGGGGA,416,418,2,29,24377,0,0
24841,ACGTCGAATCTAGGGA,416,421,5,28,24378,0,0
24842,ACGTCGAATCTAGGGT,416,431,15,25,24379,0,0
24843,ACGTCGAATCTAGGGA,416,433,17,28,24380,0,0
24844,ACCTCGATTCTGGGGA,416,419,3,29,24386,0,0
24845,ACGTCGAATCTAGGGA,416,421,5,28,24387,0,0
24846,ACGTCGAGTCTAGGGA,416,445,29,34,24388,0,0
24847,ACGTCGACTCTAGGGA,416,441,25,30,24391,0,0
24848,ACGTCGAATCTAGGGA,416,421,5,29,24393,0,0
24849,ACGTCGAATCTAGGGA,416,416,0,29,24394,0,0
24850,ACGTCGAAAGCAGGGA,416,417,1,28,24397,0,0
24851,ACGTCGAATCTAGGGA,416,423,7,30,24399,0,0
24852,ACGTCGAATCTAGGGA,417,418,1,27,22369,0,0
24853,ACGTCGAATCTAGGGA,417,417,0,28,22635,0,0
24854,ACGTCGAATTTAGGGA,417,428,11,26,22847,0,0
24855,ACGTCGATTCTGGGGA,417,424,7,26,22849,0,0
24856,ACGTCGAAAGCAGGGA,417,434,17,27,23447,0,0
24857,ACGTCGAATCTAGGGA,417,423,6,25,23536,0,0
24858,TCGTCGAATCTAGGGA,417,420,3,29,23541,0,0
24859,ACGTCGAATCTAGGGA,417,418,1,32,23716,0,0
24860,TCGTCGAATCTAGGGA,417,420,3,29,23720,0,0
24861,ACGTCGAATCTAGGGA,417,420,3,28,23727,0,0
24862,ACGTCGAATCTAGGGA,417,420,3,28,23728,0,0
24863,ACGTCGAATCTAGGGA,417,420,3,30,23732,0,0
24864,ACGTCGAATCTAGGGT,417,420,3,25,23738,0,0
24865,ACGTCGAATCTTGGGA,417,420,3,24,23753,0,0
24866,ACGTCTAATCTAGGGA,417,420,3,27,23989,0,0
24867,ACGTCGACTCTAGGGA,417,420,3,30,23996,0,0
24868,ACGTCGAATCTAGGGA,417,417,0,25,24070,0,0
24869,ACGTCGAATCTAGGGA,417,420,3,23,24073,0,0
24870,ACGTCGAATCTAGGGA,417,420,3,30,24074,0,0
24871,ACGTCGAATCTTGGGA,417,420,3,28,24076,0,0
24872,ACGTCGAATCGAGGGA,417,420,3,29,24079,0,0
24873,ACGTCGAATCTAGGGA,417,420,3,29,24080,0,0
24874,ACGTCGGATCTAGGGT,417,420,3,26,24084,0,0
24875,TCGTCGAATCTAGGGA,417,420,3,28,24089,0,0
24876,TCGTCGAATCTAGGGA,417,420,3,29,24252,0,0
24877,ACGTCGAATCGAGGGA,417,420,3,29,24258,0,0
24878,TCGTCGAATCTAGGGA,417,417,0,28,24260,0,0
24879,ACGTCGAATCTAGGGA,417,420,3,29,24262,0,0
24880,ACGTCGAATCTAGGGA,417,419,2,29,24264,0,0
24881,ACGTCGAATCGAGGGA,417,420,3,29,24265,0,0
24882,TCGTCGAATCTAGGGA,417,420,3,28,24267,0,0
24883,ACGTCGACTCTAGAGT,417,420,3,29,24271,0,0
24884,ACGTCGATTCTGGGGA,417,420,3,30,24273,0,0
24885,ACGTCGACTCTAGAGA,417,420,3,28,24279,0,0
24886,ACGTCGAATCTAGGGA,417,417,0,32,24434,0,0
24887,ACGTCGAATCTAGGGA,417,418,1,26,24437,0,0
24888,ACGTCGAATCTAGGGA,417,418,1,28,24438,0,0
24889,ACGTCGATTCTGGGGA,417,420,3,28,24440,0,0
24890,ACGTCGAATCTAGGGT,417,420,3,26,24441,0,0
24891,ACGTCGAATCTAGGGA,417,419,2,29,24442,0,0
24892,ACGTCGAATCGAGGGA,417,417,0,29,24443,0,0
24893,ACGTCGAATCTAGGGA,417,418,1,35,24444,0,0
24894,ACGTCGATTCTGGGGA,417,419,2,27,24445,0,0
24895,ACGTCGAATCGAGGGA,417,420,3,29,24447,0,0
24896,ACGTCGATTCTGGGGA,417,418,1,30,24449,0,0
24897,ACGTTGAATCTAGGGA,417,420,3,27,24453,0,0
24898,ACGTCGAATCTAGGGA,417,420,3,29,24455,0,0
24899,ACGTCGAATCTAGGGA,417,420,3,30,24456,0,0
24900,ACGTCGAATCTAGGGA,417,420,3,32,24458,0,0
24901,ACGTCGAATCTAGGGT,417,419,2,26,24459,0,0
24902,ACGTCGAATCTAGGGA,417,420,3,29,24460,0,0
24903,ACGTCGATTCTGGGGA,417,420,3,30,24461,0,0
24904,ACGTCGAATCTAGGGA,417,420,3,25,24462,0,0
24905,ACGTCGAATCTAGGGA,417,420,3,35,24465,0,0
24906,ACGTCGAATCTAGGGA,417,420,3,29,24466,0,0
24907,ACGTCGAATCTAGGGA,417,420,3,35,24467,0,0
24908,ACGTCGAATCTAGGGT,417,420,3,26,24474,0,0
24909,ACGTCGAATCTAGGGA,417,420,3,29,24475,0,0
24910,ACGTCGATTCTGGGGA,418,419,1,25,20719,0,0
24911,ACGTCGAATCTAGGGA,418,426,8,33,22086,0,0
24912,ACGTCGAATCTAGGGA,418,429,11,27,22755,0,0
24913,ACGTCGAATCTAGGGA,418,433,15,27,23082,0,0
24914,ACGTCGAATCTAGGGA,418,422,4,33,23083,0,0
24915,ACGTCGAATCTAGGGA,418,433,15,27,23263,0,0
24916,ACGTCGAGTCTAGGGA,418,420,2,33,23265,0,0
24917,ACGTCGAAAGCAGGGA,418,427,9,26,23271,0,0
24918,ACGTCGAATCTAGGGA,418,442,24,34,23314,0,0
24919,ACGTCGAATCTAGGGA,418,430,12,28,23320,0,0
24920,ACGTCGAATCTAGGGA,418,418,0,28,23425,0,0
24921,ACGTCGAATCTAGGGA,418,431,13,32,23612,0,0
24922,ACGTCGAAAGCAGGGA,418,420,2,26,23614,0,0
24923,ACGTCGAATCTAGGGA,418,422,4,28,23615,0,0
24924,ACGTCGAATCTAGGGA,418,421,3,26,23621,0,0
24925,GCGTCGATTGTGGGGA,418,436,18,30,23631,0,0
24926,ACGTCGAATCTAGGGA,418,422,4,26,23632,0,0
24927,ACGTCGAATCTAGGGA,418,427,9,29,23635,0,0
24928,ACGTCGAATGTGGGGA,418,418,0,32,23644,0,0
24929,ACGTCGAATTTAGGGA,418,418,0,27,23780,0,0
24930,ACGTCGAATCTAGGGA,418,427,9,28,23785,0,0
24931,ACGTCGAATCTAGGGA,418,426,8,30,23786,0,0
24932,TCGTCGAATCTAGGGA,418,418,0,30,23959,0,0
24933,ACGTCGAATCTAGGGA,418,431,13,26,23964,0,0
24934,ACATCGAATCTAGGGA,418,419,1,32,23969,0,0
24935,ACGTCGAATCTAGGGA,418,431,13,30,23973,0,0
24936,ACGTCGTATCTAGGGA,418,436,18,33,23980,0,0
24937,ACGTCGAATCCAGGGA,418,421,3,31,23982,0,0
24938,TCGTCGAATCAAGGGA,418,423,5,31,23984,0,0
24939,ACGTCGAATCTAGGGA,418,424,6,34,24027,0,0
24940,ACGTCGAATCTAGGGA,418,423,5,34,24029,0,0
24941,ACCTCGATTCTGGGGA,418,426,8,29,24030,0,0
24942,ACGTCGAATCTTGGGA,418,429,11,27,24120,0,0
24943,ACGTCGAATCTAGGGA,418,422,4,27,24229,0,0
24944,ACGTCGAATCTAGGGA,418,422,4,30,24234,0,0
24945,ACGTCGATTCTGGGGA,418,425,7,29,24238,0,0
24946,ACGTCGAATCTAGGGA,418,450,32,30,24239,0,0
24947,ACGTCGAATCTAGGGA,418,421,3,28,24240,0,0
24948,ACGTCGAATCTAGGGA,418,428,10,27,24245,0,0
24949,ACGTCGAATCTAGGGA,418,420,2,29,24320,0,0
24950,ACGTCGAATTTAGGGA,418,422,4,27,24322,0,0
24951,ACGTCGAATCTAGGGA,418,421,3,26,24324,0,0
24952,ACGTCGAATCTAGGGA,418,421,3,26,24326,0,0
24953,ACGTCGAATCTAGGGA,418,460,42,29,24327,0,0
24954,ACGTCGAATCTAGGGA,418,423,5,30,24333,0,0
24955,ACGTCGAATCTAGGGA,418,422,4,30,24334,0,0
24956,TCGTCGAATCTAGGGA,418,418,0,30,24342,0,0
24957,ACGTCGAATCTAGGGA,418,423,5,29,24347,0,0
24958,ACGTCGAATTTAGGGA,418,419,1,27,24494,0,0
24959,TCGTCGAATCTAGGGA,418,427,9,30,24498,0,0
24960,ACGTCGAATCTAGGGA,419,425,6,27,22749,0,0
24961,ACGTCGATTCTGGGGA,419,421,2,27,22817,0,0
24962,ACGTCGATTCTGGGGA,419,425,6,29,23374,0,0
24963,ACGTCGACTCTAGAGA,419,424,5,27,23481,0,0
24964,ACGTCGAATCTAGGGT,419,435,16,25,23504,0,0
24965,ACGTCGAATCTAGGGA,419,457,38,24,23674,0,0
24966,ACGTCGATTCTGGGGA,419,434,15,26,23819,0,0
24967,ACGTCGAATCTAGGGA,419,428,9,28,23827,0,0
24968,ACGTCGAATCTAGGGT,419,427,8,25,23837,0,0
24969,ACGTCGACTCTAGGGA,419,432,13,28,23864,0,0
24970,ACGTCGAATCTAGGGA,419,430,11,30,23872,0,0
24971,ACGTCGAATCTAGGGA,419,432,13,29,24003,0,0
24972,ACGTCGAATCTAGGGA,419,422,3,28,24008,0,0
24973,ACGTCGATTCTGGGGA,419,426,7,29,24009,0,0
24974,ACGTCGAATCGGGGGA,419,426,7,29,24093,0,0
24975,TCGTCGAATCTAGGGA,419,425,6,30,24100,0,0
24976,ACGTCGAATCTAGGGA,419,423,4,30,24106,0,0
24977,ACGTCGAATCTAGGGA,419,432,13,32,24109,0,0
24978,ACGTCGAAAGTAGGGA,419,433,14,28,24115,0,0
24979,ACGCCGAATCTAGGGA,419,444,25,28,24121,0,0
24980,ACGTCGATTCTGGGGA,419,437,18,26,24186,0,0
24981,ACGTCGAATCTAGGGA,419,442,23,32,24187,0,0
24982,ACGTCGAATCTAGGGA,419,430,11,28,24193,0,0
24983,ACGTCGATTCTGGGGA,419,422,3,29,24194,0,0
24984,ACGTCGAAGCTAGGGA,419,423,4,28,24199,0,0
24985,ACGTCGAATCTAGGGA,419,433,14,35,24216,0,0
24986,CCGTCGAATCTAGGGA,419,421,2,29,24287,0,0
24987,ACGTCGATTCTGGGGA,419,426,7,30,24291,0,0
24988,ACGTCGAATCTAGGGA,419,428,9,34,24374,0,0
24989,ACGTCGAATCTAGGGA,419,426,7,28,24376,0,0
24990,ACGTCGATTCTGGGGA,419,424,5,29,24377,0,0
24991,ACGTCGAATCGAGGGT,419,427,8,25,24379,0,0
24992,ACGTCGAATCTAGGGA,419,451,32,28,24380,0,0
24993,ACGTCGAATCTAGGGA,419,448,29,29,24393,0,0
24994,ACGTCGAATCTAGGGA,419,421,2,29,24394,0,0
24995,ACGTCGAAAGCAGGGA,419,422,3,28,24397,0,0
24996,ACGTCGAATCTAGGGA,419,430,11,30,24399,0,0
24997,ACGTCGACTCTAGGGA,419,421,2,29,24478,0,0
24998,ACGTCGAATCTAGGGA,419,429,10,31,24481,0,0
24999,ACGTCGAATCTAGGGA,419,421,2,35,24483,0,0
