Bacterium, DNA, Iteration Born, Iteration Died, Life Span, Generation, Parent Bacterium, Number of Offspring, Alive at End
0,ACGTCGAATCTAGGGA,0,5,5,1,0,1,0
3,ACGTCGAATCTAGAGA,10,15,5,3,1,1,0
1,ACGTCGAATCTAGAGA,3,16,13,2,0,3,0
2,ACGTCGAATCTAGAGA,7,16,9,3,1,2,0
7,ACGTCGAAGCTAGAGA,14,16,2,4,3,0,0
11,ACGTCGAATCTAGAGA,18,19,1,5,6,0,0
6,ACGTCGAATCTAGAGA,14,21,7,4,2,1,0
8,ACGTCGAATCTAGAGA,15,23,8,5,4,2,0
10,ACGTCGAATCTAGAGA,18,23,5,5,4,1,0
9,ACGTCGAATCTAGAGA,17,25,8,4,5,2,0
4,ACGTCGAATCTAGAGA,11,26,15,4,2,4,0
17,ACGTCGAATCTAGAGA,22,26,4,6,10,0,0
15,ACGTCGAATCTAGAGA,21,27,6,5,9,1,0
24,ACGTCGAATCTAGAGA,25,27,2,6,15,0,0
16,ACGTCGAATCTAGAGA,22,28,6,6,8,1,0
20,ACGTCGACTCTAGAGA,24,28,4,5,4,0,0
32,ACGTCTAATCTAGAGA,28,29,1,6,21,0,0
30,ACGTCGAATCTAGAGA,27,30,3,8,19,0,0
31,ACGTCGAATCTAGAGA,28,30,2,6,14,0,0
34,ACGTCGAATCTAGAGA,29,30,1,4,5,0,0
5,ACGTCGAATCTAGAGA,13,31,18,3,1,5,0
12,ACGTCGAATCTAGAGA,19,31,12,6,8,3,0
23,ACGTCGAATCTAGAGA,25,31,6,6,14,1,0
25,ACGTCGAATCTAGAGA,26,31,5,4,5,1,0
36,ACGTCGAATCTAGAGA,29,31,2,7,23,0,0
42,ACGTCGAATCTAGAGA,30,33,3,8,27,0,0
14,ACGTCGAATCTAGAGA,21,34,13,5,4,3,0
39,ACGTCGAATCTAGAGA,30,34,4,8,19,0,0
43,ACGTCGAATCTAGAGA,31,34,3,6,14,0,0
48,ACGTCGAATCTAGAGA,32,34,2,7,33,0,0
19,ACGTCGAATCTAGAGA,23,35,12,7,12,3,0
56,ACGTCGAATCTAGAGA,34,35,1,6,22,0,0
58,ACGTCGAATCTAGAGA,34,35,1,6,29,0,0
41,ACGTCGAATCTAGAGA,30,36,6,8,26,1,0
47,ACGTCGAATCTAGAGA,31,36,5,6,29,1,0
64,ACGTCGAATCTAGAGA,35,36,1,7,44,0,0
40,ACGTCGAATCTAGAGA,30,37,7,5,25,1,0
63,ACGTCGAATCTAGAGA,35,37,2,7,33,0,0
26,ACGTCGAATCTAGAGA,26,38,12,7,12,3,0
29,ACGTCGAATCTAGAGA,27,38,11,5,18,3,0
79,ACGTCGAATCTAGAGA,37,38,1,6,49,0,0
49,ACGTCGAATCTAGAGA,33,39,6,5,13,1,0
53,ACGTCGAATCTAGAGA,33,39,6,8,27,1,0
78,ACGTCGAATCTAGAGA,37,39,2,6,38,0,0
81,ACGTCGAATCTAGAGA,37,39,2,9,51,0,0
21,ACGTCGAATCTAGAGA,24,40,16,5,9,4,0
33,ACGTCGAATCTAGAGA,28,40,12,6,22,3,0
44,ACGTCGAATCTAGAGA,31,40,9,6,21,2,0
55,ACGTCGAATCTAGAGA,34,40,6,6,21,1,0
57,ACGTCGAATCTAGAGA,34,40,6,6,28,1,0
60,ACGTCGAATCTAGAGA,34,40,6,6,38,1,0
67,ACGTCGAATCTAGAGA,35,40,5,7,47,1,0
13,ACGTCGAATCTAGAGA,20,41,21,4,5,6,0
54,ACGTCGAATCTAGAGA,33,41,8,8,35,2,0
68,ACGTCGAATCTAGAGA,36,41,5,5,13,1,0
72,ACGTCGAATCTAGAGA,36,41,5,8,35,1,0
83,ACGTCGAATCTAGAGA,37,41,4,9,53,0,0
105,ACGTCGAATCTAGAGA,40,41,1,6,38,0,0
106,ACGTCGAATCTAGAGA,40,41,1,6,50,0,0
70,ACGTCGAATCTAGAGA,36,42,6,8,26,1,0
103,ACGTCGAATCTAGAGA,40,42,2,6,28,0,0
110,ACGTCGAATCTAGAGA,40,42,2,6,68,0,0
116,ACGTCGAATCTAGAGA,41,42,1,7,46,0,0
118,ACGTCGAATCTAGAGA,41,42,1,7,61,0,0
120,ACGTCGAATCTAGAGA,41,42,1,7,73,0,0
121,ACGTCGAATCTAGAGA,41,42,1,7,74,0,0
62,ACGTCGAATCTAGAGA,34,43,9,9,41,2,0
88,ACGTCGAATCTAGAGA,38,43,5,7,46,1,0
94,ACGTCGAATCTAGAGA,38,43,5,10,62,1,0
100,ACGTCGAATCTAGAGA,39,43,4,8,66,0,0
107,ACGTCGAATCTAGAGA,40,43,3,9,51,0,0
109,ACGTCGAATCTAGAGA,40,43,3,9,54,0,0
141,ACGTCGAATCTAGAGA,42,43,1,8,93,0,0
142,ACGTCGAATCTAGAGA,42,43,1,11,94,0,0
46,ACGTCGAATCTAGAGA,31,44,13,6,28,3,0
82,ACGTCGAATCTAGAGA,37,44,7,9,52,1,0
84,ACGTCGAATCTAGAGA,37,44,7,9,54,1,0
86,ACGTCGAATCTAGAGA,38,44,6,7,44,1,0
90,ACGTCGAATCTAGAGA,38,44,6,7,57,1,0
122,ACGTCGAATCTAGAGA,41,44,3,7,75,0,0
128,ACGTCGAATCTAGAGA,42,44,2,5,18,0,0
143,ACGTCGAATCTAGAGA,43,44,1,6,22,0,0
147,ACGTCGAATCTAGAGA,43,44,1,6,50,0,0
156,ACGTCGAATCTAGAGA,43,44,1,9,99,0,0
157,ACGGCGAATCTAGAGA,43,44,1,9,101,0,0
28,ACGTCGAATCTAGAGA,27,45,18,5,13,5,0
37,ACGTCGAATCTAGAGA,30,45,15,5,13,4,0
38,ACGTCGAATCTAGAGA,30,45,15,5,18,4,0
52,ACGTCGAATCTAGAGA,33,45,12,8,26,3,0
77,ACGTCGAATCTAGAGA,37,45,8,6,37,2,0
80,ACGTCGAATCTAGAGA,37,45,8,6,50,2,0
113,ACGTCGAATCTAGGGA,40,45,5,9,71,1,0
125,ACGTCGAATCTAGAGA,41,45,4,7,80,0,0
131,ACGTCGAATCTAGAGA,42,45,3,8,65,0,0
138,ACGTCGAATCTAGAGA,42,45,3,8,90,0,0
149,ACGTCGAATCTAGAGA,43,45,2,9,52,0,0
161,ACGTCGAATCTAGAGA,44,45,1,7,73,0,0
167,ACGTCGAATCTAGAGA,44,45,1,7,102,0,0
172,ACGTCGAATCTAGGGA,44,45,1,10,113,0,0
66,ACGTCGAATCTAGAGA,35,46,11,7,46,3,0
69,ACGTCGAATCTAGAGA,36,46,10,5,18,2,0
97,ACGTCGAATCTAGAGA,39,46,7,8,27,1,0
98,ACGTCGAATCTAGAGA,39,46,7,8,35,1,0
99,ACGTCGAATCTAGAGA,39,46,7,8,65,1,0
101,ACGGCGAATCTAGAGA,39,46,7,8,67,1,0
104,ACGTCGAATCTAGAGA,40,46,6,6,37,1,0
119,ACGTCGAATCTAGAGA,41,46,5,10,62,1,0
154,ACGTCGAATCTAGAGA,43,46,3,9,97,0,0
162,ACGTCGAATCTAGAGA,44,46,2,7,74,0,0
168,ACGTCGAATCTAGAGA,44,46,2,7,104,0,0
171,ACGTCGAATCTAGAGA,44,46,2,10,112,0,0
173,ACGTCGAATCTAGAGA,44,46,2,10,114,0,0
181,ACGTCGAATCTAGAGA,45,46,1,8,89,0,0
183,ACGTCGAATCTAGAGA,45,46,1,8,92,0,0
27,ACGTCGAATCTAGAGA,26,47,21,7,16,6,0
45,ACGTCGAATCTAGAGA,31,47,16,6,22,4,0
76,ACGTCGAATCTAGAGA,37,47,10,6,29,2,0
91,ACGTCGAATCTAGAGA,38,47,9,7,59,2,0
123,ACGTCGAATCTAGAGA,41,47,6,7,76,1,0
132,ACGTCGAATCTAGAGA,42,47,5,8,66,1,0
135,ACGTCGAATCTAGAGA,42,47,5,8,87,1,0
150,ACGTCGAATCTAGAGA,43,47,4,6,69,0,0
151,ACGTCGAATCTAGAGA,43,47,4,9,71,0,0
193,ACGTCGAATCTAGAGA,46,47,1,6,50,0,0
201,ACGTCGAATCTAGAGA,46,47,1,9,133,0,0
59,ACGTCGAATCTAGAGA,34,48,14,6,37,4,0
115,ACGTCGAATCTAGAGA,41,48,7,7,45,1,0
130,ACGTCGAATCTAGAGA,42,48,6,8,35,1,0
146,ACGTCGAATCTAGAGA,43,48,5,6,38,1,0
159,ACGTCGAATCTAGAGA,44,48,4,7,59,0,0
178,ACGTCGAATCTAGAGA,45,48,3,8,66,0,0
187,ACGTCGAATCTAGAGA,45,48,3,11,119,0,0
192,ACGTCGAATCTAGAGA,46,48,2,6,22,0,0
209,ACGTCGAATCTAGAGA,47,48,1,7,61,0,0
210,ACGTCGAATCTAGAGA,47,48,1,7,73,0,0
221,ACGTCGAATCTAGAGA,47,48,1,10,148,0,0
108,ACGTCGAATCTAGAGA,40,49,9,9,52,2,0
139,ACGTCGAATCTAGAGA,42,49,7,8,91,1,0
148,ACGTCGAATCTAGAGA,43,49,6,9,51,1,0
163,ACGTCGAATCTAGAGA,44,49,5,7,75,1,0
177,ACGTCGAATCTAGAGA,45,49,4,8,65,0,0
180,ACGTCGAATCTAGAGA,45,49,4,8,87,0,0
202,ACGTCGAATCTAGAGA,46,49,3,9,134,0,0
74,ACGTCGAATCTAGAGA,37,50,13,6,22,3,0
127,ACGTCGAATCTAGAGA,41,50,9,10,84,2,0
145,ACGTCGAATCTAGAGA,43,50,7,6,37,1,0
155,ACGTCGAATCTAGAGA,43,50,7,9,98,1,0
174,ACGTCGAATCTAGAGA,45,50,5,5,18,1,0
176,ACGTCGAATCTAGAGA,45,50,5,8,35,1,0
186,ACGTCGAATCTAGAGA,45,50,5,8,117,1,0
200,ACGTCGAATCTAGAGA,46,50,4,9,132,0,0
229,ACGTCGAATCTAGAGA,48,50,2,8,87,0,0
241,ACGTCGAATCTAGAGA,48,50,2,8,165,0,0
265,ACGTCGAATCTAGAGA,49,50,1,9,188,0,0
73,ACGTCGAATCTAGAGA,37,51,14,6,21,4,0
85,ACGTCGAATCTAGAGA,38,51,13,7,33,3,0
92,ACGTCGAATCTAGAGA,38,51,13,7,60,3,0
129,ACGTCGAATCTAGAGA,42,51,9,8,27,2,0
164,ACGTCGAATCTAGAGA,44,51,7,7,76,1,0
179,ACGTCGAATCTAGAGA,45,51,6,8,85,1,0
190,ACGTCGAATCTAGAGA,45,51,6,11,126,1,0
203,ACGTCGAATCTAGAGA,46,51,5,9,135,1,0
233,ACGTCGAATCTAGAGA,48,51,3,8,117,0,0
244,ACGTCGAATCTAGAGA,48,51,3,8,170,0,0
264,ACGTCGAATCTAGAGA,49,51,2,9,186,0,0
275,ACGTCGAATCTAGAGA,50,51,1,10,114,0,0
277,ACGTCGAATCTAGAGA,50,51,1,7,152,0,0
283,ACGTCGAATCTAGAGA,50,51,1,10,198,0,0
285,ACGTCGAATCTAGAGA,50,51,1,10,203,0,0
18,ACGTCGAATCTAGAGA,23,52,29,4,5,9,0
126,ACGTCGAATCTAGAGA,41,52,11,10,82,3,0
140,ACGTCGAATCTAGAGA,42,52,10,8,92,2,0
158,ACGTCGAATCTAGAGA,44,52,8,7,45,2,0
189,ACGTCGAATCTAGAGA,45,52,7,8,124,1,0
197,ACGTCGAATCTAGAGA,46,52,6,6,96,1,0
212,ACGTCGAATCTAGAGA,47,52,5,7,75,1,0
227,ACGTCGAATCTAGAGA,48,52,4,8,65,0,0
248,ACGTCGAATCTAGAGA,49,52,3,9,71,0,0
249,ACGTCGAATCTAGAGA,49,52,3,6,95,0,0
250,ACGTCGAATCTAGAGA,49,52,3,6,96,0,0
252,ACGTCGAATCTAGAGA,49,52,3,9,133,0,0
254,ACGTCGAATCTAGAGA,49,52,3,9,136,0,0
270,ACGTCGAATCTAGAGA,50,52,2,7,73,0,0
281,ACGTCGAATCTAGAGA,50,52,2,7,196,0,0
282,ACGTCGAATCTAGAGA,50,52,2,7,197,0,0
286,ACGTCGAATCTAGAGA,50,52,2,10,204,0,0
289,ACGTCGAATCTAGAGA,50,52,2,10,207,0,0
292,ACGTCGAATCTAGAGA,51,52,1,8,65,0,0
300,ACGTCGAATCTAGAGA,51,52,1,8,160,0,0
303,ACGTCGAATCTAGAGA,51,52,1,11,169,0,0
111,ACGTCGAATCTAGAGA,40,53,13,6,69,3,0
170,ACGTCGAATCTAGAGA,44,53,9,7,111,2,0
175,ACGTCGAATCTAGAGA,45,53,8,8,27,2,0
211,ACGTCGAATCTAGAGA,47,53,6,7,74,1,0
214,ACGTCGAATCTAGAGA,47,53,6,10,108,1,0
215,ACGTCGAATCTAGAGA,47,53,6,7,111,1,0
219,ACGTCGAATCTAGAGA,47,53,6,7,145,1,0
259,ACGTCGAATCTAGAGA,49,53,4,9,176,0,0
260,ACGTCGAATCTAGAGA,49,53,4,9,179,0,0
307,ACGTCGAATCTAGAGA,51,53,2,8,212,0,0
312,ACGTCGAATCTAGAGA,51,53,2,11,217,0,0
317,ACGTCGAATCTAGAGA,51,53,2,8,223,0,0
328,ACCTCGAATCTAGAGA,52,53,1,9,137,0,0
342,ACGTCGAATCTAGAGA,52,53,1,12,235,0,0
191,ACGTCGAATCTAGAGA,45,54,9,11,127,2,0
234,ACGTCGAATCTAGAGA,48,54,6,8,124,1,0
258,ACGTCGAATCTAGAGA,49,54,5,9,175,1,0
278,ACGTCGAATCTAGAGA,50,54,4,7,153,0,0
298,ACGTCGAATCTAGAGA,51,54,3,11,126,0,0
310,ACGTCGAATCTAGAGA,51,54,3,8,215,0,0
320,ACGTCGAATCTAGAGA,52,54,2,6,50,0,0
356,ACGTCGAATCTAGAGA,53,54,1,7,152,0,0
381,ACGTCGAATCTAGAGA,53,54,1,13,268,0,0
117,ACGTCGAATCTAGAGA,41,55,14,7,59,4,0
188,ACGTCGAATCTAGAGA,45,55,10,8,123,2,0
204,ACGTCGAATCTAGAGA,46,55,9,9,136,2,0
217,ACGTCGAATCTAGAGA,47,55,8,10,114,2,0
218,ACGTCGAATCTAGAGA,47,55,8,7,144,2,0
237,ACGTCGAATCTAGAGA,48,55,7,8,158,1,0
242,ACGTCGAATCTAGAGA,48,55,7,8,166,1,0
256,ACGTCGAATCTAGAGA,49,55,6,9,140,1,0
257,ACGTCGAATCTAGAGA,49,55,6,6,174,1,0
268,ACGTCGAATCTAGAGA,49,55,6,12,191,1,0
287,ACGTTGAATCTAGAGA,50,55,5,10,205,1,0
319,ACGTCGAATCTAGAGA,52,55,3,6,22,0,0
337,ACGTCGAATCTAGAGA,52,55,3,9,228,0,0
365,ACGTCGAATCTAGAGA,53,55,2,10,206,0,0
374,ACGTCGAATCTAGAGA,53,55,2,7,257,0,0
379,ACGTCGAATCTAGAGA,53,55,2,10,266,0,0
385,ACGTCGAATCTAGAGA,54,55,1,8,89,0,0
389,ACGTCGAATCTAGAGA,54,55,1,8,160,0,0
395,ACGTCGAATCTAGAGA,54,55,1,11,216,0,0
397,ACGTCGAATCTAGAGA,54,55,1,8,218,0,0
407,ACGTCGAATCTAGAGA,54,55,1,8,276,0,0
61,ACGTCGAATCTAGAGA,34,56,22,6,40,6,0
112,ACGTCGAATCTAGAGA,40,56,16,9,70,4,0
144,ACGTCGAATCTAGAGA,43,56,13,6,28,3,0
160,ACGTCGAATCTAGAGA,44,56,12,7,61,3,0
208,ACGTCGAATCTAGAGA,47,56,9,7,59,2,0
216,ACGTCGAATCTAGAGA,47,56,9,10,112,2,0
225,ACGTCGAATCTAGAGA,48,56,8,5,18,2,0
235,ACGTCGAATCTAGAGA,48,56,8,11,126,2,0
246,ACGTCGAATCTAGAGA,49,56,7,6,50,1,0
267,ACGTCGAATCTAGAGA,49,56,7,12,190,1,0
279,ACGTCGAATCTAGAGA,50,56,6,10,194,1,0
294,ACGTCGAATCTAGAGA,51,56,5,8,89,1,0
305,ACGTCGAATCTAGAGA,51,56,5,8,208,1,0
315,ACGTCGAATCTAGAGA,51,56,5,8,220,1,0
322,ACGTCGAATCTAGAGA,52,56,4,9,71,0,0
330,ACGTCGAATCTAGAGA,52,56,4,9,182,0,0
336,ACGTCGAATCTAGAGA,52,56,4,9,226,0,0
362,ACGTCGAATCTAGAGA,53,56,3,10,199,0,0
383,ACGTCGAATCTAGAGA,54,56,2,8,65,0,0
398,ACGTCGAATCTAGAGA,54,56,2,8,220,0,0
456,ACGTCGAATCTAGAGA,55,56,1,9,315,0,0
199,ACGTCGAATCTAGAGA,46,57,11,9,130,3,0
205,ACGTTGAATCTAGAGA,46,57,11,9,137,3,0
222,ACGTCGAATCTAGAGA,47,57,10,7,152,2,0
247,ACGTCGAATCTAGAGA,49,57,8,9,51,2,0
280,ACGTCGAATCTAGAGA,50,57,7,10,195,1,0
291,ACGTCGAATCTAGAGA,51,57,6,8,35,1,0
308,ACGTCGAATCTAGAGA,51,57,6,8,213,1,0
323,ACGTCGAATCTAGAGA,52,57,5,6,95,1,0
331,ACGTCGAATCTAGAGA,52,57,5,9,184,1,0
343,ACGTCGAATCTAGAGA,52,57,5,12,236,1,0
346,ACGTCGAATCTAGAGA,52,57,5,9,239,1,0
375,ACGTCGAATCTAGAGA,53,57,4,10,258,0,0
376,ACGTCGAATCTAGAGA,53,57,4,10,261,0,0
377,ACGTCGAATCTAGAGA,53,57,4,10,262,0,0
388,ACGTCGAATCTAGAGA,54,57,3,8,124,0,0
391,ACGTCGAATCTAGAGA,54,57,3,8,166,0,0
400,ACGTCGAATCTAGAGA,54,57,3,8,223,0,0
403,ACGTCGAATCTAGAGA,54,57,3,8,271,0,0
408,ACGTCGAATCTAGAGA,54,57,3,11,279,0,0
409,ACGTCGAATCTAGAGA,54,57,3,11,280,0,0
414,ACGTCGAATCTAGAGA,55,57,2,6,50,0,0
416,ACGTCGAATCTAGAGA,55,57,2,9,71,0,0
426,ACGTCGAATCTAGAGA,55,57,2,6,225,0,0
443,ACGTCGAATCTAGAGA,55,57,2,9,296,0,0
448,ACGTCGAATCTAGAGA,55,57,2,9,304,0,0
450,ACGTCGAATCTAGAGA,55,57,2,9,306,0,0
466,ACGTCGAATCTAGAGA,56,57,1,7,196,0,0
472,ACGTCGAATCTAGAGA,56,57,1,7,245,0,0
477,ACGTCGAATCTAGAGA,56,57,1,10,261,0,0
481,ACGTCGAATCTAGAGA,56,57,1,10,321,0,0
486,ACGTCGAATCTAGAGA,56,57,1,10,327,0,0
487,ACGTCGAATCTAGAGA,56,57,1,10,329,0,0
152,ACGTCGAATCTAGAGA,43,58,15,6,95,4,0
284,ACGTCGAATCTAGAGA,50,58,8,10,199,2,0
288,ACGTCGAATCTAGAGA,50,58,8,10,206,2,0
293,ACGTCGAATCTAGAGA,51,58,7,8,87,1,0
297,ACGTCGAATCTAGAGA,51,58,7,8,124,1,0
325,ACGTCGAATCTAGAGA,52,58,6,9,133,1,0
353,ACGTCGAATCTAGAGA,53,58,5,10,112,1,0
483,ACGTCGAATCTAGAGA,56,58,2,7,324,0,0
499,ACGTCGAATCTAGAGA,56,58,2,10,345,0,0
514,ACGTCGAATCTAGAGA,57,58,1,8,220,0,0
516,ACGTCGAATCTAGAGA,57,58,1,11,224,0,0
518,ACGTCGAATCTAGAGA,57,58,1,8,271,0,0
520,ACGTCGAATCTAGAGA,57,58,1,8,273,0,0
529,ACGTCGAATCTAGAGA,57,58,1,11,354,0,0
71,ACGTCGAATCTAGAGA,36,59,23,8,27,7,0
75,ACGTCGAATCTAGAGA,37,59,22,6,28,6,0
230,ACGTCGAATCTAGAGA,48,59,11,8,89,3,0
272,ACGTCGAATCTAGAGA,50,59,9,7,102,2,0
324,ACGTCGAATCTAGAGA,52,59,7,6,96,1,0
329,ACGTCGAATCTAGAGA,52,59,7,9,175,1,0
339,ACGTCGAATCTAGAGA,52,59,7,9,231,1,0
354,ACGTCGAATCTAGAGA,53,59,6,10,114,1,0
358,ACGTCGAATCTAGAGA,53,59,6,10,194,1,0
386,ACGTCGAATCTAGAGA,54,59,5,8,93,1,0
417,ACGTCGAATCTAGAGA,55,59,4,6,95,0,0
419,ACGTCGAATCTAGAGA,55,59,4,9,133,0,0
428,ACGTCGAATCTAGAGC,55,59,4,9,228,0,0
429,ACGTCGAATCTAGAGA,55,59,4,9,230,0,0
430,ACGTCGAATCTAGAGA,55,59,4,9,231,0,0
434,ACGTCGCATCTAGAGA,55,59,4,9,238,0,0
439,ACGTCGAATCTAGAGA,55,59,4,9,291,0,0
460,ACGTCGAATCTAGAGA,56,59,3,7,102,0,0
470,ACGTCGAATCTAGAGA,56,59,3,10,206,0,0
479,ACGTCGAATCTAGAGA,56,59,3,10,263,0,0
480,ACGTCGAAACTAGAGA,56,59,3,10,266,0,0
519,ACGTCGAATCTAGAGA,57,59,2,8,272,0,0
530,ACGTCGAATCTAGAGA,57,59,2,8,355,0,0
537,ACGTTGAATCTAGAGA,57,59,2,11,364,0,0
557,ACGTCGAATCTAGAGA,58,59,1,9,137,0,0
559,ACGTCGAATCTAGAGA,58,59,1,9,184,0,0
573,ACGTCGAATCTAGAGA,58,59,1,9,296,0,0
586,ACGTCGAATCTAGAGA,58,59,1,9,384,0,0
593,ACGTCGAATCTAGAGA,58,59,1,12,396,0,0
206,ACGTCGAATCTAGAGA,46,60,14,9,139,4,0
226,ACGTCGAATCTAGAGA,48,60,12,8,35,3,0
231,ACGTCGAATCTAGAGA,48,60,12,8,92,3,0
266,ACGTCGAATCTAGAGA,49,60,11,9,189,3,0
274,ACGTCGAATCTAGAGA,50,60,10,10,112,2,0
295,ACGTCGAATCTAGAGA,51,60,9,8,93,2,0
332,ACGTCGAATCTAGAGA,52,60,8,9,185,2,0
334,ACGTCGAATCTAGAGA,52,60,8,12,191,2,0
338,ACGTCGAATCTAGAGA,52,60,8,9,230,2,0
366,ATGTCGAATCTAGAGA,53,60,7,10,207,1,0
371,ACGTCGAATCTAGAGA,53,60,7,10,253,1,0
372,ACGTCGAATCTAGAGA,53,60,7,10,255,1,0
384,ACGTCGAATCTAGAGA,54,60,6,8,87,1,0
413,ACGTCGAATCTAGAGA,55,60,5,6,22,1,0
432,ACGTCGAATCTAGAGA,55,60,5,12,235,1,0
433,ACGTCGAATCTAGAGA,55,60,5,12,236,1,0
441,ACGTCGAATCTAGAGA,55,60,5,9,294,1,0
449,ACGTCGAATCTAGAGA,55,60,5,9,305,1,0
482,ACGTCGAATCTAGAGA,56,60,4,7,323,0,0
489,ACGTCGAATCTAGAGA,56,60,4,10,332,0,0
495,ACGTCGAATCTAGAGA,56,60,4,10,340,0,0
500,ACGTCGAATCTAGAGA,56,60,4,10,346,0,0
508,ACGTCGAATCTAGAGA,57,60,3,8,93,0,0
532,ACGTCGAATCTAGAGA,57,60,3,11,358,0,0
544,ACGTCGAATCTAGAGA,57,60,3,11,372,0,0
558,ACGTCGAATCTAGACA,58,60,2,9,182,0,0
567,ACGTCGAATCTAGAGA,58,60,2,9,238,0,0
568,ACGTCGAATCTAGAGA,58,60,2,9,239,0,0
579,ACGTCGAATCTAGAGA,58,60,2,12,309,0,0
606,ACGTCGAATCTAGAGA,59,60,1,10,194,0,0
618,ACGTCGAATCTAGAGA,59,60,1,10,263,0,0
620,ACGTCGAATCTAGAGA,59,60,1,10,321,0,0
625,ACGTCGAATCTAGAGA,59,60,1,13,334,0,0
626,ACGTCGAATCTAGAGA,59,60,1,7,335,0,0
629,ACGTCGAATCTAGAGA,59,60,1,10,341,0,0
634,ACGTCGAATCTAGAGA,59,60,1,13,349,0,0
638,ACGTCGAATCTAGAGA,59,60,1,10,420,0,0
656,ACGTCGAATCTAGAGA,59,60,1,10,445,0,0
50,ACGTCGAATCTAGAGA,33,61,28,5,18,8,0
93,ACGTCGAATCTAGAGA,38,61,23,7,61,7,0
136,ACGTCGAATCTAGAGA,42,61,19,8,88,5,0
137,ACGTCGAATCTAGAGA,42,61,19,8,89,5,0
153,ACGTCGAATCTAGAGA,43,61,18,6,96,5,0
166,ACGTCGAATCTAGAGA,44,61,17,7,80,5,0
327,ACGTCGAATCTAGAGA,52,61,9,9,136,2,0
340,ACGTCGAATCTAGAGA,52,61,9,9,232,2,0
344,ACGTCGAATCTAGAGA,52,61,9,9,237,2,0
352,ACGTCGAATCTAGAGA,53,61,8,7,102,2,0
363,ACGTCGAATCTAGAGA,53,61,8,10,204,2,0
364,ACGTTGAATCTAGAGA,53,61,8,10,205,2,0
368,ACGTCGAATCTAGAGA,53,61,8,7,246,2,0
378,ACGTCGAATCTAGAGA,53,61,8,10,263,2,0
399,ACGTCGAATCTAGAGA,54,61,7,8,222,1,0
406,ACGTCGAATCTAGAGA,54,61,7,11,274,1,0
423,ACGTCGAATCTAGAGA,55,61,6,9,182,1,0
473,ACGTCGAATCTAGAGA,56,61,5,10,247,1,0
492,ACGTCGAATCTAGAGA,56,61,5,7,335,1,0
507,ACGTCGAATCTAGAGA,57,61,4,8,89,0,0
531,ACGTCGAATCTAGAGA,57,61,4,8,357,0,0
535,ACGTCGAATCTAGAGA,57,61,4,11,361,0,0
556,ACGTCGAATCTAGAGA,58,61,3,9,136,0,0
565,ACGTCGAATCTAGAGA,58,61,3,9,232,0,0
566,ACGTCGAATCTAGAGA,58,61,3,12,236,0,0
587,ACGTCGAATCTAGAGA,58,61,3,9,386,0,0
597,ACGTCGAATCTAGAGA,58,61,3,9,404,0,0
612,ACGTCGAATCTAGAGA,59,61,2,7,245,0,0
613,ACGTCGAATCTAGAGA,59,61,2,10,251,0,0
622,ACGTCGAATCTAGAGA,59,61,2,10,327,0,0
636,ACGTCGAATCTAGAGA,59,61,2,10,415,0,0
653,ACGTCGAATCTAGAGA,59,61,2,10,441,0,0
659,ACGTCGAATCTAGAGA,59,61,2,10,449,0,0
677,ACGTCGAATCTAGAGA,60,61,1,8,220,0,0
682,ACGTCGAATCTAGAGA,60,61,1,8,273,0,0
687,ACGTCGAATCTAGAGA,60,61,1,8,355,0,0
699,ACGTCGAATCTAGAGA,60,61,1,11,378,0,0
706,ACGTCGAATCTAGAGA,60,61,1,11,465,0,0
711,ACGTCGAATCTAGAGA,60,61,1,11,473,0,0
715,ACGTCGAATCTAGAGA,60,61,1,11,478,0,0
725,ACGTCGAATCTAGAGA,60,61,1,14,497,0,0
729,ACGTCGAATCTAGAGA,60,61,1,14,503,0,0
124,ACGTCGAATCTAGAGA,41,62,21,7,77,6,0
223,ACGTCGAATCTAGAGA,47,62,15,7,153,4,0
251,ACGTCGAATCTAGAGA,49,62,13,9,129,3,0
311,ACGTCGAATCTAGAGA,51,62,11,11,216,3,0
341,ACGTCGAATCTAGAGA,52,62,10,9,234,2,0
348,ACGTCGAACCTAGAGA,52,62,10,9,242,2,0
361,ACGTCGAATCTAGAGA,53,62,9,10,198,2,0
393,ACGTCGAATCTAGAGA,54,62,8,8,208,2,0
411,ACGTTGAATCTAGAGA,54,62,8,11,287,2,0
420,ACGTCGAATCTAGAGA,55,62,7,9,134,1,0
435,ACGTCGAATCTAGAGA,55,62,7,9,239,1,0
446,ACGTCGAATCTAGAGA,55,62,7,9,301,1,0
455,ACGTCGAATCTAGAGA,55,62,7,9,314,1,0
475,ACGTCGAATCTAGAGA,56,62,6,10,253,1,0
484,ACGTCGAATCTAGAGA,56,62,6,10,325,1,0
494,ACGTCGAATCTAGAGA,56,62,6,10,339,1,0
501,ACGTCGAATCTAGAGA,56,62,6,10,347,1,0
540,ACGTCGAATCTAGAGA,57,62,5,8,368,1,0
547,ACGTCGAATCTAGAGA,57,62,5,14,380,1,0
549,ACGTCGAATCTAGAGA,58,62,4,6,50,0,0
552,ACGTCGAATCTAGAGA,58,62,4,6,95,0,0
570,ACGTCGAATCTAGAGA,58,62,4,12,243,0,0
600,ACGTCGAATCTAGAGA,58,62,4,12,410,0,0
604,ACGTCGAATCTAGAGA,59,62,3,10,114,0,0
607,ACGTCGAATCTAGAGA,59,62,3,10,195,0,0
639,ACGTCGAATCTAGAGA,59,62,3,10,421,0,0
643,ACGTCGAATCTAGAGA,59,62,3,10,425,0,0
673,ACGTCGAATCTAGAGA,60,62,2,8,165,0,0
683,ACGTCGAATCTAGAGA,60,62,2,8,276,0,0
685,ACGTCGAATCTAGAGA,60,62,2,8,351,0,0
686,ACGTCGAATCTAGAGA,60,62,2,8,352,0,0
695,ACGTCGAATCTAGAGA,60,62,2,8,368,0,0
705,ACGTCGAATCTAGAGA,60,62,2,11,464,0,0
716,ACGTCGAATCTAGAGA,60,62,2,11,484,0,0
731,ACGTCGAATCTAGAGA,61,62,1,9,51,0,0
757,ACGTCGAATCTAGAGA,61,62,1,9,316,0,0
769,ACGTCGAATCTAGAGA,61,62,1,9,405,0,0
771,ACGTTGAATCTAGAGA,61,62,1,12,411,0,0
774,ACGTCGAATCTAGAGA,61,62,1,9,505,0,0
798,ACGTCGAATCTAGAGA,61,62,1,12,542,0,0
96,ACGTCGAATCTAGAGA,39,63,24,5,18,7,0
169,ACGTCGAATCTAGAGA,44,63,19,10,108,5,0
184,ACGTCGAATCTAGAGA,45,63,18,8,93,5,0
232,ACGTCGAATCTAGAGA,48,63,15,8,93,4,0
255,ACGTCGAATCTAGAGA,49,63,14,9,137,4,0
276,ACGTCGAATCTAGAGA,50,63,13,7,144,3,0
326,ACGTCGAATCTAGAGA,52,63,11,9,134,3,0
333,ACGTCGAATCTAGAGA,52,63,11,9,188,3,0
357,ACGTCGAATCTAGAGA,53,63,10,7,153,2,0
360,ACGTCGAATCTAGAGA,53,63,10,7,196,2,0
369,ACGTCGAATCTAGAGA,53,63,10,10,247,2,0
373,ACGTCGAATCTAGAGA,53,63,10,10,256,2,0
380,ACGTCGAATCTAGAGA,53,63,10,13,267,2,0
382,ACGTCGAATCTAGAGA,54,63,9,8,35,2,0
402,ACGTCGAATCTAGAGA,54,63,9,8,269,2,0
404,ACGTCGAATCTAGAGA,54,63,9,8,272,2,0
488,ACGTCGAATCTTGAGA,56,63,7,10,331,1,0
496,ACGTCGAATCTAGAGA,56,63,7,10,341,1,0
512,ACGTCGAATCTAGAGA,57,63,6,11,169,1,0
526,ACGTCGAATCTAGAGA,57,63,6,8,351,1,0
528,ACGTCGAATCTAGAGA,57,63,6,11,353,1,0
561,ACGTCGAATCTAGAGA,58,63,5,9,226,1,0
590,ACGTCGAATCTAGAGA,58,63,5,12,392,1,0
602,ACGTCGAATCTAGAGA,58,63,5,12,412,1,0
616,ACGTCGAATCTAGAGA,59,63,4,10,261,0,0
621,ACGTCGAATCTAGAGA,59,63,4,10,326,0,0
632,ACGTCGAATCTAGAGA,59,63,4,10,347,0,0
649,ACGTCGAATCTAGAGA,59,63,4,10,436,0,0
658,ACGTCGAATCTAGAGA,59,63,4,10,447,0,0
662,ACGTCGAATCTAGAGA,59,63,4,13,453,0,0
690,ACGTCGAATCTAGAGA,60,63,3,8,360,0,0
707,ACGTCGAATCTAGAGA,60,63,3,11,467,0,0
709,ACGTTGAATCTAGAGA,60,63,3,11,469,0,0
741,ACGTCGAATCTAGAGA,61,63,2,12,236,0,0
742,ACGTCGAATCTAGAGA,61,63,2,9,238,0,0
753,ACGTCGAATCTAGAGA,61,63,2,12,309,0,0
765,ACGTCGAATCTAGAGA,61,63,2,12,396,0,0
768,ACGTCGAATCTAGAGA,61,63,2,9,404,0,0
778,ACGTCGAATCTAGAGA,61,63,2,9,511,0,0
779,ACGTCGAATCTAGAGA,61,63,2,12,512,0,0
781,ACGTCGAATCTAGAGA,61,63,2,9,515,0,0
815,ACGTCGAATCTAGAGA,62,63,1,10,263,0,0
828,ACGTCGAATCTAGAGA,62,63,1,10,425,0,0
838,ACGTCGAATCTAGAGA,62,63,1,10,447,0,0
845,ACGTCGAATCTAGAGA,62,63,1,7,548,0,0
847,ACGTCGAATCTAGAGA,62,63,1,10,551,0,0
849,ACGTCGAATCTAGAGA,62,63,1,10,554,0,0
853,ACGTCGAATCTAGAGA,62,63,1,10,562,0,0
870,ACGTCGAATCTAGAGA,62,63,1,10,588,0,0
134,ACGTCGAATCTAGAGA,42,64,22,8,86,6,0
194,ACGTCGAATCTAGAGA,46,64,18,9,51,5,0
220,ACGTCGAATCTAGAGA,47,64,17,7,146,5,0
236,ACGTCGAATCTAGAGA,48,64,16,11,127,4,0
347,ACGTCGAATCTAGAGA,52,64,12,9,240,3,0
355,ACGTCGAATCTAGAGA,53,64,11,7,144,3,0
396,ACGTCGAATCTAGAGA,54,64,10,11,217,2,0
424,ACGTCGAATCTAGAGA,55,64,9,9,184,2,0
447,ACGTCGAATCTAGAGA,55,64,9,9,302,2,0
464,ACGTCGAATCTAGAGA,56,64,8,10,194,2,0
490,ACGTCGAATCTAGAGA,56,64,8,10,333,2,0
506,ACGTCGAATCTAGAGA,57,64,7,8,87,1,0
515,ACGTCGAATCTAGAGA,57,64,7,8,223,1,0
525,ACGTCGAATCTAGAGA,57,64,7,8,350,1,0
534,ACGTCGAATCTAGAGA,57,64,7,8,360,1,0
539,ACGTCGAATCTAGAGA,57,64,7,8,367,1,0
630,ACGTCGAATCTAGAGA,59,64,5,10,344,1,0
668,ACGTCGAATCTAGAGA,60,64,4,8,65,0,0
679,ACGTCGAATCTAGAGA,60,64,4,11,224,0,0
697,ACGTCGAATCTAGAGA,60,64,4,11,370,0,0
703,ACGTCGAATCTAGAGA,60,64,4,8,462,0,0
710,ACGTCGAATCTAGAGA,60,64,4,11,471,0,0
713,ACGTCGAATCTAGAGA,60,64,4,11,475,0,0
720,ACGTCGAATCTAGAGA,60,64,4,14,491,0,0
739,ACGTCGAATCTAGAGA,61,64,3,9,228,0,0
766,ACGTCGAATCTAGAGA,61,64,3,12,401,0,0
770,ACGTCGAATCTAGAGA,61,64,3,12,410,0,0
795,ACGTCGAATCTAGAGA,61,64,3,9,539,0,0
823,ACGTCGAATCTAGAGA,62,64,2,10,415,0,0
824,ACGTCGAATCTAGAGA,62,64,2,7,418,0,0
826,ACGTCGAATCTAGAGA,62,64,2,10,422,0,0
837,ACGTCGAATCTAGAGA,62,64,2,10,445,0,0
857,ACGTCGAATCTAGAGA,62,64,2,7,571,0,0
858,ACGTCGAATCTAGAGA,62,64,2,10,572,0,0
860,ACGTCGAATCTAGAGA,62,64,2,10,575,0,0
862,ACGTCGAATCTAGAGA,62,64,2,10,577,0,0
876,ACGTCGAATCTAGAGA,62,64,2,13,595,0,0
889,ACGTCGAATCTAGAGA,63,64,1,11,224,0,0
891,ACGTCGAATCTAGAGA,63,64,1,8,271,0,0
909,ACGTCGAATCTAGAGA,63,64,1,11,474,0,0
915,ACGTCGAATCTAGAGA,63,64,1,11,493,0,0
932,ACGTCGAATCTAGAGA,63,64,1,11,627,0,0
934,ACGTCGAATCTAGAGA,63,64,1,11,630,0,0
935,ACGTCGAATCTAGAGA,63,64,1,11,631,0,0
949,ACGTCGAATCTAGAGA,63,64,1,11,652,0,0
953,ACGTCGAATCTAGAGA,63,64,1,11,660,0,0
89,ACGTCGAATCTAGAGA,38,65,27,7,55,8,0
165,ACGTCGAATCTAGAGA,44,65,21,7,77,6,0
182,ACGTCGAATCTAGAGA,45,65,20,8,91,6,0
301,ACGTCGAATCTAGAGA,51,65,14,8,165,4,0
318,ACGTCGAATCTAGAGA,51,65,14,11,224,4,0
468,ACGTCGAATCTAGAGA,56,65,9,10,199,2,0
551,ACGTCGAATCTAGAGA,58,65,7,9,71,1,0
563,ACGTCGAATCTAGAGA,58,65,7,9,230,1,0
583,ACGTCGAATCTAGAGA,58,65,7,9,316,1,0
596,ACGTCGAATCTAGAGA,58,65,7,9,402,1,0
598,ACGTCGAATCTAGAGA,58,65,7,9,405,1,0
614,ACGTCGAATCTAGAGA,59,65,6,10,253,1,0
615,ACGTCGAATCTAGAGA,59,65,6,10,255,1,0
648,ACGTCGAATCTAGAGA,59,65,6,10,435,1,0
654,ACGTCGAATCTAGAGA,59,65,6,10,442,1,0
667,ACGTCGAATCTAGAGA,60,65,5,8,35,1,0
669,ACGTCGAATCTAGAGA,60,65,5,8,87,1,0
701,ACGTCAAATCTAGAGA,60,65,5,8,459,1,0
726,ACGTCGAATCTAGAGA,60,65,5,11,498,1,0
728,ACGTCGAACCTAGAGA,60,65,5,11,502,1,0
738,ACGTCGAATCTAGAGA,61,65,4,9,185,0,0
744,ACGTCGAATCTAGAGA,61,65,4,9,240,0,0
761,ACGTCGAATCTAGAGA,61,65,4,9,390,0,0
783,ACGTCGAATCTAGAGA,61,65,4,12,521,0,0
807,ACGTCGAATCTAGAGA,62,65,3,7,196,0,0
809,ACGTCGAATCTAGAGA,62,65,3,10,207,0,0
821,ACGTCGAATCTAGAGA,62,65,3,10,347,0,0
840,ACGTCGAATCTAGAGA,62,65,3,13,452,0,0
875,ACGTCGAATCTAGAGA,62,65,3,10,594,0,0
879,ACGTCGAATCTAGAGA,62,65,3,13,599,0,0
900,ACGTCGAATCTAGAGA,63,65,2,11,461,0,0
911,ACGTCGAATCTAGAGA,63,65,2,11,478,0,0
947,ACGTCGAATCTAGAGT,63,65,2,14,650,0,0
948,ACGTCGAATCTAGAGA,63,65,2,8,651,0,0
950,ACGTCGAATCTAGAGA,63,65,2,11,654,0,0
965,ACGTCGAATCTAGAGA,64,65,1,9,228,0,0
966,ACGTCGAATCTAGAGA,64,65,1,9,238,0,0
984,ACGTCGAATCTAGAGA,64,65,1,12,392,0,0
998,ACGTCGAATCTAGAGA,64,65,1,9,522,0,0
999,ACGTCGAATCTAGAGA,64,65,1,12,523,0,0
1001,ACGTCGAATCTAGAGA,64,65,1,9,527,0,0
1045,ACGTCGAATCTAGAGA,64,65,1,12,727,0,0
306,ACGTCGAATCTAGAGA,51,66,15,8,211,4,0
367,ACGTCGAATCTAGAGA,53,66,13,7,245,3,0
401,ACGTCGAATCTAGAGA,54,66,12,11,224,3,0
427,ACGTCGAATCTAGAGA,55,66,11,9,226,3,0
453,ACGTCGAATCTAGAGA,55,66,11,12,311,3,0
458,ACGTCGAATCTAGAGA,55,66,11,12,318,3,0
527,ACGTCGAATCTAGAGA,57,66,9,8,352,2,0
533,ACGTCGAATCTAGAGA,57,66,9,11,359,2,0
538,ATGTCGAATCTAGAGA,57,66,9,11,366,2,0
571,ACGTCGAATCTAGAGA,58,66,8,6,290,2,0
575,ACGTCGAATCTAGAGA,58,66,8,9,301,2,0
585,ACGTCGAATCTAGAGA,58,66,8,9,382,2,0
628,ACGTCGAATCTAGAGA,59,66,7,10,340,1,0
635,ACGTCGAATCTAGAGA,59,66,7,7,413,1,0
650,ACGTCGAATCTAGAGA,59,66,7,13,437,1,0
691,ACGTCGAATCTAGAGA,60,66,6,11,361,1,0
694,ACGTCGAATCTAGAGA,60,66,6,8,367,1,0
717,ACGTCGAATCTAGAGA,60,66,6,11,485,1,0
721,ACGTCGAATCTAGAGA,60,66,6,8,492,1,0
776,ACGTCGAATCTAGAGA,61,66,5,9,509,1,0
782,ACGTCGAATCTAGAGA,61,66,5,9,517,1,0
787,ACGTCGAATCTAGAGA,61,66,5,9,525,1,0
788,ACGTCGAATCTAGAGA,61,66,5,9,526,1,0
793,ACGTCGAATCTAGAGA,61,66,5,12,536,1,0
794,ATGTCGAATCTAGAGA,61,66,5,12,538,1,0
808,ACGTCGAATCTAGAGA,62,66,4,10,198,0,0
816,ACGTCGAATCTAGAGA,62,66,4,10,321,0,0
841,ACGTCGAATCTAGAGA,62,66,4,13,453,0,0
869,ACGTCGAATCTAGAGA,62,66,4,10,585,0,0
884,ACGTCGAATCTAGAGA,63,66,3,8,87,0,0
894,ACGTCGAATCTAGAGA,63,66,3,8,351,0,0
910,ACGTCGAATCTAGAGA,63,66,3,11,476,0,0
916,ACGTCGAATCTAGAGA,63,66,3,14,497,0,0
919,ACGTCGAATCTAGAGA,63,66,3,14,503,0,0
920,ACGTCGAATCTAGAGA,63,66,3,8,603,0,0
939,ACGTCGAATCTAGAGA,63,66,3,11,640,0,0
945,ACGTCGAATCTAGAGA,63,66,3,14,647,0,0
994,ACGTCGAATCTAGAGA,64,66,2,9,511,0,0
1042,ACGTCGAATCTAGAGA,64,66,2,12,723,0,0
1043,ACGTCGAATCTAGAGA,64,66,2,12,724,0,0
1048,ACGTCGAATCTAGAGA,65,66,1,10,114,0,0
1051,ACGTCGAATCTAGAGA,65,66,1,10,198,0,0
1071,ACGTCGAATCTAGAGA,65,66,1,7,438,0,0
1077,ACGTCGAATCTAGAGA,65,66,1,13,452,0,0
1083,ACGTCGAATCTAGAGA,65,66,1,10,550,0,0
1090,ACGTCGAATCTAGAGA,65,66,1,10,569,0,0
1102,ACGTCGAATCTAGAGA,65,66,1,10,585,0,0
1108,ACGTCGAATCTAGAGA,65,66,1,13,595,0,0
1125,ACGTCGAATCTAGAGA,65,66,1,10,750,0,0
1126,ACGTCGAATCTAGAGC,65,66,1,10,751,0,0
1132,ACGTCGAATCTAGAGA,65,66,1,10,759,0,0
1135,ACGTCGAATCTAGAGA,65,66,1,10,763,0,0
1137,ACGTCGAATCTAGAGA,65,66,1,10,767,0,0
51,ACGTCGAATCTAGAGA,33,67,34,8,19,10,0
213,ACGTCGAATCTAGAGA,47,67,20,7,102,6,0
238,ACGTCGAATCTAGAGA,48,67,19,8,160,5,0
253,ACGTCGAATCTAGAGA,49,67,18,9,134,5,0
351,ACGTCGAATCTAGAGA,53,67,14,7,75,4,0
476,ACGTCGAATCTAGAGA,56,67,11,10,255,3,0
509,ACGTCGAATCTAGAGA,57,67,10,8,124,2,0
536,ACGTCGAATCTAGAGA,57,67,10,11,363,2,0
541,ACGTCGAATCTAGAGA,57,67,10,11,369,2,0
543,ACGTCGAATCTAGAGA,57,67,10,11,371,2,0
580,ACGTCGAATCTAGAGA,58,67,9,12,311,2,0
603,ACGTCGAATCTAGAGA,59,67,8,7,102,2,0
605,ACGTCGAATCTAGAGA,59,67,8,7,153,2,0
611,ACGTCGAATCTAGAGA,59,67,8,10,207,2,0
631,ACGTCGAATCTAGAGA,59,67,8,10,345,2,0
637,ACGTCGAATCTAGAGA,59,67,8,7,418,2,0
672,ACATCGAATCTAGAGA,60,67,7,8,124,1,0
730,ACGTCGAATCTAGAGA,61,67,6,6,22,1,0
743,ACGTCGAATCTAGAGA,61,67,6,9,239,1,0
745,ACGTCGAATCCAGAGA,61,67,6,12,243,1,0
752,ACGTCGAATCTAGAGA,61,67,6,9,306,1,0
755,ACGTCGAATCTAGAGA,61,67,6,9,313,1,0
789,ACGTCGAATCTAGAGA,61,67,6,9,527,1,0
792,ACGTCGAATCTAGAGA,61,67,6,9,534,1,0
799,ACGTCGAATCTAGAGA,61,67,6,12,543,1,0
844,ACGTCGAATCTAGAGA,62,67,5,13,458,1,0
885,ACGTCGAATCTAGAGA,63,67,4,8,89,0,0
895,ACGTCGAATCTAGAGA,63,67,4,8,355,0,0
898,ACGTCGAATCTAGAGA,63,67,4,11,370,0,0
956,ACGTCGAATCTAGAGA,63,67,4,11,664,0,0
967,ACGTCGAATCTAGAGA,64,67,3,9,239,0,0
976,ACGTCGAATCTAGAGA,64,67,3,9,306,0,0
991,ACGTCGAATCTAGAGA,64,67,3,9,505,0,0
1004,ATGTCGAATCTAGAGA,64,67,3,12,538,0,0
1007,ACGTCGAATCTAGAGA,64,67,3,12,543,0,0
1066,ACGTCGAATCTAGAGA,65,67,2,10,425,0,0
1085,ACGTCGAATCTAGAGA,65,67,2,10,554,0,0
1140,ACGTCGAATCTAGAGA,65,67,2,10,775,0,0
1156,ACGTCGAATCTAGAGA,65,67,2,10,796,0,0
1159,ACGTCGAATCTAGAGA,65,67,2,13,800,0,0
1166,ACGTCGAATCTAGAGA,66,67,1,11,224,0,0
1170,ACGTCGAATCTAGAGA,66,67,1,8,350,0,0
1180,ACGTTGAATCTAGAGA,66,67,1,11,469,0,0
1190,ACGTCGAATCTAGAGA,66,67,1,11,502,0,0
1210,ACGTCGAATCTAGAGA,66,67,1,11,645,0,0
1215,ACGTCGAATCTAGAGA,66,67,1,11,655,0,0
1219,ACGTCGAATCTAGAGA,66,67,1,11,663,0,0
1228,ACGTCGAATCTAGAGA,66,67,1,11,811,0,0
1233,ACGTCGAATCTAGAGA,66,67,1,11,818,0,0
1236,ACGTCGAATCTAGAGA,66,67,1,14,822,0,0
1244,ACGTCGAATCTAGAGA,66,67,1,11,834,0,0
1255,ACGTCGAATCTAGAGA,66,67,1,11,852,0,0
1268,ACGTCGAATCTAGAGA,66,67,1,14,872,0,0
296,ACGTCGAATCTAGAGA,51,68,17,8,117,5,0
314,ACGTCGAATCTAGAGA,51,68,17,8,219,5,0
387,ACGTCGAATCTAGAGA,54,68,14,8,117,4,0
410,ACGTCGAATCTAGAGA,54,68,14,11,284,4,0
467,ACGTCGAATCTAGAGA,56,68,12,10,198,3,0
505,ACGTCGAATCTAGAGA,57,68,11,8,65,3,0
550,ACGTCGAATCTAGAGA,58,68,10,9,51,2,0
562,ACGTCGAATCTAGAGA,58,68,10,9,228,2,0
595,ACGTCGAATCTAGAGA,58,68,10,12,401,2,0
641,ACGTCGAATCTAGAGA,59,68,9,10,423,2,0
664,ACGTCGAATCTAGAGA,59,68,9,10,455,2,0
674,ACGTCGAATCTAGAGA,60,68,8,8,166,2,0
693,ACGTTGAATCTAGAGA,60,68,8,11,364,2,0
708,ACGTCGAATCTAGAGA,60,68,8,11,468,2,0
722,ACGTCGAATCTAGAGA,60,68,8,11,493,2,0
796,ACGTCGAATCTAGAGA,61,68,7,9,540,1,0
825,ACGTCGAATCTAGAGA,62,68,6,10,421,1,0
843,ACGTCGAATCTAGAGA,62,68,6,10,457,1,0
881,ACGTCGAATCTAGAGA,62,68,6,13,602,1,0
897,ACGTCGAATCTAGAGA,63,68,5,8,367,1,0
901,ACGTCGAATCTAGAGA,63,68,5,8,462,1,0
903,ACGTCCAATCTAGAGA,63,68,5,11,464,1,0
908,ACGTCGAATCTAGAGA,63,68,5,11,471,1,0
917,ACGTCGAATCTAGAGA,63,68,5,11,498,1,0
958,ACGTCGAATCTAGAGA,63,68,5,14,666,1,0
962,ACGTCGAATCTAGAGA,64,68,4,9,133,0,0
964,ACGTCGAATCTAGAGA,64,68,4,9,185,0,0
974,ACGTCGAATCTAGAGA,64,68,4,9,302,0,0
979,ACGTCGAATCTAGAGA,64,68,4,9,314,0,0
990,ACGTCGAATCTAGAGA,64,68,4,9,504,0,0
1015,ACGTCGAATCTAGAGA,64,68,4,9,674,0,0
1029,ACGTCGAATCTAGAGA,64,68,4,12,698,0,0
1038,ACGTCGAATCTTGAGA,64,68,4,12,718,0,0
1057,ACGTCGAATCTAGAGA,65,68,3,10,263,0,0
1063,ACGTCGAATCTAGAGA,65,68,3,7,418,0,0
1074,ACGTCGAATCTAGAGA,65,68,3,10,444,0,0
1079,ACGTCGAATCTAGAGA,65,68,3,10,454,0,0
1081,ACGTCGAATTTAGAGA,65,68,3,13,458,0,0
1088,ACGTCGAATCTAGAGA,65,68,3,10,562,0,0
1098,ACGTCGAATCTAGAGA,65,68,3,13,580,0,0
1105,ACGTCGAATCTAGAGA,65,68,3,10,591,0,0
1107,ACGTCGAATCTAGAGA,65,68,3,10,594,0,0
1116,ACGTCGAATCTAGAGA,65,68,3,10,736,0,0
1128,ACGTCGAATCTAGAGA,65,68,3,13,754,0,0
1129,ACGTCGAATCTAGAGA,65,68,3,10,755,0,0
1130,ACGTCGAATCTAGAGA,65,68,3,10,756,0,0
1147,ACGTCGAATCTAGAGA,65,68,3,13,786,0,0
1153,ACGTCGAATCTAGAGA,65,68,3,10,792,0,0
1164,ACGTCGAATCTAGAGA,66,68,2,8,87,0,0
1167,ACGTCGAATCTAGAGA,66,68,2,8,269,0,0
1169,ACGTCGAATCTAGAGA,66,68,2,8,273,0,0
1171,ACGTCGAATCTAGAGA,66,68,2,8,351,0,0
1175,ACGTCGAATCTAGAGA,66,68,2,11,461,0,0
1185,ACGTCGAATCTAGAGA,66,68,2,11,485,0,0
1193,ACGTCGAATCTAGAGA,66,68,2,8,605,0,0
1195,ACGTCGAATCTAGAGA,66,68,2,11,609,0,0
1213,ACGTCGAATCTAGAGA,66,68,2,8,651,0,0
1214,ACGTCGAATCTAGAGA,66,68,2,11,652,0,0
1217,ACGTCGAATCTAGAGA,66,68,2,11,660,0,0
1229,TCGTCGAATCTAGAGA,66,68,2,11,812,0,0
1242,ACGTCGAATCTAGAGA,66,68,2,14,832,0,0
1245,ACGTCGAATCTAGAGA,66,68,2,11,835,0,0
1248,ACGTCGAATCTAGAGA,66,68,2,11,842,0,0
1273,GCGTTGAATCTAGAGA,66,68,2,14,880,0,0
1277,ACGTCGAATCTAGAGA,67,68,1,9,133,0,0
1278,ACGTCGAATCTAGAGA,67,68,1,9,185,0,0
1280,ACGTCGAATCTAGAGA,67,68,1,9,239,0,0
1281,ACGTCGAATCTAGAGA,67,68,1,9,240,0,0
1294,ACGTCGAATCTAGAGA,67,68,1,12,392,0,0
1302,ACGTCGAATCTAGAGA,67,68,1,9,511,0,0
1307,ACGTCGAATCTAGAGA,67,68,1,12,523,0,0
1318,ACGTCGAATCTAGAGA,67,68,1,9,680,0,0
1320,ACGTCGAATCTAGAGA,67,68,1,9,684,0,0
1345,ACGTCGAATCTAGAGA,67,68,1,9,892,0,0
1348,ACGTCGAATCTAGAGA,67,68,1,9,897,0,0
1352,ACGTCCAATCTAGAGA,67,68,1,12,903,0,0
1368,ACGTCGAATCTAGAGA,67,68,1,12,926,0,0
1373,ACGTCGAATCTAGAGA,67,68,1,12,931,0,0
1381,ACGTCGAATCTAGAGA,67,68,1,12,943,0,0
261,ACGTCGAATCTAGAGA,49,69,20,9,182,6,0
437,ACGTCGAATCTAGAGA,55,69,14,12,243,4,0
440,ACGTCGAATCTAGAGA,55,69,14,9,293,4,0
491,ACGTCGAATCTAGAGA,56,69,13,13,334,3,0
555,ACGTCGAATCTAGAGA,58,69,11,9,134,3,0
581,ACGTCGAATCTAGAGA,58,69,11,9,313,3,0
609,ACGTCGAATCTAGAGA,59,69,10,10,198,2,0
642,ACGTCGAATCTAGAGA,59,69,10,10,424,2,0
652,ACGTCGAATCTAGAGA,59,69,10,10,440,2,0
675,ACGTCGAATCTAGAGA,60,69,9,11,169,2,0
676,ACGTCGAATCTAGAGA,60,69,9,8,213,2,0
692,ACGTCGAATCTAGAGA,60,69,9,11,363,2,0
751,ACGTCGAATCTAGAGC,61,69,8,9,304,2,0
759,ACGTCGAATCTAGAGA,61,69,8,9,382,2,0
762,ACGTCGAATCTAGAGA,61,69,8,12,392,2,0
839,ACGTCGAATCTAGAGA,62,69,7,10,451,1,0
850,ACGTCGAATCTAGAGA,62,69,7,10,555,1,0
866,ACGTCGAATCTAGAGA,62,69,7,10,582,1,0
871,ACGTCGAATCTAGAGA,62,69,7,10,589,1,0
880,ACGTTGAATCTAGAGA,62,69,7,13,601,1,0
902,ACGTCGAATCTAGAGA,63,69,6,8,463,1,0
959,ACGTCGAATTTAGAGA,64,69,5,6,22,1,0
969,ACGTCGAATCTAGAGA,64,69,5,12,243,1,0
983,ACGTCGAATCTAGAGA,64,69,5,9,390,1,0
1014,ACATCGAATCTAGAGA,64,69,5,9,672,1,0
1041,ACGTCGAATCTAGAGA,64,69,5,12,722,1,0
1046,ACGTCGAACCTAGAGA,64,69,5,12,728,1,0
1059,ACGTCGAATCTAGAGA,65,69,4,7,335,0,0
1072,ACGTCGAATCTAGAGA,65,69,4,10,440,0,0
1099,ACGTCAAATCTAGAGA,65,69,4,10,581,0,0
1111,ACGTCGAATCTAGAGA,65,69,4,7,730,0,0
1114,ACGTCGAATCTAGAGA,65,69,4,10,734,0,0
1151,ACGTCGAATCTAGAGA,65,69,4,13,790,0,0
1162,ACGTCGAATCTAGAGA,66,69,3,8,35,0,0
1178,ACGTCGAATCCAGAGA,66,69,3,11,465,0,0
1179,ACGTCGAATCTAGAGA,66,69,3,11,467,0,0
1198,ACGTCGAATCTAGAGA,66,69,3,11,617,0,0
1216,ACGTCGAATCTAGAGA,66,69,3,11,657,0,0
1238,ACGTCGAATCTAGAGA,66,69,3,11,827,0,0
1263,ACGTCGAATCTAGAGA,66,69,3,11,865,0,0
1276,ACGTCGAATCTAGAGA,67,69,2,6,95,0,0
1282,ACGTCGAATCTAGAGA,67,69,2,12,243,0,0
1306,ACGTCGAATCTAGAGA,67,69,2,9,522,0,0
1311,ACGTCGAATCTAGAGA,67,69,2,12,546,0,0
1315,ACGTCGAATCTAGAGA,67,69,2,12,675,0,0
1322,ACGTCGAATCTAGAGA,67,69,2,12,689,0,0
1323,ACGTCGAATCTAGAGA,67,69,2,12,692,0,0
1329,ACGTCGAATCTAGAGA,67,69,2,9,704,0,0
1340,ACGTCGAATCTAGAGA,67,69,2,9,883,0,0
1343,ACGTCGAATCTAGAGA,67,69,2,9,888,0,0
1350,ACGTCGAATCTAGAGA,67,69,2,9,901,0,0
1371,ACGTCGAATCTAGAGT,67,69,2,12,929,0,0
1376,ACGTCGAATCTAGAGA,67,69,2,9,937,0,0
1398,ACGTCGAATCTAGAGA,68,69,1,10,262,0,0
1401,ACGTCGAATCTAGAGA,68,69,1,7,335,0,0
1404,ACGTCGAATCTAGAGA,68,69,1,10,415,0,0
1423,ACGTCGAATCTAGAGA,68,69,1,10,554,0,0
1426,ACGTCGAATCTAGAGA,68,69,1,10,564,0,0
1433,ACGTCGAATCTAGAGA,68,69,1,10,581,0,0
1461,ACGTCGAATCTAGAGA,68,69,1,13,762,0,0
1469,ACGTCGAATCTAGAGA,68,69,1,10,780,0,0
1471,ACGTCGAATCTAGAGA,68,69,1,13,785,0,0
1490,ACGTCGAATCTAGAGA,68,69,1,13,977,0,0
1502,ACGTCGAATCTAGAGA,68,69,1,10,993,0,0
1506,ACGTCGAATCTAGAGA,68,69,1,13,1000,0,0
1515,ACGTCGAATCTAGAGA,68,69,1,10,1012,0,0
1528,ACGTTGAATCTAGAGA,68,69,1,13,1026,0,0
1531,ACGTCGAATCTAGAGA,68,69,1,16,1030,0,0
1535,ACGTCGAATCTAGAGA,68,69,1,13,1034,0,0
198,ACGTCGAATCTAGAGA,46,70,24,9,129,7,0
316,ACGTCGAATCTAGAGA,51,70,19,8,222,5,0
425,ACGTCGAATCTAGAGA,55,70,15,9,185,4,0
438,ACGTCGAATCTAGAGA,55,70,15,6,290,4,0
459,ACGTCAAATCTAGAGA,56,70,14,7,75,4,0
510,ACGTCGAATCTAGAGA,57,70,13,8,165,3,0
522,ACGTCGAATCTAGAGA,57,70,13,8,276,3,0
569,ACGTCGAATCTAGAGA,58,70,12,9,240,3,0
594,ACGTCGAATCTAGAGA,58,70,12,9,399,3,0
599,ACGTCGAATCTAGAGA,58,70,12,12,406,3,0
623,ACGTCGAATCTAGAGA,59,70,11,10,332,3,0
665,ACGTCGAATCTAGAGA,59,70,11,10,457,3,0
689,ACGTCGAATCTAGAGA,60,70,10,11,359,2,0
732,ACGTCGAATCTAGAGA,61,70,9,6,95,2,0
775,ACGTCGAATCTAGAGA,61,70,9,9,506,2,0
801,ACGTCGAATCTAGAGA,61,70,9,12,546,2,0
819,ACGTCGAATCTAGAGA,62,70,8,7,335,2,0
820,ACGTCGAATCTAGAGA,62,70,8,10,345,2,0
859,ACGTCGAATCTAGAGA,62,70,8,10,574,2,0
874,ACGTCGAATCTAGAGA,62,70,8,10,592,2,0
882,ACGTCGAATCTAGAGA,63,70,7,8,35,1,0
892,ACGTCGAATCTAGAGA,63,70,7,8,273,1,0
918,ACGTCGAACCTAGAGA,63,70,7,11,502,1,0
925,ACGTCGAATCTAGAGA,63,70,7,11,611,1,0
957,ACGTCGAATCTAGAGA,63,70,7,11,665,1,0
989,ACGTCGAATCTAGAGA,64,70,6,12,412,1,0
996,ACGTCGAATCTAGAGA,64,70,6,9,517,1,0
1018,AGGTCGAATCTAGAGA,64,70,6,9,678,1,0
1040,ACGTCGAATCTAGAGA,64,70,6,9,721,1,0
1049,ACGTCGAATCTAGAGA,65,70,5,10,195,1,0
1065,ACGTCGAATCTAGAGA,65,70,5,10,422,1,0
1070,ACGTCGAATCTAGAGA,65,70,5,13,437,1,0
1080,ACGTCGAATCTAGAGA,65,70,5,10,457,1,0
1086,ACGTCGAATCTAGAGA,65,70,5,10,555,1,0
1113,ACGTCGAATCTAGAGA,65,70,5,7,733,1,0
1142,ACGTCGAATCTAGAGA,65,70,5,10,777,1,0
1146,ACGTCGAATCTAGAGC,65,70,5,13,785,1,0
1148,ACGTCGAATCTAGAGA,65,70,5,10,787,1,0
1184,ACGTCGAATCTAGAGA,66,70,4,11,478,0,0
1187,ACGTCGAATCTAGAGA,66,70,4,11,493,0,0
1199,ACGTCGAATCTAGAGA,66,70,4,11,619,0,0
1202,ACGTCGAATCTAGAGA,66,70,4,11,627,0,0
1207,ACGTCGAATCTAGAGA,66,70,4,11,641,0,0
1225,ACGTCGGATCTAGAGA,66,70,4,11,805,0,0
1234,ACGTCGAATCTAGAGA,66,70,4,8,819,0,0
1249,ACGTCGAATCTAGAGA,66,70,4,11,843,0,0
1256,ACGTCGAATCTAGAGA,66,70,4,11,854,0,0
1283,ACGTCGAATCTAGAGA,67,70,3,6,290,0,0
1289,ACGTCGAATCTAGAGA,67,70,3,9,313,0,0
1291,ACGTCGAATCTAGAGA,67,70,3,9,316,0,0
1303,ACGTCGAATCTAGAGA,67,70,3,9,513,0,0
1346,ACGTCGAATCTAGAGA,67,70,3,9,893,0,0
1372,ACGTCGAATCTAGAGA,67,70,3,12,930,0,0
1378,ACGTCGAATCTAGAGA,67,70,3,12,940,0,0
1379,ACGTCGAATCTAGAGA,67,70,3,12,941,0,0
1385,ACGTCGAATCTAGAGA,67,70,3,12,952,0,0
1386,ACGTCGAATCTAGAGA,67,70,3,15,954,0,0
1390,ACGTCGAATCTAGAGA,68,70,2,7,102,0,0
1402,ACGTCGAATCTAGAGA,68,70,2,10,345,0,0
1408,ACGTCGAATCTAGAGA,68,70,2,10,425,0,0
1410,ACGTCGAATCTAGAGA,68,70,2,10,436,0,0
1414,ACGTCGAATCTAGAGA,68,70,2,10,442,0,0
1418,ACGTCGAATCTAGAGA,68,70,2,13,452,0,0
1420,ACGTCGAATCTAGAGA,68,70,2,10,457,0,0
1425,ACGTCGAATCTAGAGA,68,70,2,10,560,0,0
1438,ACGTCGAATCTAGAGA,68,70,2,10,591,0,0
1447,ACGTCGAATCTAGAGA,68,70,2,10,736,0,0
1449,ACGTCGAATCTAGAGA,68,70,2,10,740,0,0
1463,ACGTCGAATCAAGAGA,68,70,2,10,764,0,0
1468,ACGTCGAATCTAGAGA,68,70,2,10,777,0,0
1486,ACGTCGAATCTAGAGA,68,70,2,10,971,0,0
1500,ACGTCGAATCTAGAGA,68,70,2,13,989,0,0
1504,ACGTCGAATCTAGAGA,68,70,2,10,996,0,0
1516,ACGTCGAATCTAGAGA,68,70,2,10,1013,0,0
1519,ACGTCGACTCTAGAGA,68,70,2,10,1017,0,0
1525,ACGTCGAATCTAGAGA,68,70,2,13,1023,0,0
1536,ACGTCGAATCTAGAGA,68,70,2,13,1035,0,0
1579,ACGTCGAATCTAGAGA,69,70,1,11,645,0,0
1580,ACGTCGAATCTAGAGA,69,70,1,14,646,0,0
1612,ACGTCGAATCTAGAGA,69,70,1,11,836,0,0
1618,ACGTCGAATCTAGAGA,69,70,1,11,854,0,0
1619,ACATCGAATCTAGAGA,69,70,1,11,855,0,0
1634,ACGTCGAATCTAGAGA,69,70,1,11,1049,0,0
1640,ACGTCGAATCTAGACA,69,70,1,11,1056,0,0
1644,ACGTCGAATCTAGAGA,69,70,1,11,1062,0,0
1650,ACGTCGAATCTAGAGA,69,70,1,14,1070,0,0
1662,ACGTCGAATCTAGAGA,69,70,1,11,1092,0,0
1663,ACGTCGAATCTAGAGA,69,70,1,11,1093,0,0
1675,ACGTCGAATCTAGAGA,69,70,1,8,1112,0,0
1680,ACGTCGAATCTAGAGA,69,70,1,11,1119,0,0
1681,ACGTCGAATCCAGCGA,69,70,1,14,1120,0,0
1684,ACGTCGAATCTAGAGA,69,70,1,11,1123,0,0
1686,ACGTCGAATCTAGAGA,69,70,1,11,1127,0,0
262,ACGTCGAATCTAGAGA,49,71,22,9,184,6,0
269,ACGTCGAATCTAGAGA,50,71,21,7,61,6,0
271,ACGTCGAATCTAGAGA,50,71,21,7,75,6,0
321,ACGTCGAATCTAGAGA,52,71,19,9,51,5,0
421,ACGTCGAATCTAGAGA,55,71,16,9,136,4,0
442,ACGTCGAATCTAGAGA,55,71,16,9,295,4,0
471,ACGTCGAATCTAGAGA,56,71,15,10,207,4,0
478,ACGTCGAATCTAGAGA,56,71,15,10,262,4,0
542,ACGTCGAATCTAGAGA,57,71,14,11,370,4,0
619,ACGTCGAATCTAGAGA,59,71,12,10,266,3,0
624,ACGTCGAATCTAGAGA,59,71,12,10,333,3,0
702,ACGTCGAATCTAGAGA,60,71,11,11,461,3,0
754,ACGTCGAATCTAGAGA,61,71,10,12,311,2,0
772,ACGTCGAATCTAGAGA,61,71,10,12,412,2,0
803,ACGTCGAATCTAGAGA,62,71,9,7,102,2,0
831,ACGTCGAATCTAGAGA,62,71,9,10,436,2,0
846,ACGTCGAATCTAGAGA,62,71,9,10,550,2,0
863,ACGTCGAATCTAGAGA,62,71,9,10,578,2,0
868,ACGTCGAATCTGGAGA,62,71,9,13,584,2,0
888,ACGTCGAATCTAGAGA,63,71,8,8,220,2,0
936,ACGTCGAACCTAGAGA,63,71,8,11,633,2,0
993,ACGTCGAATCTAGAGA,64,71,7,9,510,1,0
997,ACGTCGAATCTAGAGA,64,71,7,12,521,1,0
1012,ACGTCGAATCTAGAGA,64,71,7,9,670,1,0
1032,ACGTCGAATCTAGAGA,64,71,7,12,702,1,0
1037,ACGTCGAATCTAGAGA,64,71,7,12,717,1,0
1050,ACGTCGAATCTAGAGA,65,71,6,7,196,1,0
1091,ACGTCGAATCTAGAGA,65,71,6,7,571,1,0
1118,ACGTCGAATCTAGAGA,65,71,6,10,740,1,0
1150,ACGTCGAATCTAGAGA,65,71,6,10,789,1,0
1155,ATGTCGAATCTAGAGA,65,71,6,13,794,1,0
1161,ACGTCGAATCTAGAGA,65,71,6,16,802,1,0
1165,ACGTCGAATCTAGAGA,66,71,5,8,213,1,0
1206,ACGTCGAATCTAGAGA,66,71,5,11,640,1,0
1226,ACGTCGAATCTAGAGA,66,71,5,11,806,1,0
1227,ACGTCGAATCTAGAGA,66,71,5,8,810,1,0
1351,ACGTCGAATCTAGAGA,67,71,4,9,902,0,0
1357,ACGTCGAATCTAGAGA,67,71,4,12,908,0,0
1400,ACGTCGAATCTAGAGA,68,71,3,10,321,0,0
1406,ACGTCGAATCTAGAGA,68,71,3,10,421,0,0
1412,ACGTCGAATCTAGAGA,68,71,3,7,438,0,0
1419,ACGTCGAATCTAGAGA,68,71,3,10,454,0,0
1428,ACGTCGAATCTAGAGA,68,71,3,10,572,0,0
1436,ACGTCGAATCTAGAGA,68,71,3,10,588,0,0
1437,ACGTCGAATCTAGAGA,68,71,3,10,589,0,0
1443,ACGTCGAATCTAGAGA,68,71,3,7,732,0,0
1460,ACGTCGAATCTAGAGA,68,71,3,10,760,0,0
1476,ACGTCGAATCTAGAGA,68,71,3,13,800,0,0
1478,ACGTCGAATCTAGAGA,68,71,3,16,802,0,0
1480,ACGTCGAATCTAGAGA,68,71,3,10,960,0,0
1483,ACGTCGAATCTAGAGA,68,71,3,10,968,0,0
1501,ACGTCGAATCTAGAGA,68,71,3,10,992,0,0
1508,ACGTCGAATCTAGAGA,68,71,3,13,1003,0,0
1523,ACGTCGAATCTAGAGA,68,71,3,10,1021,0,0
1537,ACGTCGAATCTAGAGA,68,71,3,13,1036,0,0
1562,ACGTCGAATCTAGAGA,69,71,2,11,478,0,0
1564,ACGTCGAATATAGAGA,69,71,2,11,493,0,0
1574,ACGTCGAATCTAGAGA,69,71,2,11,624,0,0
1599,ACGTCGAATCTAGAGA,69,71,2,11,817,0,0
1600,ACGTCGAATCTAGAGA,69,71,2,11,818,0,0
1602,ACGTCGAATCTAGAGA,69,71,2,11,820,0,0
1606,ACGTCGAATCTAGAGA,69,71,2,11,830,0,0
1627,ACGTCGAATCTGGAGA,69,71,2,14,868,0,0
1631,ACGTCGAATCTAGAGA,69,71,2,11,877,0,0
1641,ACGTCGAATCTAGAGA,69,71,2,11,1058,0,0
1651,ACGTCGACTCTAGAGA,69,71,2,11,1073,0,0
1654,ACGTCGAATCTAGAGA,69,71,2,14,1078,0,0
1678,ACGTCGAATCTAGAGA,69,71,2,11,1117,0,0
1687,ACGTCGAATCTAGAGA,69,71,2,14,1131,0,0
1692,ACGTCGAATCTAGAGA,69,71,2,11,1139,0,0
1701,ACGTCGAATCTAGAGA,69,71,2,11,1150,0,0
1724,ACGTCGAATCTAGAGA,70,71,1,12,392,0,0
1730,ACGTCGAATCTAGAGA,70,71,1,9,513,0,0
1732,ACGTCGAATCTAGAGA,70,71,1,12,521,0,0
1735,ACGTCGAATCTAGAGA,70,71,1,12,542,0,0
1739,ACGTCGAATCTAGAGA,70,71,1,9,671,0,0
1741,ACGTCGAATCTAGAGA,70,71,1,9,680,0,0
1749,ACGTCGAATCTAGAGA,70,71,1,9,704,0,0
1767,ACGTCGAATCTAGAGA,70,71,1,12,906,0,0
1769,ACGTCGAATCTAGAGA,70,71,1,12,912,0,0
1791,ACGTCGAATCTAGAGA,70,71,1,12,946,0,0
1792,ACGTCGAATCTAGAGA,70,71,1,12,951,0,0
1800,ACGTCGAATCTAGAGA,70,71,1,12,1173,0,0
1804,ACGTCGAATCTAGAGA,70,71,1,12,1181,0,0
1811,ACGTCGAATCTAGAGA,70,71,1,9,1192,0,0
1813,ACGTCGAATCTAGAGA,70,71,1,12,1196,0,0
1815,ACGTCGAATCTAGAGA,70,71,1,12,1200,0,0
1826,ACGTCGAATCTGGAGA,70,71,1,12,1220,0,0
1838,ACTTCGAATCTAGAGA,70,71,1,12,1239,0,0
1848,ACGTCGAATCTAGAGA,70,71,1,12,1254,0,0
1853,ACGTCGAATCTAGAGA,70,71,1,12,1261,0,0
1854,ACGTCGAATCTAGAGA,70,71,1,15,1262,0,0
1857,ACGTCGAATCTGGAGA,70,71,1,15,1266,0,0
196,ACGTCGAATCTAGAGA,46,72,26,6,95,8,0
207,ACGTCGAATCTAGAGA,46,72,26,9,140,8,0
299,ACGTCGAATCTAGAGA,51,72,21,8,158,6,0
370,ACGTCGAATCTAGAGA,53,72,19,10,251,5,0
405,ACGTCGAATCTAGAGA,54,72,18,8,273,5,0
445,ACGTCGAATCTAGAGA,55,72,17,9,299,5,0
452,ACGTCGAATCTAGAGA,55,72,17,12,309,5,0
461,ACGTCGAATCTAGAGA,56,72,16,10,114,4,0
548,ACGTCGAATCTAGAGA,58,72,14,6,22,4,0
655,ACGTCGAATCTAGAGA,59,72,13,10,444,3,0
747,ACGTCGAATCTAGAGA,61,72,11,9,296,3,0
750,ACGTCGAATCTAGAGA,61,72,11,9,302,3,0
773,ACGTCGAATCTAGAGA,61,72,11,9,504,3,0
786,ACGTCGAATCTAGAGA,61,72,11,12,524,3,0
791,ACGTCGAATCTAGAGA,61,72,11,12,533,3,0
802,ACGTCGAATCTAGAGA,61,72,11,15,547,3,0
813,ACGTCGAATCTAGAGT,62,72,10,10,261,2,0
877,ACGTCGAATCTAGAGA,62,72,10,10,596,2,0
883,ACGTCGAATCTAGAGA,63,72,9,8,65,2,0
890,ACGTCGAATCTAGAGA,63,72,9,8,269,2,0
907,ACGTTGAATCTAGAGA,63,72,9,11,469,2,0
942,ACGTCGAATCTAGAGA,63,72,9,11,644,2,0
952,ACGTCGAATCTAGAGA,63,72,9,11,657,2,0
970,ACGTCGAATCTAGAGA,64,72,8,6,290,2,0
978,ACGTCGAATCTAGAGA,64,72,8,9,313,2,0
1000,ACGTCGAATCTAGAGA,64,72,8,12,524,2,0
1044,ACGTCGAATCTAGAGA,64,72,8,12,726,1,0
1047,ACGTCGAATCTAGAGA,65,72,7,7,102,1,0
1053,ACGTCGAATCTAGAGA,65,72,7,7,245,1,0
1054,ACGTCGAATCTAGAGA,65,72,7,10,253,1,0
1061,ACGTCGAATCTAGAGA,65,72,7,13,349,1,0
1089,ACGTCGAATCTAGAGA,65,72,7,10,564,1,0
1131,ACGTCGAATCTAGAGA,65,72,7,13,758,1,0
1134,ACGTCGAATCTAGAGA,65,72,7,13,762,1,0
1136,ACGTCGAATCAAGAGA,65,72,7,10,764,1,0
1139,ACGTCGAATCTAGAGA,65,72,7,10,773,1,0
1143,ACGTCGAATCTAGAGA,65,72,7,10,780,1,0
1192,ACGTCGAATCTAGAGA,66,72,6,8,603,1,0
1208,ACGTCGAATCTAGAGA,66,72,6,11,642,1,0
1209,ACGTCGAATCTAGAGA,66,72,6,11,644,1,0
1211,ACGTCGAATCTAGAGA,66,72,6,14,646,1,0
1246,ACGTCGAATCTAGAGA,66,72,6,11,836,1,0
1250,ACGTCGAATCTAGAGA,66,72,6,14,844,1,0
1260,ACGTCGAATCTAGAGA,66,72,6,11,861,1,0
1265,ACGTCGAATCTAGAGA,66,72,6,11,867,1,0
1266,ACGTCGAATCTGGAGA,66,72,6,14,868,1,0
1274,ACGTCGAATCTAGAGA,66,72,6,14,881,1,0
1279,ACGTCGAATCTAGAGA,67,72,5,9,228,1,0
1285,ACGTCGAATCTAGAGA,67,72,5,9,299,1,0
1304,ACGTCGAATCTAGAGA,67,72,5,9,517,0,0
1305,ACGTCGAATCTAGAGA,67,72,5,12,521,0,0
1309,ACGTCGAATCTAGAGA,67,72,5,12,542,0,0
1312,ACGTCGAATCTAGAGA,67,72,5,9,670,0,0
1317,AGGTCGAATCTAGAGA,67,72,5,9,678,0,0
1324,ACGTTGAATCTAGAGA,67,72,5,12,693,0,0
1355,ACGTCGAATCTAGAGA,67,72,5,12,906,0,0
1380,ACGTCGAATCTAGAGA,67,72,5,12,942,0,0
1383,ACGTCGAATCTAGAGA,67,72,5,12,946,0,0
1387,ACGTCGAATCTAGAGA,67,72,5,12,955,0,0
1392,ACGTCGAATCTAGAGA,68,72,4,10,195,0,0
1445,ACGTCGAATCTAGAGA,68,72,4,10,734,0,0
1446,ACGTCGAATCTAGAGA,68,72,4,10,735,0,0
1450,ACGTCGAATCTAGAGA,68,72,4,7,746,0,0
1459,ACGTCGAATCTAGAGA,68,72,4,10,759,0,0
1477,ACGTCGAATCTAGAGA,68,72,4,13,801,0,0
1556,ACGTCGAATCTAGAGA,69,72,3,8,462,0,0
1575,ACGTCGAATCTAGAGA,69,72,3,11,627,0,0
1578,ACGTCGAATCTAGAGA,69,72,3,11,644,0,0
1581,ACGTCGAATCTAGAGA,69,72,3,14,647,0,0
1591,ACGTCGAATCTAGAGA,69,72,3,11,804,0,0
1593,ACGTCGAATCTAGAGA,69,72,3,11,806,0,0
1609,ACGTCGAATCTAGAGA,69,72,3,8,833,0,0
1614,ACGTCGAATCTAGAGA,69,72,3,11,846,0,0
1623,ACGTCGAATCTAGAGA,69,72,3,11,863,0,0
1625,ACGTCGAATCTAGAGA,69,72,3,11,865,0,0
1632,ACGTCGAATCTAGAGA,69,72,3,11,878,0,0
1647,ACGTCGAATCTAGAGA,69,72,3,11,1067,0,0
1652,ACGTCGAATCTAGAGA,69,72,3,11,1075,0,0
1658,ACGTCGAATCTAGGGA,69,72,3,11,1086,0,0
1668,ACGTCGAATCTAGAGA,69,72,3,11,1100,0,0
1673,ACGTCGAATCTAGAGA,69,72,3,14,1109,0,0
1693,ACGTCGAATCTAGAGA,69,72,3,11,1141,0,0
1694,ACGTCGATTCTAGAGA,69,72,3,11,1142,0,0
1697,ACGTCGAATCTAGAGA,69,72,3,11,1145,0,0
1711,ACGTCGAATCTAGAGA,70,72,2,9,133,0,0
1746,ACGTCGAATCTAGAGA,70,72,2,12,698,0,0
1747,ACGTCGAATCTAGAGA,70,72,2,15,700,0,0
1755,ACGTCGAATCTAGAGA,70,72,2,12,724,0,0
1764,ACGTCAAATCTAGAGA,70,72,2,9,899,0,0
1778,ACGTCGAATCTAGAGA,70,72,2,12,928,0,0
1780,ACGTCGAATCTAGAGA,70,72,2,12,930,0,0
1807,ACGTCGAATCTAGAGA,70,72,2,15,1186,0,0
1821,ACGTCGAATCTAGAGA,70,72,2,12,1208,0,0
1825,ACGTCGAATCTAGAGA,70,72,2,15,1218,0,0
1855,ACGTCGAATCTAGAGA,70,72,2,12,1264,0,0
1859,ACGTCGAATCTAGAGA,70,72,2,12,1269,0,0
1863,ACGTCGAATCTAGAGA,70,72,2,15,1274,0,0
1871,ACGTCGAATCTAGAGA,71,72,1,7,335,0,0
1872,ACGTCGAATCTAGAGA,71,72,1,10,345,0,0
1875,ACGTCGAATCTAGAGA,71,72,1,7,418,0,0
1885,ACGTCGAATCTAGAGA,71,72,1,7,548,0,0
1892,ACGTCGAATCTAGAGA,71,72,1,10,576,0,0
1897,ACGTCGAATCTAGAGA,71,72,1,10,588,0,0
1901,ACGTTGAATCTAGAGA,71,72,1,13,601,0,0
1912,ACGTCGAATCTAGAGA,71,72,1,10,750,0,0
1924,ACGTCGAATCTAGAGA,71,72,1,13,786,0,0
1925,ACGTCGAATCTAGAGA,71,72,1,13,790,0,0
1926,ACGTCGAATCTAGAGA,71,72,1,13,791,0,0
1928,ACGTCGAATCTAGAGA,71,72,1,13,800,0,0
1938,ACGTCGAATCTAGAGA,71,72,1,10,975,0,0
1950,ACGTCGAATCTAGAGA,71,72,1,13,1000,0,0
1951,ACGTCGAATCTAGAGA,71,72,1,13,1002,0,0
1961,ACGTCGAATCTAGAGA,71,72,1,10,1279,0,0
1965,ACGTCGAATCTAGAGA,71,72,1,10,1287,0,0
1971,ACGTCGAATCTAGAGA,71,72,1,13,1358,0,0
87,ACGTCGAATCTAGAGA,38,73,35,7,45,11,0
273,ACGTCGAATCTAGAGA,50,73,23,7,111,7,0
304,ACGTCGAATCTAGAGA,51,73,22,8,170,6,0
431,ACGTCGAATCTAGAGA,55,73,18,9,232,5,0
493,ACGTCGAATCTAGAGA,56,73,17,10,338,5,0
671,ACGTCGAATCTAGAGA,60,73,13,8,93,3,0
681,ACGTCGAATCTAGAAA,60,73,13,8,271,3,0
727,ACGTCGAATCTAGAGA,60,73,13,11,501,3,0
733,ACGTCGAATCTAGAGA,61,73,12,6,96,3,0
833,ACGTCGAATCTAGAGA,62,73,11,7,438,3,0
842,ACGTCGAATCTAGAGA,62,73,11,10,454,3,0
855,ACATCGAATCTAGAGA,62,73,11,10,564,3,0
937,ACGTCGAATCTAGAGA,63,73,10,8,635,2,0
954,ACGTCGAATCTAGAGA,63,73,10,14,661,2,0
971,ACGTCGAATCTAGAGA,64,73,9,9,296,2,0
972,ACGTCGAATCTAGAGA,64,73,9,9,299,2,0
992,ACGTCGAATCTAGAGA,64,73,9,9,509,2,0
1002,ACGTCGAATCTAGAGA,64,73,9,12,533,2,0
1008,ACGTCGAATCTAGAGA,64,73,9,12,545,2,0
1010,ACGTCGAATCTAGAGA,64,73,9,9,667,2,0
1016,ACGTCGAATCTAGAGA,64,73,9,12,675,2,0
1069,ACGTCGAATCTAGAGA,65,73,8,10,436,1,0
1075,ACGTCGAATCTAGAGA,65,73,8,10,445,1,0
1112,ACGTCGAATCTAGAGA,65,73,8,7,732,1,0
1122,ACGTCGAATCTAGAGA,65,73,8,10,747,1,0
1145,ACGTCGAATCTAGAGA,65,73,8,10,784,2,0
1172,ACGTCGAATCTAGAGA,66,73,7,11,359,1,0
1177,ACGTCGAATCTAGAGA,66,73,7,8,463,1,0
1182,ACGTCGAATCTAGAGA,66,73,7,11,474,1,0
1239,ACTTCGAATCTAGAGA,66,73,7,11,829,1,0
1241,ACGTCGAATCTAGAGA,66,73,7,11,831,1,0
1247,ACGTCGAATCTAGAGA,66,73,7,11,839,1,0
1258,ACGTCGAATCTAGAGA,66,73,7,11,856,1,0
1296,ACGTCGAATCTAGAGA,67,73,6,9,405,1,0
1310,ACGTCGAATCTAGAGA,67,73,6,12,545,1,0
1331,ACGTCGAATCTAGAGA,67,73,6,12,712,0,0
1354,ACGTCGAATCTAGAGA,67,73,6,12,905,0,0
1374,ACGTCGAATCTAGAGA,67,73,6,12,933,0,0
1375,ACGTCGAACCTAGAGA,67,73,6,12,936,0,0
1393,ACGTCGAATCTAGAGA,68,73,5,7,196,1,0
1397,ACGTCGAATCTAGAGA,68,73,5,10,261,0,0
1415,ACGTCGAATCTAGAGA,68,73,5,10,444,0,0
1442,ACGTTGAATCTAGAGA,68,73,5,13,601,0,0
1448,ACGTCGAATCTAGAGA,68,73,5,10,737,1,0
1454,ACGTCGAATCTAGAGA,68,73,5,10,750,0,0
1465,ACGTCGAATCTAGAGA,68,73,5,13,772,0,0
1466,ACGTCGAATCTAGAGA,68,73,5,10,773,0,0
1499,ACGTCGAATCTAGAGA,68,73,5,13,988,0,0
1529,ACGTCGAAGCTAGAGA,68,73,5,10,1027,0,0
1542,ACGTCGAATCTAGAGA,68,73,5,13,1044,0,0
1551,ACGTCGAATCTAGAGA,69,73,4,8,350,0,0
1571,ACGTCGAATCTAGAGA,69,73,4,11,617,0,0
1572,ACGTCGAATCTAGAGA,69,73,4,11,619,0,0
1577,ACGTCGAATCTAGAGA,69,73,4,11,640,0,0
1585,ACGTCGAATCTAGAGA,69,73,4,11,660,0,0
1630,ACGTCTAATCTAGAGA,69,73,4,11,874,0,0
1655,ACCTCGAATCTAGAGA,69,73,4,11,1080,0,0
1698,ACGTCGAATCTAGAGC,69,73,4,14,1146,0,0
1705,ACGTCGAATCTAGAGA,69,73,4,14,1157,0,0
1709,ACGTCGAATCTAGAGA,70,73,3,6,22,0,0
1710,ACGTCGAATCTAGAGA,70,73,3,6,95,0,0
1719,ACGTCGAATGTAGAGA,70,73,3,9,302,0,0
1726,ACGTCGAATCTAGAGA,70,73,3,9,405,0,0
1731,ACGTCGAATCTAGAGA,70,73,3,9,517,0,0
1750,ACGTCGAATCTAGAGA,70,73,3,12,712,0,0
1786,ACGTCGAATCTAGAGA,70,73,3,12,940,0,0
1822,ACGTCGAATCTAGAGA,70,73,3,12,1209,0,0
1850,ACGTCGAATCTAGAGA,70,73,3,12,1258,0,0
1880,ACGTCGAATCTAGAGA,71,73,2,10,445,0,0
1889,ACGTCGAATCTAGAGA,71,73,2,10,564,0,0
1890,ACGTCGAATCTAGAGA,71,73,2,10,572,0,0
1899,ACGTCGAATCTAGAGA,71,73,2,10,591,0,0
1918,ACGTCGAATCTAGAGA,71,73,2,10,767,0,0
1956,ACGTCGAATCTAGAGA,71,73,2,13,1009,0,0
1958,ACGTCGAATCTAGAGA,71,73,2,10,1033,0,0
1966,ACGTCGAATCTAGAGA,71,73,2,13,1288,0,0
1980,ACGTCGAATCTAGAGA,72,73,1,8,463,0,0
1986,ACGTCGAATCTAGAGA,72,73,1,14,497,0,0
2027,ACGTCGAATCTAGAGA,72,73,1,11,852,0,0
2041,ACGTCGAATCTAGAGA,72,73,1,10,1017,0,0
2042,ACGTCGAATCTAGAGA,72,73,1,10,1019,0,0
2053,ACGTCGAATCTAGAGA,72,73,1,11,1052,0,0
2066,ACGTCGAATCTAGAGA,72,73,1,13,1297,0,0
2082,ACGTTGAATCTAGAGA,72,73,1,13,1356,0,0
2090,ACGTCGAATCTAGAGA,72,73,1,11,1462,0,0
345,ACGTCGAATCTAGAGA,52,74,22,9,238,6,0
454,ACGTCGAATCTAGAGA,55,74,19,9,313,5,0
592,ACGTCGAATCTAGAGA,58,74,16,9,394,4,0
644,ACGTCGAATCTAGAGA,59,74,15,10,427,4,0
646,ACGTCGAATCTAGAGA,59,74,15,13,432,4,0
647,ACGTCGAATCTAGAGA,59,74,15,13,433,4,0
663,ACGTCGAATCTAGAGA,59,74,15,10,454,4,0
712,ACGTCGAATCTAGAGA,60,74,14,11,474,4,0
756,ACGTCGAATCTAGAGA,61,74,13,9,314,3,0
784,ACGTCGAATCTAGAGA,61,74,13,9,522,3,0
834,ACGTCGAATCTAGAGA,62,74,12,10,440,3,0
873,ACGTCGAATCTAGAGA,62,74,12,10,591,3,0
886,ACGTCGAATCTAGAGA,63,74,11,8,165,3,0
899,ACGTCAAATCTAGAGA,63,74,11,8,459,3,0
922,ACGTCGAATCTAGAGA,63,74,11,8,608,3,0
923,ACGTCGAATCTAGAGA,63,74,11,11,609,3,0
924,ACGTCGAATCTAGAGA,63,74,11,11,610,3,0
973,ACGTCGAATCTAGAGA,64,74,10,9,301,2,0
995,ACGTCGAATCTAGAGA,64,74,10,9,513,2,0
1020,ACGTCGAATCTAGAAA,64,74,10,9,681,2,0
1033,ACGTCGAATCTAGAGA,64,74,10,9,704,2,0
1034,ACGTCGAATCTAGAGA,64,74,10,12,708,2,0
1035,ACGTCGAATCTAGAGA,64,74,10,12,712,2,0
1073,ACGTCGACTCTAGAGA,65,74,9,10,442,2,0
1095,ACGTCGAATCTAGAGA,65,74,9,10,576,1,0
1115,ACGTCGAATCTAGAGA,65,74,9,10,735,2,0
1121,ACGTCGAATCTAGAGA,65,74,9,7,746,1,0
1123,ACGTCGAATCTAGAGA,65,74,9,10,748,2,0
1138,ACGTCGAATCTAGAGA,65,74,9,13,772,2,0
1144,ACGTCGAATCTAGAGA,65,74,9,10,782,2,0
1183,ACGTCGAATCTAGAGA,66,74,8,11,476,2,0
1200,ACGTCGAATCTAGAGA,66,74,8,11,623,1,0
1271,ACGTCGAATCTAGAGA,66,74,8,11,877,1,0
1334,ACGTCGAATCTAGAGA,67,74,7,12,719,0,0
1360,ACGTCGAATCTAGAGA,67,74,7,15,914,0,0
1365,ACGTCGAATCTAGAGA,67,74,7,12,923,0,0
1384,ACGTCGAATCTAGAGA,67,74,7,12,951,1,0
1422,ACGTCGAATCTAGAGA,68,74,6,7,553,0,0
1440,ACGTCGAATCTAGAGA,68,74,6,10,594,0,0
1441,ACGTCGAATCTAGAGA,68,74,6,13,599,0,0
1453,ACGTCGAATCTAGAGA,68,74,6,10,749,1,0
1513,ACGTCGAATCTAGAGA,68,74,6,10,1010,0,0
1518,ACGTCGAATCTAGAGA,68,74,6,13,1016,0,0
1544,ACGTCGAATCTAGAGA,69,74,5,8,35,0,0
1554,ACGTCAAATCTAGAGA,69,74,5,8,459,0,0
1568,ACGTCGAATCTAGAGA,69,74,5,14,503,0,0
1629,ACGTCGAATCTAGAGA,69,74,5,11,873,0,0
1638,ACGTCGAATCTAGAGA,69,74,5,11,1054,0,0
1639,ACGTCGAATCTAGAGA,69,74,5,11,1055,0,0
1649,ATGTCGAATCTAGAGA,69,74,5,11,1069,0,0
1659,ACGTCGAATCTAGAGA,69,74,5,11,1087,0,0
1666,ACGTCGGATCTAGAGA,69,74,5,11,1096,0,0
1700,ACGTCGAATCTAGAGA,69,74,5,11,1149,0,0
1706,ACGTCGAATCTAGAGA,69,74,5,14,1158,1,0
1712,ACGTCGAATCTAGAGA,70,74,4,9,185,0,0
1713,ACGTCGAATCTAGAGA,70,74,4,9,228,0,0
1751,ACGTCGAATCTAGAGA,70,74,4,12,714,0,0
1756,ACGTCGAATCTAGAGA,70,74,4,12,727,0,0
1758,ACGTCGAATCTAGAGA,70,74,4,9,886,0,0
1796,ACGTCGAATCTAGAGA,70,74,4,9,1163,0,0
1818,ACGTCGAACCTAGAGA,70,74,4,12,1204,0,0
1827,ACGTCGAATCTAGAGA,70,74,4,12,1221,0,0
1833,ACGTCGAATCTAGAGT,70,74,4,12,1230,0,0
1837,ACGTCGAATCTAGAGA,70,74,4,12,1237,0,0
1895,ACGTCGAATCTAGAGA,71,74,3,10,582,0,0
1907,ACGTCGAATCTAGAGA,71,74,3,10,740,0,0
1919,ACGTCGAATCTAGAGA,71,74,3,10,773,0,0
1922,ACGTCGAATCTAGAGA,71,74,3,10,784,0,0
1927,ACGTCGAATCTAGAGA,71,74,3,13,797,0,0
1944,ACGTCGAATCTAGAGA,71,74,3,10,985,0,0
1948,ACGTCGAATCTAGAGA,71,74,3,10,992,0,0
1949,ACGTCGAATCTAGAGA,71,74,3,10,995,0,0
1959,ACGTCGAATCTAGAGA,71,74,3,13,1039,0,0
1988,ACGTCGAACCTAGAGA,72,74,2,11,502,0,0
1996,ACGTCGAATCTAGAGA,72,74,2,11,644,0,0
2010,ACGTCGAATCTAGAGA,72,74,2,11,811,0,0
2015,ACGTCGAATCTAGAGA,72,74,2,14,822,0,0
2033,ACGTCGAATCTAGAGA,72,74,2,11,865,0,0
2035,ACGTCGAATCTAGAGA,72,74,2,14,872,0,0
2048,ACGTCGAATCTAGAGA,72,74,2,13,1025,0,0
2049,ACGTTGAATCTAGAGA,72,74,2,13,1026,0,0
2059,ACGTCGAATCTAGAGA,72,74,2,11,1133,0,0
2073,ACGTCGAATCTAGAGA,72,74,2,10,1313,0,0
2078,ACGTCGAATCTAGAGA,72,74,2,13,1325,0,0
2089,ACGTCGAATCTAGAGA,72,74,2,11,1452,0,0
2102,ACGTCGAATCTAGAGA,73,74,1,12,309,0,0
2107,ACGTCGAATCTAGAGA,73,74,1,12,412,0,0
2112,ACGTCGAATCTAGAGA,73,74,1,12,521,0,0
2117,ACGTCGAATCTAGAGA,73,74,1,9,670,0,0
2118,AGGTCGAATCTAGAGA,73,74,1,9,678,0,0
2123,ACGTCGAATCTAGAGA,73,74,1,12,698,0,0
2144,ACGTCGAATCTAGAGA,73,74,1,9,922,0,0
2169,ACGTCGAATCTAGAGA,73,74,1,12,1181,0,0
2185,ACGTCGAATCTAGAGA,73,74,1,11,1453,0,0
2198,ACGTCGAATCTAGAGA,73,74,1,9,1656,0,0
224,ACGTCGAATCTAGAGA,47,75,28,10,155,8,0
359,ACGTCGAATCTAGAGA,53,75,22,10,195,6,0
422,ACGTCGAATCTAGAGA,55,75,20,9,137,6,0
465,ACGTCGAATCTAGAGA,56,75,19,10,195,5,0
503,ACGTCGAATCTAGAGA,56,75,19,13,349,5,0
553,ACGTCGAATCTAGAGA,58,75,17,6,96,5,0
651,ACGTCGAATCTAGAGA,59,75,16,7,438,4,0
660,ACGTCGAATCTAGAGA,59,75,16,10,451,4,0
829,ACTTCGAATCTAGAGA,62,75,13,10,427,3,0
946,ACGTCGAATCTAGAGA,63,75,12,11,648,3,0
955,ACGTCGAATCTAGAGA,63,75,12,11,663,3,0
961,ACGTCGAATCTAGAGA,64,75,11,6,95,2,0
968,ACGTCGAATCTAGAGA,64,75,11,9,240,2,0
975,ACGTCGAATCTAGAGA,64,75,11,9,304,3,0
1021,ACGTCGAATCTAGAGA,64,75,11,9,684,2,0
1030,ACGTCGAATCTAGAGA,64,75,11,15,700,2,0
1055,ACGTCGAATCTAGAGA,65,75,10,10,261,2,0
1094,ACGTCGAATCTAGAGA,65,75,10,10,575,1,0
1109,ACGTCGAATCTAGAGA,65,75,10,13,599,1,0
1127,ACGTCGAATCTAGAGA,65,75,10,10,752,2,0
1174,ACGTCAAATCTAGAGA,66,75,9,8,459,1,0
1181,ACGTCGAATCTAGAGA,66,75,9,11,471,2,0
1191,ACGTCGAATCTAGAGA,66,75,9,14,503,1,0
1240,ACGTCGAATCTAGAGA,66,75,9,11,830,2,0
1284,ACGTCGAATCTAGAGA,67,75,8,9,296,1,0
1292,ACGTCGAATCTAGAGA,67,75,8,9,387,1,0
1308,ACGTCGAATCTAGAGA,67,75,8,12,524,1,0
1325,ACGTCGAATCTAGAGA,67,75,8,12,696,1,0
1339,ACGTCGAATCTAGAGA,67,75,8,9,882,0,0
1358,ACGTCGAATCTAGAGA,67,75,8,12,912,1,0
1366,ACGTCGAATCTAGAGA,67,75,8,12,924,1,0
1367,ACGTCGAATCTAGAGA,67,75,8,12,925,0,0
1388,ACGTCGAATCTAGAGA,67,75,8,12,957,1,0
1399,ACGTCGAATCTAGAGA,68,75,7,10,263,1,0
1472,ACGTCGAATCTAGAGA,68,75,7,13,786,0,0
1487,ACGTCGAATCTAGAGA,68,75,7,10,972,0,0
1489,ACGTCGAATCTAGAGA,68,75,7,10,975,0,0
1495,ACGTCGAATCTAGAGA,68,75,7,10,983,0,0
1498,ACGTCGAATCTAGAGA,68,75,7,10,987,0,0
1521,ACGTCGAATCTAGAGA,68,75,7,10,1019,0,0
1549,ACGTCGAATCTAGAGA,69,75,6,8,271,0,0
1576,ACGTCGAACCTAGAGA,69,75,6,11,633,1,0
1594,ACGTCGAATCTAGAGA,69,75,6,8,810,0,0
1595,ACGTCGAATCTAGAGA,69,75,6,11,811,0,0
1598,AAGTCGAATCTAGAGA,69,75,6,11,814,0,0
1601,ACGTCGAATCTAGAGA,69,75,6,8,819,0,0
1605,ACTTCGAATCTAGAGA,69,75,6,11,829,0,0
1610,ACGTCGAATCTAGAGA,69,75,6,11,834,0,0
1628,ACGTCGAATCTAGAGA,69,75,6,14,872,0,0
1671,ACGTCGAATCTAGAGA,69,75,6,11,1104,0,0
1685,ACGTCGAATCTAGAGA,69,75,6,11,1124,0,0
1708,ACGTCGAATCTAGAGA,69,75,6,17,1161,0,0
1729,ACGTCGAATCTAGAGA,70,75,5,9,511,0,0
1737,ACGTCGAATCTAGAGA,70,75,5,12,546,0,0
1745,ACGTCGAATCTAGAGA,70,75,5,12,696,0,0
1772,ACGTCGAATCTAGAGA,70,75,5,9,921,0,0
1788,ACGTCGAATCTAGAGA,70,75,5,12,942,0,0
1828,ACGTCGAATCTAGAGA,70,75,5,15,1222,1,0
1836,ACGTCGAATCTAGAGA,70,75,5,12,1235,0,0
1883,ACGTCGAATCTAGAGA,71,75,4,10,454,0,0
1906,ACGTCGAATCTAGAGA,71,75,4,10,737,0,0
1917,ACGTCGAATCAAGAGA,71,75,4,10,764,0,0
1943,ACGTCGAATCTAGAGA,71,75,4,10,982,0,0
1945,ACGTCGAATCTAGAGA,71,75,4,13,986,0,0
1974,ACGTCGAATCTAGAGA,72,75,3,8,87,0,0
1975,ACGTCGAATCTAGAGA,72,75,3,11,224,0,0
1983,ACGTCGAATCTAGAGA,72,75,3,11,474,0,0
1992,ACGTCGAATCTAGAGA,72,75,3,11,617,0,0
2040,ACGTCGAATCTAGAGA,72,75,3,13,1016,0,0
2063,ACGTCGAATCTAGAGA,72,75,3,11,1145,0,0
2072,ACGTCGAATCTAGAGA,72,75,3,13,1310,0,0
2103,ACGTCGAATCTAGAGA,73,75,2,9,313,0,0
2121,ACCTCGAATCTAGAGA,73,75,2,9,688,0,0
2128,ACGTCGAATCTTGAGA,73,75,2,12,718,0,0
2134,ACGTCGAATCTAGAGA,73,75,2,9,893,0,0
2141,ACGTCGAATCTAGAGA,73,75,2,12,913,0,0
2143,ACGTCGAATCTAGCGA,73,75,2,9,921,0,0
2150,ACGTCGAATCTAGAGA,73,75,2,12,929,0,0
2170,ACGTCGAATCTAGAGA,73,75,2,12,1183,0,0
2186,ACGTCGAATCTAGAGC,73,75,2,11,1455,0,0
2188,ACGTCGAATCTAGAGA,73,75,2,11,1470,0,0
2194,ACGTCGAACCTAGAGA,73,75,2,12,1576,0,0
2222,ACGTCGAATCTAGAGA,74,75,1,10,577,0,0
2225,ACGTCGAATCTGGAGA,74,75,1,13,584,0,0
2231,ACGTCGAATCTAGAGA,74,75,1,10,735,0,0
2246,ACGTCGAATCTAGAGA,74,75,1,13,1039,0,0
2262,ACGTCGAATCTAGAGA,74,75,1,13,1366,0,0
2266,ACGTCGAATCTAGAGA,74,75,1,11,1457,0,0
2271,ACGTCGAATCTAGAGA,74,75,1,12,1555,0,0
2285,ACGTCGAATCTAGGGA,74,75,1,10,1759,0,0
65,ACGTCGAATCTAGAGA,35,76,41,7,45,13,0
309,ACGTCGAATCTAGAGA,51,76,25,11,214,7,0
457,ACGTCGAATCTAGAGA,55,76,21,9,316,6,0
463,ACGTCGAATCTAGAGA,56,76,20,7,153,6,0
589,ACGTCGAATCTAGAGA,58,76,18,9,390,5,0
698,ACGTCGAATCTAGAGA,60,76,16,11,373,4,0
758,ACGTCGAATCTAGAGA,61,76,15,12,318,4,0
800,ACGTCGAATCTAGAGA,61,76,15,12,545,4,0
893,ACGTCGAATCTAGAGA,63,76,13,8,350,3,0
931,ACGTCGAATCTAGAGA,63,76,13,11,624,3,0
938,ACGTCGAATCTAGAGA,63,76,13,8,637,3,0
941,ACGTCGAATCTAGAGA,63,76,13,11,642,3,0
977,ACGTCGAATCTAGAGA,64,76,12,12,309,3,0
1056,ACGTCGAATCTAGAGA,65,76,11,10,262,3,0
1117,ACGTCGAATCTAGAGA,65,76,11,10,737,2,0
1186,ACGTCGAATCTAGAGA,66,76,10,14,491,2,0
1201,ACGTCGAATCTAGAGA,66,76,10,11,624,2,0
1205,ACGTCGAATCTAGAGA,66,76,10,8,637,1,0
1262,ACGTCGAATCTAGAGA,66,76,10,14,864,1,0
1269,ACGTCGAATCTAGAGA,66,76,10,11,873,1,0
1275,ACGTCGAATCTAGAGA,67,76,9,6,22,1,0
1319,ACGTCGAATCTAGAAA,67,76,9,9,681,1,0
1327,ACGTCGAATCTAGAGA,67,76,9,15,700,1,0
1330,ACGTCGAATCTAGAGA,67,76,9,12,708,1,0
1363,ACGTCGAATCTAGAGA,67,76,9,9,921,0,0
1407,ACGTCGAATCTAGAGA,68,76,8,10,422,0,0
1455,ACGTCGAATCTAGAGC,68,76,8,10,751,1,0
1503,ACGTCGAATCTAGAGA,68,76,8,10,995,1,0
1505,ACGTCGAATCTAGAGA,68,76,8,13,997,1,0
1530,ACGTCGAATCTAGAGA,68,76,8,13,1028,1,0
1539,ACGTCGAATCTAGAGA,68,76,8,13,1039,0,0
1543,ACGTCGAACCTAGAGA,68,76,8,13,1046,1,0
1559,ACGTTGAATCTAGAGA,69,76,7,11,469,0,0
1567,ACGTCGAACCTAGAGA,69,76,7,11,502,0,0
1620,ACGTCGAATCTAGAGA,69,76,7,11,856,0,0
1621,ACGTCGAATCTAGAGA,69,76,7,11,859,0,0
1642,ACGTCGACTCTAGAGA,69,76,7,11,1060,1,0
1643,ACGTCGAATCTAGAGA,69,76,7,14,1061,1,0
1648,ACGTCGAATCTAGAGA,69,76,7,11,1068,0,0
1688,ACGTCGAATCTAGAGA,69,76,7,11,1133,1,0
1716,ACGTCGAATCTAGAGA,70,76,6,12,243,1,0
1738,ACGTCGAATCTAGAGA,70,76,6,9,670,1,0
1766,ACGTCGAATCTAGAGA,70,76,6,12,905,0,0
1782,ACGTCGAATCTAGAGA,70,76,6,12,933,0,0
1785,ACGTCGAATCTAGAGA,70,76,6,9,938,0,0
1787,ACGTCGAATCTAGAGA,70,76,6,12,941,0,0
1814,ACGTCGAATCTAGAGA,70,76,6,12,1197,0,0
1839,ACGTCGAATCTAGAGA,70,76,6,12,1240,1,0
1861,ACGTCGAATCTAGAGA,70,76,6,12,1271,0,0
1862,ACGTCGAATCTAGAGA,70,76,6,12,1272,0,0
1886,ACGTCGAATCTAGAGA,71,76,5,7,553,0,0
1896,ACGTCGAATCTGGAGA,71,76,5,13,584,0,0
1910,ACGTCGAATCTAGAGA,71,76,5,10,748,0,0
1932,ACGTCGAATCTAGAGA,71,76,5,10,963,0,0
1935,ACGTCGAATCTAGAGA,71,76,5,10,971,0,0
1937,ACGTCGAATCTAGAGA,71,76,5,10,973,0,0
1939,ACGTCGAATCTAGAGA,71,76,5,13,977,0,0
1940,ACGTCGAATCTAGAGA,71,76,5,10,978,0,0
1947,ACGTCGAATCTAGAGA,71,76,5,13,988,1,0
1977,ACGTCGAATCTAGAGA,72,76,4,8,350,0,0
1991,ACGTCGAATCTAGAGA,72,76,4,11,610,0,0
2018,ACGTCGAATCTAGAGA,72,76,4,11,830,0,0
2037,ACGTCGAATCTAGAGA,72,76,4,11,878,0,0
2056,ACGTCGAATCTAGAGA,72,76,4,11,1058,0,0
2062,ACGTCGAATCTAGAGA,72,76,4,11,1144,0,0
2075,ACGTCGAATCTAGAGA,72,76,4,10,1316,0,0
2087,ACGTCGAATCTAGAGA,72,76,4,11,1448,0,0
2101,ACGTCGAATCTAGAGA,73,76,3,9,302,0,0
2115,ACGTCGAATCTAGAGA,73,76,3,12,545,0,0
2122,ACGTCGAATCTAGAGA,73,76,3,12,696,0,0
2131,ACGTCGAATCTAGAGA,73,76,3,12,724,0,0
2133,ACGTCGAATCTAGAGA,73,76,3,9,887,0,0
2147,ACGTCGAATCTAGAGA,73,76,3,12,926,0,0
2157,ACGTCGAATCTAGAGA,73,76,3,13,1034,0,0
2159,ACGTCGAATCTAGAGA,73,76,3,13,1036,0,0
2163,ACGTCGACTCTAGAGA,73,76,3,11,1073,0,0
2168,ACGTCGAATCTAGAGA,73,76,3,12,1173,0,0
2171,ACGTCGAATCTAGAGA,73,76,3,12,1240,0,0
2184,ACGTCGAATCTAGAGA,73,76,3,8,1444,0,0
2204,ACGTCGAATCTAGAGA,74,76,2,7,245,0,0
2210,ACGTCGAATCTAGAGA,74,76,2,10,422,0,0
2228,ACGTCGAATCTAGAGA,74,76,2,10,591,0,0
2232,ACGTCGAATCTAGAGA,74,76,2,10,736,0,0
2238,ACGTCGAATCTAGAGA,74,76,2,12,941,0,0
2239,ACGTCGAATCTAGAGA,74,76,2,12,943,0,0
2244,ACGTCGAATCTAGAGA,74,76,2,10,975,0,0
2258,ACGTCGAATCTAGAGA,74,76,2,12,1201,0,0
2268,ACGTCGAATCTAGAGA,74,76,2,11,1514,0,0
2274,AGGTCGACTCTAGAGA,74,76,2,12,1642,0,0
2275,ACGTCGAATCTAGAGA,74,76,2,15,1643,0,0
2286,ACGTCGAATCTAGAGA,74,76,2,10,1797,0,0
2300,ACGTCGAATCTAGAGA,75,76,1,11,498,0,0
2311,ACGTCGAATCTAGAGA,75,76,1,14,666,0,0
2363,ACGTCGAATCTAGAGA,75,76,1,12,1583,0,0
2376,ACGTCGAATCTAGAGA,75,76,1,13,1748,0,0
102,ACGTCGAATCTAGAGA,40,77,37,6,22,11,0
577,ACGTCGAATCTAGAGA,58,77,19,9,304,5,0
617,ACGTCGAATCTAGAGA,59,77,18,10,262,5,0
814,ACGTCGAATCTAGAGA,62,77,15,10,262,4,0
822,ACGTCGAATCTAGAGA,62,77,15,13,349,3,0
830,ACGTCGAATCTAGAGA,62,77,15,10,431,4,0
913,ACGTCGAATCTAGAGA,63,77,14,11,490,3,0
914,ACGTCGAATCTAGAGA,63,77,14,14,491,3,0
921,ACGTCGAATCTAGAGA,63,77,14,8,605,3,0
926,ACGTCGAATCTAGAGA,63,77,14,11,614,3,0
928,ACGTCGAATCTAGAGA,63,77,14,11,617,3,0
933,ACGTCGAATCTAGAGA,63,77,14,11,628,4,0
944,ACGTCGAATCTAGAGA,63,77,14,14,646,3,0
951,ACGTCGAATCTAGAGA,63,77,14,11,655,3,0
987,ACGTCGAATCTAGAGA,64,77,13,9,405,3,0
1005,ACGTCGAATCTAGAGA,64,77,13,12,541,2,0
1009,ACGTCGAATCTAGAGA,64,77,13,12,546,2,0
1026,ACGTTGAATCTAGAGA,64,77,13,12,693,2,0
1039,ACGTCGAATCTAGAGA,64,77,13,12,719,3,0
1097,ACGTCGAATCTAGAGA,65,77,12,10,578,2,0
1110,ACGTTGAATCTAGAGA,65,77,12,13,601,2,0
1264,ACGTCGAATCTAGAGA,66,77,11,11,866,2,0
1316,ACGTCGAATCTAGAGA,67,77,10,9,676,1,0
1335,ACGTCGAATCTAGAGA,67,77,10,12,722,1,0
1362,ACGTCGAACCTAGAGA,67,77,10,12,918,1,0
1364,ACGTCGAATCTAGAGA,67,77,10,9,922,1,0
1369,ACGTCGAATCTAGAGA,67,77,10,12,927,1,0
1396,ACGTCGAATCTAGAGA,68,77,9,7,245,0,0
1424,ACGTCGAATCTAGAGA,68,77,9,10,555,1,0
1427,ACGTCGAATCTAGAGA,68,77,9,10,569,0,0
1432,ACGTCGAATCTAGAGA,68,77,9,10,578,0,0
1456,ACGTCGAATCTAGAGA,68,77,9,13,754,1,0
1464,ACGTCGAATCTAGAGA,68,77,9,10,767,0,0
1481,ACGTCGAATCTAGAGA,68,77,9,7,961,0,0
1497,ACGTCGAATCTAGAGA,68,77,9,13,986,0,0
1540,ACGTCGAATCTAGAGA,68,77,9,10,1040,1,0
1547,ACGTCGAATCTAGAGA,69,77,8,11,224,0,0
1552,ACGTCGAATCTAGAGA,69,77,8,11,359,1,0
1555,ACGTCGAATCTAGAGA,69,77,8,11,461,1,0
1583,ACGTCGAATCTAGAGA,69,77,8,11,655,1,0
1616,ACGTCGAATCTAGAGA,69,77,8,11,851,0,0
1646,ACGTCGAATCTAGAGA,69,77,8,11,1065,1,0
1679,ACGTCGAATCTAGAGA,69,77,8,11,1118,0,0
1740,AGGTCGAATCTAGAGA,70,77,7,9,678,1,0
1743,ACGTCGAATCTAGAGA,70,77,7,9,684,0,0
1809,ACGTCGAATCTAGAGA,70,77,7,12,1189,0,0
1824,ACGTCGAATCTAGAGA,70,77,7,15,1212,0,0
1830,ACGTCGAATCTAGAGA,70,77,7,12,1224,0,0
1903,ACGTCGAATCTAGAGA,71,77,6,10,734,0,0
1960,ACGTCGAATCTAGAGA,71,77,6,7,1275,0,0
1963,ACGTCGAATCTAGAGA,71,77,6,10,1285,0,0
2008,ACGTCGAATCTAGAGA,72,77,5,11,806,0,0
2052,ACGTCGAATCTAGAGA,72,77,5,16,1030,0,0
2061,ACGTCGAATCTAGAGA,72,77,5,11,1141,0,0
2070,ACGTCGAATCTAGAGA,72,77,5,10,1301,0,0
2095,ACGTCGAATCTAGAGA,73,77,4,9,185,0,0
2105,ACGTCGAATCTAGAGA,73,77,4,12,392,0,0
2108,ACGTCGAATCTAGAGA,73,77,4,9,504,0,0
2110,ACGGCGAATCTAGAGA,73,77,4,9,513,0,0
2135,ACGTCGAATCTAGAGA,73,77,4,12,896,0,0
2154,ACGTCGAATCTAGAGA,73,77,4,9,938,0,0
2172,ACGTCGAATCTAGAGA,73,77,4,9,1243,0,0
2176,ACGTCGAATCTAGAGA,73,77,4,13,1332,0,0
2179,ACGTCGAATCTAGAGA,73,77,4,10,1377,0,0
2207,ACGTCGAATCTAGAGA,74,77,3,13,349,0,0
2227,ACGTCGAATCTAGAGA,74,77,3,10,589,0,0
2240,ACGTCGAATCTAGAGA,74,77,3,15,944,0,0
2243,ACGTCGAATCTAGAGA,74,77,3,10,960,0,0
2276,ACTTCGAATCTAGAGA,74,77,3,12,1653,0,0
2287,ACGTCGAATCTAGAGA,74,77,3,10,1819,0,0
2290,ACGTCGAATCTAGAGA,74,77,3,13,1839,0,0
2312,ACGTCGAATCTAGAGA,75,77,2,7,746,0,0
2318,ACGTCGAATCTAGAGA,75,77,2,10,767,0,0
2320,ACGTCGAATCTAGAGA,75,77,2,10,780,0,0
2322,ACGTCGAATCTAGAGA,75,77,2,13,797,0,0
2340,ACGTTGAATCTAGAGA,75,77,2,14,1110,0,0
2346,ACGTCGAATCTAGAGA,75,77,2,10,1286,0,0
2351,ACGTCGAGCCTAGAGA,75,77,2,13,1362,0,0
2357,ACGTCGAATCTAGAGA,75,77,2,11,1488,0,0
2380,ACGTCGAATCTAGAGA,75,77,2,13,1840,0,0
2382,ACGTCGAATCTAGAGA,75,77,2,8,1908,0,0
2407,ACGTCGAATCTAGAGA,76,77,1,12,524,0,0
2417,ATGTCGAATCTAGAGA,76,77,1,9,704,0,0
2423,ACGTCGAATCTAGAGA,76,77,1,13,986,0,0
2437,ACGTCGAATCTAGAGA,76,77,1,11,1409,0,0
2441,ACGTCAAATCTAGAGA,76,77,1,11,1532,0,0
2443,ACGTCGAATCTAGAGA,76,77,1,9,1546,0,0
2446,ACGTCGAATCTAGAGA,76,77,1,12,1622,0,0
2450,ACGTCGAATCTAGAGA,76,77,1,9,1656,0,0
2453,AGGTCGAATCTAGAGA,76,77,1,10,1740,0,0
2476,ACGTCGAATCTAGAGA,76,77,1,11,2064,0,0
302,ACGTCGAATCTAGAGA,51,78,27,8,166,8,0
578,ACGTCGAATCTAGAGA,58,78,20,9,306,6,0
601,ACGTTGAATCTAGAGA,58,78,20,12,411,6,0
777,ACGTCGAATCTAGAGA,61,78,17,9,510,4,0
864,ACGTCGAATCTAGAGA,62,78,16,13,580,3,0
867,ACGTCGAATCTAGAGA,62,78,16,10,583,3,0
1003,ACGTCGAATCTAGAGA,64,78,14,12,536,4,0
1064,ACGTCGAATCTAGAGA,65,78,13,10,421,2,0
1093,ACGTCGAATCTAGAGA,65,78,13,10,574,1,0
1119,ACGTCGAATCTAGAGA,65,78,13,10,743,2,0
1222,ACGTCGAATCTAGAGA,66,78,12,14,666,1,0
1237,ACGTCGAATCTAGAGA,66,78,12,11,825,1,0
1251,ACGTCGAATCTAGAGA,66,78,12,11,846,2,0
1252,ACGTCGAATCTAGAGA,66,78,12,8,848,2,0
1347,ACGTCGAATCTAGAGA,67,78,11,12,896,0,0
1395,ACGTCGAATCTAGAGA,68,78,10,10,207,1,0
1409,ACGTCGAATCTAGAGA,68,78,10,10,431,1,0
1435,ACGTCGAATCTGGAGA,68,78,10,13,584,0,0
1496,ACGTCGAATCTAGAGA,68,78,10,10,985,1,0
1517,ACATCGAATCTAGAGA,68,78,10,10,1014,0,0
1520,AGGTCGAATCTAGAGA,68,78,10,10,1018,1,0
1527,ACGTCGAATCTAGAGA,68,78,10,13,1025,0,0
1561,ACGTCGAATCTAGAGA,69,78,9,11,474,0,0
1592,ACGTCGGATCTAGAGA,69,78,9,11,805,0,0
1596,ACGTCGAATCTAGAGA,69,78,9,11,812,1,0
1597,ACGTCGAATCTAGAGT,69,78,9,11,813,1,0
1613,ACGTCGAATCTAGAGA,69,78,9,11,842,0,0
1637,ACGTCGAATCTAGAGA,69,78,9,8,1053,0,0
1653,ACGTCGAATCTAGAGA,69,78,9,11,1076,2,0
1664,AGGTCGAATCTAGAGA,69,78,9,11,1094,0,0
1674,ACGTTGAATCTAGAGA,69,78,9,14,1110,0,0
1690,ACGTCGAATCAAGAGA,69,78,9,11,1136,0,0
1691,ACGTCGAATCTAGAGA,69,78,9,14,1138,0,0
1696,ACGTCGAATCTAGAGA,69,78,9,11,1144,0,0
1715,ACGTCGAATCTAGAGA,70,78,8,9,240,1,0
1720,ACGTCGAATCTAGAGA,70,78,8,9,304,0,0
1760,ACGTCGAATCTAGAGA,70,78,8,9,888,0,0
1793,ACGTCGAATCTAGAGA,70,78,8,12,952,1,0
1794,ACGTCGAATCTAGAGA,70,78,8,15,954,0,0
1810,ACGTCGAATCTAGAGA,70,78,8,15,1191,1,0
1816,ACGTCGAATCTAGAGA,70,78,8,12,1201,1,0
1842,ACGTCGAATCTAGAGA,70,78,8,12,1246,0,0
1856,ACGTCGAATCTAGAGA,70,78,8,12,1265,0,0
1866,ACGTCGAATCTAGAGA,71,78,7,10,195,0,0
1873,ACGTCGAATCTAGAGA,71,78,7,13,349,0,0
1878,ACGTCGAATCTAGAGA,71,78,7,10,436,0,0
1893,ACGTCGAATCTAGAGA,71,78,7,10,577,0,0
1934,ACGTCGAATCTAGAGA,71,78,7,7,970,0,0
1941,ACGTCGAATCTAGAGA,71,78,7,10,980,1,0
1968,ACGTCGAATCTAGAGA,71,78,7,10,1292,0,0
1995,ACGTCGAATCTAGAGA,72,78,6,11,640,0,0
2001,ACGTCGAATCTAGAGA,72,78,6,11,657,0,0
2007,ACGTCGGATCTAGAGA,72,78,6,11,805,0,0
2024,ACGTCGAATCTAGAGA,72,78,6,11,842,0,0
2028,ACGTCGAATCTAGAGA,72,78,6,11,854,0,0
2044,ACGTCGAATCTAGAGA,72,78,6,10,1021,0,0
2050,ACGTCGAAGCTAGAGA,72,78,6,10,1027,0,0
2104,ACGTCGAATCTAGAGA,73,78,5,9,390,0,0
2129,ACGTCGAATCTAGAGA,73,78,5,12,719,0,0
2139,ACGTCGAATCTAGAGA,73,78,5,12,906,0,0
2156,ACGTCAAATCTAGAGA,73,78,5,10,1031,0,0
2160,ACGTCGACTCTAGAGA,73,78,5,11,1060,0,0
2208,ACATCGAATCTAGAGA,74,78,4,10,415,0,0
2219,ACGTCGAATCTAGAGA,74,78,4,10,572,0,0
2220,ACGTCGAATCTAGAGA,74,78,4,10,574,0,0
2223,ACGTCGAATCTAGAGA,74,78,4,10,578,0,0
2241,ACGTCGGATCTAGAGA,74,78,4,12,946,0,0
2242,ACGTCGAATCTAGAGT,74,78,4,12,951,0,0
2253,ACGTCGAATCTAGAGA,74,78,4,11,1124,0,0
2255,ACGTCGAATCTAGAGA,74,78,4,14,1152,0,0
2261,ACGTCGAATCTAGAGA,74,78,4,13,1361,0,0
2270,ACGTCGAATCTAGAGA,74,78,4,9,1545,0,0
2281,ACGTCGAATCTAGAGA,74,78,4,10,1714,0,0
2284,ACGTCGAATCTAGAGA,74,78,4,10,1757,0,0
2288,ACGTCGAATCTAGAGA,74,78,4,16,1828,0,0
2297,ACGTCGAATCTAGAGA,75,78,3,11,474,0,0
2315,ACGTCGAATCTAGAGA,75,78,3,10,760,0,0
2329,ACGTCGAATCTAGAGA,75,78,3,11,812,0,0
2331,ACGTCGAATCTAGAGA,75,78,3,10,963,0,0
2333,ACGTCGAATCTAGAGA,75,78,3,10,980,0,0
2335,ACGTCGAATCTAGAGA,75,78,3,10,982,0,0
2337,ACGTCGAATCTAGAGA,75,78,3,11,1052,0,0
2358,ACGTCGAATCTAGAGA,75,78,3,11,1491,0,0
2360,ACGTCGAATCTAGAGA,75,78,3,14,1505,0,0
2362,ACGTCGCATCTAGAGA,75,78,3,9,1550,0,0
2365,ACGTCGAATCTAGAGT,75,78,3,12,1597,0,0
2366,ACGTCGAATCTAGAGA,75,78,3,15,1603,0,0
2383,ACGTCGAATCTAGAGA,75,78,3,11,1920,0,0
2399,ACGTCGAATCTAGAGA,76,78,2,9,394,0,0
2405,ACGTCGAATCTAGAGA,76,78,2,12,521,0,0
2415,ACGTCGAATCTAGAGA,76,78,2,12,696,0,0
2420,ACGTCGAATCTAGAGA,76,78,2,12,896,0,0
2465,ACGTCGAATCTAGAGA,76,78,2,11,1933,0,0
2466,ACGTCGAATCTAGAGA,76,78,2,11,1936,0,0
2498,ACGTCGAATCTGGAGA,77,78,1,13,584,0,0
2504,ACGTCGAATCTAGAGA,77,78,1,12,719,0,0
2505,ACGTCGAATCTAGAGA,77,78,1,12,723,0,0
2518,ACGTCGAATCTAGAGA,77,78,1,10,960,0,0
2525,ACGTCGACTCTAGAGA,77,78,1,11,1060,0,0
2532,ACGTCGAATCTAGAGA,77,78,1,16,1382,0,0
2535,ACGTCGAATCTAGAGA,77,78,1,11,1429,0,0
2538,ACGTCGAATCTAGAGA,77,78,1,11,1457,0,0
2547,ACGTCGAATCTAGAGA,77,78,1,12,1617,0,0
2549,ACGTCGAATCTAGAGA,77,78,1,9,1682,0,0
2555,ACGTCGAATCTAGAGA,77,78,1,11,1904,0,0
2557,ACGTCGAATCTAGAGA,77,78,1,11,1964,0,0
22,ACGTCGAATCTAGAGA,24,79,55,5,13,17,0
195,ACGTCGAATCTAGAGA,46,79,33,9,71,10,0
263,ACGTCGAATCTAGAGA,49,79,30,9,185,9,0
313,ACGTCGAATCTAGAGA,51,79,28,8,218,8,0
335,ACGTCGAATCTAGAGA,52,79,27,6,225,8,0
719,ACGTCGAATCTAGAGA,60,79,19,11,490,5,0
810,ACGTCGAATCTAGAGA,62,79,17,7,245,4,0
832,ACGTCGAATCTAGAGA,62,79,17,13,437,4,0
896,ACGTCGAATCTAGAGA,63,79,16,11,359,4,0
1017,ACGTCGAATCTAGAGA,64,79,15,9,676,3,0
1023,ACGTCGAATCTAGAGA,64,79,15,12,689,2,0
1024,ACGTCGAATCTAGAGA,64,79,15,12,691,2,0
1141,ACGTCGAATCTAGAGA,65,79,14,10,776,2,0
1194,ACGTCGAATCTAGAGA,66,79,13,8,608,2,0
1204,ACGTCGAACCTAGAGA,66,79,13,11,633,1,0
1230,ACGTCGAATCTAGAGT,66,79,13,11,813,1,0
1243,ACGTCGAATCTAGAGA,66,79,13,8,833,3,0
1257,ACATCGAATCTAGAGA,66,79,13,11,855,1,0
1301,ACGTCGAATCTAGAGA,67,79,12,9,510,1,0
1314,ACGTCGAATCTAGAGA,67,79,12,9,674,1,0
1326,ACGTCGAATCTAGAGA,67,79,12,12,698,2,0
1349,ACGTCAAATCTAGAGA,67,79,12,9,899,1,0
1361,ACGTCGAATCTAGAGA,67,79,12,12,917,1,0
1391,ACGTCGAATCTAGAGA,68,79,11,10,114,1,0
1430,ACGTCGAATCTAGAGA,68,79,11,10,576,1,0
1470,ACGTCGAATCTAGAGA,68,79,11,10,784,1,0
1573,ACGTCGAATCTAGAGA,69,79,10,11,623,1,0
1588,ACGTCGAATCTAGAGA,69,79,10,11,665,0,0
1607,ACGTCGAATCTAGAGA,69,79,10,11,831,2,0
1624,ACGTCGAATCTAGAGA,69,79,10,14,864,1,0
1656,ACGTCGAATCTAGAGA,69,79,10,8,1082,2,0
1661,ACGTCGAATCTAGAGA,69,79,10,8,1091,0,0
1670,ACGTCGAATCTAGAGA,69,79,10,11,1103,0,0
1699,ACGTCGAATCTAGAGA,69,79,10,11,1148,2,0
1733,ACGTCGAATCTAGAGA,70,79,9,12,523,1,0
1752,ACGTCGAATCTTGAGA,70,79,9,12,718,1,0
1753,ACGTCGAATCTAGAGA,70,79,9,12,719,0,0
1765,ACGTCGAATCTAGAGA,70,79,9,12,904,0,0
1806,ACGTCGAATCTAGAGA,70,79,9,12,1183,0,0
1829,ACGTCGAATCTAGAGA,70,79,9,9,1223,1,0
1911,ACGTCGAATCTAGAGA,71,79,8,10,749,1,0
1916,ACGTCGAATCTAGAGA,71,79,8,10,763,0,0
1923,ACGTCGAATCTAGAGA,71,79,8,13,785,0,0
1930,ACGTCGAATCTAGAGA,71,79,8,10,960,0,0
1936,ACGTCGAATCTAGAGA,71,79,8,10,972,1,0
1973,ACGTCGAATCTAGAGA,72,79,7,8,65,0,0
1982,ACGTTGAATCTAGAGA,72,79,7,11,469,0,0
2000,ACGTCGAATCTAGAGA,72,79,7,8,651,0,0
2012,ACGTCGAATCTAGAGA,72,79,7,11,814,0,0
2029,ACATCGAATCTAGATA,72,79,7,11,855,1,0
2032,ACGTCGAATCTAGAGA,72,79,7,14,864,0,0
2057,ACGTCGAATCTAGAGA,72,79,7,11,1062,1,0
2065,ACGTCGAAGCTAGAGA,72,79,7,10,1296,1,0
2079,ACGTCGAATCTAGAGA,72,79,7,13,1326,0,0
2093,ACGTCGAATCTAGAGA,73,79,6,6,95,0,0
2136,ACGTCAAATCTAGAGA,73,79,6,9,899,1,0
2193,ACGTCGAATCTAGAGA,73,79,6,12,1573,0,0
2200,ACGTCGAATCTAGAGA,73,79,6,15,1706,0,0
2226,ACGTCGAATCTAGAGA,74,79,5,10,588,1,0
2251,ACGTCGAATCTAGAGA,74,79,5,11,1096,0,0
2254,ACGTCGAATCTAGAGA,74,79,5,11,1127,1,0
2260,ACGTCGAATCTAGAGA,74,79,5,13,1335,0,0
2307,ACGTCGAATCTAGAGA,75,79,4,11,640,0,0
2309,ACGTCGAATCTAGAGA,75,79,4,11,657,0,0
2324,ACGTCGAATCTAGAGA,75,79,4,11,804,0,0
2368,ACGTCGAATCTAGAGA,75,79,4,12,1607,0,0
2387,ACGTCGAATCTAGAGA,76,79,3,6,95,0,0
2393,ACGTCGAATCTAGAGA,76,79,3,12,243,0,0
2412,ACGTCGAATCTAGAGA,76,79,3,9,680,0,0
2422,ACGTCGAATCTAGAGA,76,79,3,10,985,0,0
2432,ACGTCGAATCTAGAGA,76,79,3,10,1287,0,0
2433,ACCTCGAATCTAGAGA,76,79,3,10,1321,0,0
2454,ACGTTGAATCTAGGGA,76,79,3,13,1768,0,0
2473,ACGTCGAATCTAGAGA,76,79,3,15,2019,0,0
2475,ACGTCGAATCTAGAGA,76,79,3,12,2057,0,0
2477,ACGTCGAATCTAGAAA,76,79,3,11,2076,0,0
2483,ACGTCGAATCTAGAGA,77,79,2,7,335,0,0
2496,ACGTCGAATCTAGAGA,77,79,2,10,578,0,0
2507,ACGTCGAATCTAGAGA,77,79,2,10,734,0,0
2510,ACGTCGAATCTAGAGA,77,79,2,11,818,0,0
2533,ACGTCGAATCTAGAGA,77,79,2,16,1389,0,0
2570,ACGTCGAATCTAGAGA,77,79,2,17,2180,0,0
2582,ACGTCGAATCTAGAGA,78,79,1,11,627,0,0
2588,ACGTCGAATCTAGAGA,78,79,1,14,666,0,0
2595,ACGTCGAATCTAGAGA,78,79,1,10,763,0,0
2602,ACGTCGAATCTAGAGA,78,79,1,11,865,0,0
2605,ACGTCGAATCAAGAGA,78,79,1,11,1067,0,0
2625,ACGTCGAATCTAGAGA,78,79,1,9,1657,0,0
2652,ACATCGAATCTAGATA,78,79,1,12,2029,0,0
415,ACGTCGAATCTAGAGA,55,80,25,9,51,7,0
485,ACGTCGAATCTAGAGA,56,80,24,10,326,7,0
497,ACGTCGAATCTAGAGA,56,80,24,13,343,7,0
524,ACGTCGAATCTAGAGA,57,80,23,11,288,7,0
545,ACGTCGAATCTAGAGA,57,80,23,11,373,7,0
684,ACGTCGAATCTAGAGA,60,80,20,8,350,6,0
735,ACGTCGAATCTAGAGA,61,80,19,9,134,5,0
804,ACGTCGAATCTAGAGA,62,80,18,10,114,5,0
848,ACGTCGAATCTAGAGA,62,80,18,7,553,4,0
865,ACGTCGAATCTAGAGA,62,80,18,10,581,4,0
1013,ACGTCGAATCTAGAGA,64,80,16,9,671,3,0
1019,ACGTCGAATCTAGAGA,64,80,16,9,680,3,0
1100,ACGTCGAATCTAGAGA,65,80,15,10,582,2,0
1163,ACGTCGAATCTAGAGA,66,80,14,8,65,1,0
1188,ACGTCGAATCTAGAGA,66,80,14,14,497,2,0
1232,ACGTCGAATCTAGAGA,66,80,14,11,817,1,0
1336,ACGTCGAATCTAGAGA,67,80,13,12,723,1,0
1389,ACGTCGAATCTAGAGA,67,80,13,15,958,2,0
1429,ACGTCGAATCTAGAGA,68,80,12,10,574,1,0
1431,ATGTCGAATCTAGAGA,68,80,12,10,577,1,0
1482,ACGTCGAATCTAGAGA,68,80,12,10,963,1,0
1511,ACGTCGAATCTAGAGA,68,80,12,13,1008,1,0
1548,ACGTCGAATCTAGAGA,69,80,11,8,269,1,0
1589,ACGTCGAATCTAGAGA,69,80,11,14,666,1,0
1714,ACGTCGAATCTAGAGA,70,80,10,9,239,1,0
1718,ACGTCGAATCTAGAGA,70,80,10,9,299,1,0
1722,ACGTCGAATCTAGAGA,70,80,10,9,313,0,0
1771,ACGTCGAATCTAGAGA,70,80,10,15,914,0,0
1790,ACGTCGAATCTAGAGA,70,80,10,15,944,1,0
1843,ACGTCGAATCTAGAGA,70,80,10,12,1247,1,0
1887,ACGTCGAATCTAGAGA,71,80,9,10,554,1,0
1891,ACGTCGAATCTAGAGA,71,80,9,10,574,0,0
2068,ACGTCGAATCTAGAGA,72,80,8,10,1299,0,0
2071,ACGTCGAATCTAGAGA,72,80,8,13,1308,1,0
2094,ACGTCGAATCTAGAGA,73,80,7,9,133,1,0
2096,ACGTCGAATCTAGAGA,73,80,7,9,228,1,0
2099,ACGTCGAATCTAGAGA,73,80,7,12,243,0,0
2116,ACGTCGAATCTAGAGA,73,80,7,12,546,0,0
2126,ACGTCGAATCTAGAGA,73,80,7,12,712,0,0
2146,ACGTCGAATCTAGAGA,73,80,7,12,924,0,0
2155,ACGTCGAATCTAGAGA,73,80,7,12,955,1,0
2182,ACGTCGAATCTAGAGA,73,80,7,11,1399,0,0
2190,ACGTCGAATCTAGAGA,73,80,7,14,1530,0,0
2216,ACGTCGAATCTAGAGA,74,80,6,10,554,0,0
2221,ACGTCGAATCTAGAGA,74,80,6,10,576,1,0
2224,ACGTCGAATCTAGAGA,74,80,6,10,582,1,0
2280,ACGTCGAATCTAGAGA,74,80,6,15,1707,0,0
2345,ACGTCGAATCTAGAGA,75,80,5,9,1252,0,0
2350,ACGTCGAATCTAGAGA,75,80,5,10,1341,0,0
2359,ACGTCGAATCTAGAGA,75,80,5,11,1496,0,0
2378,ACGTCGAATCTAGAAA,75,80,5,13,1789,0,0
2381,ACGTCGAATCTAGAGA,75,80,5,11,1884,0,0
2386,ACGTCTAATCTAGAGA,76,80,4,6,22,0,0
2396,ACGTCGAATCTAGAGA,76,80,4,9,313,0,0
2400,ACGTCGAATCTAGAGA,76,80,4,12,412,0,0
2404,ACGTCGAATCTAGAGA,76,80,4,9,517,0,0
2413,ACGTCGAATCTAGAGA,76,80,4,9,684,0,0
2424,ACGTCGAATCTAGAGA,76,80,4,10,987,0,0
2436,ACGTCGAATCTAGAGA,76,80,4,10,1364,0,0
2444,ACGTCGAATCTAGAGA,76,80,4,12,1560,0,0
2479,ACGTCGAATCTAGAGA,77,80,3,10,114,0,0
2508,ACGTCGAATCTAGAGA,77,80,3,10,735,0,0
2550,ACGTCGAATCTAGAAA,77,80,3,10,1742,0,0
2561,ACGTCGAATCTAGAGA,77,80,3,14,2071,0,0
2562,ACGTCGAATCTAGAGA,77,80,3,10,2096,0,0
2608,ACGTCGAATCTAGAGA,78,80,2,9,1223,0,0
2611,ACGTCGAATCTAGAGA,78,80,2,12,1254,0,0
2619,ACGTCGAATCTAGAGA,78,80,2,14,1533,0,0
2630,ACGTCGAATCTAGAGA,78,80,2,12,1699,0,0
2656,ACGTCGAATCTAGAGA,78,80,2,13,2130,0,0
2660,ACGTCGAATCTAGAGA,78,80,2,8,2209,0,0
2673,ACGTCGAATCTAGAGA,79,80,1,9,133,0,0
2679,ACGTCGAATCTAGAGA,79,80,1,6,290,0,0
2687,ACGTCGAATCTAGAGA,79,80,1,9,517,0,0
2691,ACGTCGAATCTAGAGA,79,80,1,12,545,0,0
2699,ACGTCGAATCTAGAGA,79,80,1,15,700,0,0
2707,ACGTCGAATCTAGAGA,79,80,1,11,835,0,0
2711,ACGTCGAATCTAGAGA,79,80,1,11,852,0,0
2721,ACGTCGAATCTAGAGA,79,80,1,12,1261,0,0
2739,ACGTCGAATCTAGAGA,79,80,1,13,1754,0,0
2765,ACGTCGAATCTAGAGA,79,80,1,12,2264,0,0
2766,ACGTCGAATCTAGAGA,79,80,1,12,2308,0,0
2768,ACGTCGGATCTAGAGA,79,80,1,12,2325,0,0
2769,ACGTCGAATCTAGAGA,79,80,1,13,2369,0,0
95,ACGTCGAATCTAGAGA,39,81,42,5,13,13,0
390,ACGTCGAATCTAGAGA,54,81,27,8,165,8,0
418,ACGTCGAATCTAGAGA,55,81,26,6,96,8,0
588,ACGTCGAATCTAGAGA,58,81,23,9,387,7,0
666,ACGTCGAATCTAGAGA,59,81,22,13,458,6,0
704,ACGTCGAATCTAGAGA,60,81,21,8,463,6,0
718,ACGTCGAATCTTGAGA,60,81,21,11,488,6,0
734,ACGTCGAATCTAGAGA,61,81,20,9,133,6,0
740,ACGTCGAATCTAGAGA,61,81,20,9,232,5,0
763,ACGTCGAATCTAGAGA,61,81,20,9,393,5,0
780,ACGTCGAATCTAGAGA,61,81,20,9,513,5,0
817,ACGTCGAATCTAGAGA,62,81,19,10,326,5,0
818,ACGTCGAATCTAGAGA,62,81,19,10,333,5,0
854,ACGTCGAATCTAGAGA,62,81,19,10,563,4,0
872,ACGTCGAATCTAGAGA,62,81,19,13,590,4,0
912,ACGTCGAATCTAGAGA,63,81,18,11,485,4,0
927,ACGTCGAATCTAGAGA,63,81,18,11,615,4,0
943,ACGTCGAATCTAGAGA,63,81,18,11,645,4,0
980,ACGTCGAATCTAGAGA,64,81,17,9,316,3,0
1022,ACCTCGAATCTAGAGA,64,81,17,9,688,4,0
1036,ACGTCGAATCTAGAGA,64,81,17,12,714,2,0
1052,ACGTCGAATCTAGAGA,65,81,16,10,207,3,0
1084,ACGTCGAATCTAGAGA,65,81,16,7,553,2,0
1101,ACGTCGAATCTGGAGA,65,81,16,13,584,2,0
1103,ACGTCGAATCTAGAGA,65,81,16,10,588,1,0
1120,ACGTCGAATCCAGAGA,65,81,16,13,745,2,0
1133,ACGTCGAATCTAGAGA,65,81,16,10,760,3,0
1203,ACGTCGAATCTAGAGA,66,81,15,11,631,2,0
1270,ACGTCGAATCTAGAGA,66,81,15,11,874,2,0
1337,ACGTCGAATCTAGAGA,67,81,14,12,724,1,0
1341,ACGTCGAATCTAGAGA,67,81,14,9,886,1,0
1356,ACGTTGAATCTAGAGA,67,81,14,12,907,1,0
1434,ACGTCGAATCTAGAGA,68,81,13,10,582,2,0
1474,ACGTCGAATCTAGAGA,68,81,13,13,791,0,0
1479,ACGTCGAATTTAGAGA,68,81,13,7,959,1,0
1509,ACGTCGAATCTAGAGA,68,81,13,13,1005,1,0
1524,ACCTCGAATCTAGAGA,68,81,13,10,1022,1,0
1526,ACGTCGAATCTAGAGA,68,81,13,13,1024,0,0
1560,ACGTCGAATCTAGAGA,69,81,12,11,471,1,0
1566,ACGTCGAATCTAGAGA,69,81,12,11,498,0,0
1604,ACGTCGAATCTAGAGA,69,81,12,11,827,2,0
1645,ACGTCGAATCTAGAGA,69,81,12,11,1064,1,0
1707,ACGTCGAATCTAGAGA,69,81,12,14,1160,1,0
1721,ACGTCGAATCTAGAGA,70,81,11,12,309,1,0
1761,ACGTCGAATCTAGAGA,70,81,11,9,890,1,0
1768,ACGTTGAATCTAGGGA,70,81,11,12,907,2,0
1784,ACGTCGAATCTAGAGA,70,81,11,9,937,0,0
1797,ACGTCGAATCTAGAGA,70,81,11,9,1165,2,0
1798,ACGTCGAATCTAGAGA,70,81,11,9,1168,1,0
1803,ACGTCGAATCTAGAGA,70,81,11,9,1177,0,0
1805,ACGTCGAATCTAGAGA,70,81,11,12,1182,0,0
1819,ACGTCGAATCTAGAGA,70,81,11,9,1205,1,0
1820,ACGTCGAATCTAGAGA,70,81,11,12,1206,0,0
1860,ACGTCGAATCTAGAGA,70,81,11,12,1270,0,0
1867,ACGTCGAATCTAGAGA,71,81,10,7,196,1,0
1953,ACGTCGAATCTAGAGA,71,81,10,13,1005,1,0
1955,ACGTCGAATCTAGAGA,71,81,10,13,1008,0,0
1984,ACGTCGAATCTAGAGA,72,81,9,11,485,1,0
1999,ACGTCGAATCTAGAGA,72,81,9,14,647,0,0
2011,ACGTCGAATCTAGAGA,72,81,9,11,812,1,0
2084,ACGTCGAATCTAGAGA,72,81,9,13,1384,0,0
2106,ACGTCGAATCTAGAGA,73,81,8,9,394,1,0
2130,ACGTCGAATCTAGAGA,73,81,8,12,723,1,0
2173,ACGTCGAATCTAGAGA,73,81,8,12,1251,1,0
2180,ACGTCGAATCTAGAGA,73,81,8,16,1389,1,0
2181,ACGTCGAATCTAGAGA,73,81,8,11,1394,0,0
2199,ACGTCGAATCTAGAGA,73,81,8,12,1699,0,0
2202,ACGTCGAATCTAGAGA,74,81,7,10,114,0,0
2294,ACGTCGAATCTAGAGA,75,81,6,8,462,0,0
2310,ACGTCGAATCTAGAGA,75,81,6,14,661,1,0
2317,ACGTCGAATCAAGAGA,75,81,6,10,764,0,0
2325,ACGTCGGATCTAGAGA,75,81,6,11,805,1,0
2398,ACGTCGAATCTAGAGA,76,81,5,12,392,0,0
2418,ACGTCGAATCTAGAGA,76,81,5,11,814,0,0
2428,ACGTCGAATCTAGAGA,76,81,5,12,1203,0,0
2431,ACGTCGAATCTAGAGA,76,81,5,12,1270,0,0
2448,ACGTCGAATCTAGAGA,76,81,5,12,1645,0,0
2515,ACGTCGAATCTAGAGA,77,81,4,12,930,0,0
2522,ACGTCGAATCTAGAGA,77,81,4,10,1011,0,0
2552,ACGTCGAATCTAGAGA,77,81,4,16,1810,0,0
2559,ACGTCGAATCTAGAGA,77,81,4,12,2054,0,0
2569,ACGTCGAATCTTGAGA,77,81,4,14,2177,0,0
2604,ACGTCGAATCTAGAGA,78,81,3,10,1017,0,0
2607,ACGTCGAATCTAGAGA,78,81,3,11,1124,0,0
2614,ACGTCGAATCTAGAGA,78,81,3,14,1411,0,0
2623,ACGTCGAATCTAGAGA,78,81,3,12,1607,0,0
2624,ACGTCGAATCTAGAGA,78,81,3,9,1615,0,0
2632,ACGTCGAATCTAGAGA,78,81,3,10,1718,0,0
2638,ACGTCGAATCTAGAGA,78,81,3,13,1817,0,0
2649,ACGTCGAATCTAGAGA,78,81,3,12,2002,0,0
2661,ACGTCGAATCTAGAGA,78,81,3,11,2221,0,0
2662,ACGTCGAATCTAGAGA,78,81,3,11,2224,0,0
2677,ACGTCGAATCTAGAGA,79,81,2,9,240,0,0
2685,ACGTCGAATCTAGAGA,79,81,2,9,511,0,0
2686,ACGTCGAATCTAGAGA,79,81,2,9,513,0,0
2715,ACGTCGAATCTAGAGA,79,81,2,13,1028,0,0
2719,ACGTCGAATCTAGAGA,79,81,2,12,1231,0,0
2724,ACGTCGAATCTAGAGA,79,81,2,13,1328,0,0
2726,ACGTCGAATCTAGAGA,79,81,2,13,1370,0,0
2727,ACGTCGAATCTAGAGA,79,81,2,11,1394,0,0
2731,ACGTCGAATCTAGAGA,79,81,2,15,1589,0,0
2737,ACGTCGAATCTAGAGA,79,81,2,15,1703,0,0
2742,ACGTCGAATCTAGAGA,79,81,2,16,1808,0,0
2753,ACGTCGAATCTAGAGA,79,81,2,12,2030,0,0
2763,ACGTCGAATCTAGAGA,79,81,2,12,2252,0,0
2776,ACGTCGAATCTAGAGA,80,81,1,10,451,0,0
2780,ACGTCGAATCTAGAGA,80,81,1,10,572,0,0
2791,ACGTCGAATCTAGAGA,80,81,1,10,734,0,0
2811,ACGTCGAATCTAGAGA,80,81,1,11,1434,0,0
2828,ACGTCGAATCTAGAGA,80,81,1,10,2098,0,0
2830,ACGTCGAATCTAGAGA,80,81,1,10,2119,0,0
670,ACGTCGAATCTAGAGA,60,82,22,8,89,6,0
851,ACGTCGAATCTAGAGA,62,82,20,10,560,4,0
878,ACGTCGAATCTAGAGA,62,82,20,10,598,4,0
960,ACGTCGAATCTAGAGA,64,82,18,9,51,5,0
1060,ACGTCGACTCTAGAGA,65,82,17,10,345,4,0
1078,ACGTCGAATCTAGAGA,65,82,17,13,453,3,0
1106,ACGTCGAATCTAGAGA,65,82,17,10,592,2,0
1176,ACGTCGAATCTAGAGA,66,82,16,8,462,2,0
1254,ACGTCGAATCTAGAGA,66,82,16,11,851,2,0
1353,ACGTCGAATCTAGAGA,67,82,15,12,904,2,0
1413,ACGTCGAATCTAGAGA,68,82,14,10,440,0,0
1417,ACGTCGAATCTAGAGA,68,82,14,10,451,0,0
1458,ACGTCGAATCTAGAGA,68,82,14,13,758,1,0
1563,ACGTCGAATCTAGAGA,69,82,13,11,485,2,0
1603,ACGTCGAATCTAGAGA,69,82,13,14,822,2,0
1660,ACGTCGAATCTAGAGA,69,82,13,11,1089,2,0
1717,ACGTCGAATCTAGAGA,70,82,12,6,290,2,0
1763,ACGTCGAATCTAGAGA,70,82,12,12,896,0,0
1775,ACGTCGAATCTAGAGA,70,82,12,12,924,0,0
1789,ACGTCGAATCTAGAGA,70,82,12,12,943,2,0
1802,ACGTCGAATCTAGAGA,70,82,12,9,1176,0,0
1812,ACGTCGAATCTAGAGA,70,82,12,9,1194,2,0
1888,ACGTCGAATCTAGAGA,71,82,11,10,560,1,0
1894,ACGTCGAATCTAGAGA,71,82,11,10,578,1,0
1909,ACGTCGAATCTAGAGA,71,82,11,10,747,0,0
1978,ACGTCGAATCTAGAGA,72,82,10,11,359,1,0
2005,ACGTCGAATCTAGAGA,72,82,10,14,666,0,0
2045,ACCTCGAATCTAGAGA,72,82,10,10,1022,1,0
2047,ACGTCGAATCTAGAGA,72,82,10,13,1024,0,0
2067,ACGTCGAATCTAGACA,72,82,10,13,1298,1,0
2083,ACGTCGAATCTAGAGA,72,82,10,16,1382,0,0
2158,ACGTCGAATCTAGAGA,73,82,9,13,1035,1,0
2161,ACGTCGAATCTAGAGA,73,82,9,11,1064,1,0
2164,ACGTCGAATCTAGAGA,73,82,9,11,1076,0,0
2166,ACGTCGAATCTAGAGA,73,82,9,11,1123,0,0
2183,ACGTCGAATCTAGAGA,73,82,9,11,1416,1,0
2197,ACGTCGAATCTAGAGA,73,82,9,9,1633,0,0
2201,ACGTCGAATCTAGAGA,74,82,8,7,102,1,0
2206,ACGTCGAATCTAGAGA,74,82,8,7,335,0,0
2229,ACGTTGAATCTAGAGA,74,82,8,13,601,1,0
2230,ACGTCGAATCTAGAGA,74,82,8,10,734,1,0
2250,ACGTCGAATCTAGAGA,74,82,8,8,1084,0,0
2252,ACGTCGAATCTAGAGA,74,82,8,11,1117,1,0
2259,ACGTCGAATCTAGAGA,74,82,8,12,1272,0,0
2299,ACGTCGAATCTAGAGA,75,82,7,14,497,0,0
2304,ACGTCGAATCTAGAGA,75,82,7,11,617,0,0
2306,ACGTCGAACCTAGAGA,75,82,7,11,633,0,0
2313,ACGTCGAATCTAGAGA,75,82,7,10,748,1,0
2348,ACGTCGAATCTAGAGA,75,82,7,10,1313,0,0
2356,ACGTCGAATCTAGAGA,75,82,7,14,1473,0,0
2370,ACGTCGAATCTAGAGA,75,82,7,12,1636,0,0
2377,ACGTCGAATCTAGAGA,75,82,7,10,1773,0,0
2389,ACGTCGAATCTAGAGA,76,82,6,9,185,0,0
2395,ACGTCGAATCTAGAGA,76,82,6,9,302,0,0
2416,ACGTCGAATCTAGAGA,76,82,6,15,700,0,0
2451,ACGTCGAATCTAGAGA,76,82,6,15,1689,0,0
2452,ACGTCGAATCTAGAGA,76,82,6,7,1717,0,0
2484,ACGTCGAATCTAGAGA,77,82,5,13,349,0,0
2485,ACGTCGAATCTAGAGA,77,82,5,10,415,0,0
2488,ACGTCGAATCTAGAGA,77,82,5,10,444,0,0
2493,ACGTCGAATCTAGAGA,77,82,5,10,572,0,0
2495,ACGTCGAATCTAGAGA,77,82,5,10,576,0,0
2501,ACGTTGAATCTAGAGA,77,82,5,13,601,0,0
2534,ACGTCGAATCTAGAGA,77,82,5,8,1405,0,0
2536,ACGTCGAATCTAGAGA,77,82,5,11,1430,0,0
2539,ACGTCGAATCTAGAGA,77,82,5,11,1467,0,0
2554,ACGTCGAATCTAGAGA,77,82,5,10,1832,0,0
2577,ACGTCGAATCTAGAGA,78,82,4,14,497,0,0
2584,ACGTCGAATCTAGAGA,78,82,4,11,640,0,0
2589,ACGTCGAATCTAGAGA,78,82,4,10,737,0,0
2593,ACGTCGAATCTAGAGA,78,82,4,10,749,0,0
2594,ACGTCGAATCTAGAGA,78,82,4,10,760,0,0
2599,ACGTCGAATCTAGAGA,78,82,4,13,785,0,0
2617,ACGTCGAATCTAGAAA,78,82,4,11,1522,0,0
2626,ACGTCGAATCTAGAGA,78,82,4,12,1660,0,0
2627,ACGTCGAATCTAGAGA,78,82,4,12,1665,0,0
2631,ACGTCGAATCTAGAGA,78,82,4,15,1702,0,0
2648,ACGTCGAATCTAGAGA,78,82,4,12,1997,0,0
2655,ACGTCGAATCTAGAGA,78,82,4,13,2113,0,0
2689,ACGTCGAATCTAGAGA,79,82,3,12,523,0,0
2700,ACGTCGAATCTAGAGA,79,82,3,9,704,0,0
2701,ACGTCGAATCTAGAGA,79,82,3,11,804,0,0
2705,ACGTCGAATCTAGAGA,79,82,3,11,812,0,0
2738,ACGTCGAATCTAGAGA,79,82,3,13,1734,0,0
2743,ACGTCGAATCTAGAGA,79,82,3,13,1834,0,0
2752,ACGTCGAATCTAGAGA,79,82,3,12,2013,0,0
2771,ACGTCGAATCTAGAGA,80,82,2,7,245,0,0
2774,ACGTCGAATCTAGAGA,80,82,2,10,436,0,0
2787,ACGTCGAATCTAGAGA,80,82,2,12,714,0,0
2801,ACGTCGAATCTAGAGA,80,82,2,12,906,0,0
2824,ACGTCGAATCTAGAGA,80,82,2,11,1898,0,0
2836,ACGTCGAATCTAAAGA,80,82,2,11,2217,0,0
2837,ACGTCGAATCTAGAGA,80,82,2,11,2230,0,0
2849,ACCTCGAATCTAGAGA,80,82,2,10,2414,0,0
2869,ACGTCGAATCTAGAGA,81,82,1,7,746,0,0
2874,ACGTCGAATCTAGAGA,81,82,1,10,767,0,0
2876,ACGTCGAATCTAGAGA,81,82,1,13,790,0,0
2878,ACGTCGAATCTAGAGA,81,82,1,12,929,0,0
2902,ACGTCGAATCTAGAGA,81,82,1,11,1124,0,0
2903,ACGTCGAATCTAGAGA,81,82,1,14,1152,0,0
2929,ACGTCGAATCAAGAGA,81,82,1,13,1831,0,0
2933,ACGTCGAATCTAGATA,81,82,1,11,1957,0,0
2939,ACGTCGAATCTAGAGA,81,82,1,10,2132,0,0
2946,ACGTCGAATCTAGAGA,81,82,1,11,2313,0,0
2950,ACGTCGAATCTAGAGA,81,82,1,12,2419,0,0
392,ACGTCGAATCTAGAGA,54,83,29,11,169,9,0
462,ACGTCGAATCTAGAGA,56,83,27,7,152,8,0
498,ACGTCGAATCTAGAGA,56,83,27,10,344,8,0
560,ACGTCGAATCTAGAGA,58,83,25,9,185,7,0
576,ACGTCGAATCTAGAGA,58,83,25,9,302,7,0
680,ACGTCGAATCTAGAGA,60,83,23,8,269,7,0
724,ACGTCGAATCTAGAGA,60,83,23,11,496,6,0
827,ACGTCGAATCTAGAGA,62,83,21,10,424,5,0
1025,ACGTCGAATCTAGAGA,64,83,19,12,692,4,0
1158,ACGTCGAATCTAGAGA,65,83,18,13,799,1,0
1293,ACGTCGAATCTAGAGA,67,83,16,9,390,2,0
1359,ACGTCGAATCTAGAGA,67,83,16,12,913,2,0
1451,ACGTCGAATCTAGAGA,68,83,15,10,747,1,0
1522,ACGTCGAATCTAGAAA,68,83,15,10,1020,2,0
1532,ACGTCAAATCTAGAGA,68,83,15,10,1031,2,0
1586,ACGTCGAATCTAGAGA,69,83,14,14,661,1,0
1626,ACGTCGAATCTAGAGA,69,83,14,11,867,1,0
1657,ACGTCGAATCTAGAGA,69,83,14,8,1084,2,0
1704,ATGTCGAATCTAGAGA,69,83,14,14,1155,0,0
1777,ACGTCGAATCTAGAGA,70,83,13,12,927,0,0
1900,ACGTCGAATCTAGAGA,71,83,12,10,592,1,0
1913,ACGTCGAATCTAGAGA,71,83,12,10,756,2,0
1914,ACGTCGAATCTAGAGA,71,83,12,13,758,0,0
1970,ACGTCGAATCTAGAGA,71,83,12,13,1353,0,0
1998,ACGTCGAATCTAGAGA,72,83,11,14,646,0,0
2014,ACGTCGAATCTAGAGA,72,83,11,11,818,1,0
2016,ACGTCGAATCTAGAGA,72,83,11,11,827,0,0
2043,ACGTCGAATCTAGAAA,72,83,11,10,1020,0,0
2064,ACGTCGAATCTAGAGA,72,83,11,10,1295,1,0
2069,ACGTCGAATCTAGAGA,72,83,11,10,1300,1,0
2080,ACGTCGAATCTAGAGA,72,83,11,16,1327,1,0
2086,ACGTCGAATCTAGAGA,72,83,11,8,1393,1,0
2097,ACGTCGAATCTAGAGA,73,83,10,9,239,1,0
2113,ACGTCGAATCTAGAGA,73,83,10,12,523,1,0
2152,ACGTCGAATCTAGAGA,73,83,10,12,931,0,0
2205,ACGTCGAATCTAGAGA,74,83,9,10,263,1,0
2235,ACGTCGAATCTAGAGA,74,83,9,13,758,1,0
2278,ACGTCGAATCTAGAGA,74,83,9,12,1667,0,0
2283,ACGTCGAATCTTGAGA,74,83,9,13,1752,1,0
2289,ACGTCGAATCTAGAGA,74,83,9,13,1834,1,0
2308,ACGTCGAATCTAGAGA,75,83,8,11,645,2,0
2319,ACGTCGAATCTAGAGA,75,83,8,10,777,1,0
2327,ACGTCGAATCTAGAGA,75,83,8,8,810,0,0
2353,ACGTCGAATCTAGAGA,75,83,8,13,1370,0,0
2355,ACGTCGAATCTAGAGA,75,83,8,14,1403,0,0
2402,ACGTCGAATCTAGAGA,76,83,7,9,511,1,0
2408,ACGTCGAATCTAGAGA,76,83,7,12,545,0,0
2414,ACCTCGAATCTAGAGA,76,83,7,9,688,1,0
2427,ACGTCGAATCTAGAGA,76,83,7,12,1189,0,0
2439,ACGTCGAATCTAGAGA,76,83,7,14,1507,0,0
2469,ACGTCGAATCTAGAGA,76,83,7,14,1952,0,0
2490,ACGTCGAATCTAGAGA,77,83,6,10,554,0,0
2497,ACGTCGAATCTAGAGA,77,83,6,10,582,1,0
2514,ACGTCGAATCTAGAGA,77,83,6,12,929,0,0
2524,ACGTCAAAGCTAGAGA,77,83,6,10,1027,0,0
2540,ACGTCGAATCTAGAGA,77,83,6,11,1482,1,0
2564,ACGTCGAATCTAGAGA,77,83,6,10,2109,0,0
2572,ACGTCGAATCTAGAGA,78,83,5,8,350,0,0
2606,ACGTCGAATCTAGAGA,78,83,5,11,1096,0,0
2613,ACGTCGAATCTAGAGA,78,83,5,14,1403,0,0
2641,ACGTCGAATCTAGAGA,78,83,5,8,1867,0,0
2643,ACGTCGAATCTAGAGA,78,83,5,11,1879,0,0
2645,ACGTCGAATCTAGAGA,78,83,5,11,1946,0,0
2680,ACGTCGAATCTAGAGA,79,83,4,9,390,0,0
2697,ACCTCGAATCTAGAGA,79,83,4,9,688,0,0
2718,ACGTCGAATCTAGAGA,79,83,4,15,1212,0,0
2733,ACGTCGAATCTAGAGA,79,83,4,12,1626,0,0
2749,ACGTCGAATCTAGAGA,79,83,4,9,1976,0,0
2755,ACGTCGAATCTAGAGA,79,83,4,12,2058,0,0
2762,ACGTTGAATCTAGAGA,79,83,4,14,2229,0,0
2777,ACGTCGAATCTAGAGA,80,83,3,10,554,0,0
2785,ACGTCGAATCTAGAGA,80,83,3,10,588,0,0
2819,ACGTCGAATCTAGAGA,80,83,3,10,1725,0,0
2826,ACGTCGAATCTAGAGA,80,83,3,11,2074,0,0
2832,ACGTCGAATCTAGAGA,80,83,3,13,2148,0,0
2840,ACGTCGAATCTAGAGA,80,83,3,11,2347,0,0
2842,ACGTCGAATCTAGAAA,80,83,3,12,2361,0,0
2854,ACGTCGAATCTAGAGA,81,83,2,8,350,0,0
2857,ACGTCGAATCTAGAGA,81,83,2,11,474,0,0
2860,ACGTCGAATCTAGAGA,81,83,2,8,608,0,0
2870,ACGTCGAATCTAGAGA,81,83,2,10,748,0,0
2871,ACGTCGAATCTAGAGA,81,83,2,10,749,0,0
2872,ACGTCGAATCTAGAGA,81,83,2,10,760,0,0
2891,ACGTCGAATCTAGAGA,81,83,2,11,1058,0,0
2896,ACGTCGAATCTAGAGA,81,83,2,11,1076,0,0
2945,ACGTCGAATCTAGAGA,81,83,2,9,2295,0,0
2965,ACGTCGAATCTAGAGA,82,83,1,12,392,0,0
2987,ACGTCGAATCTAGAGA,82,83,1,12,904,0,0
3006,ACGTCGAATCTAGAGA,82,83,1,13,1776,0,0
3015,ACGTCGAATCTAGAGA,82,83,1,14,2046,0,0
3027,ACGTCGAATCTAGAGA,82,83,1,11,2234,0,0
3034,ACGTCGAATCTAGAGA,82,83,1,12,2308,0,0
3036,ACGTCGAATCTAGAGA,82,83,1,14,2349,0,0
3040,ACGTCGAATCTAGAGA,82,83,1,10,2390,0,0
349,ACGTCGAATCTAGAGA,52,84,32,12,243,10,0
502,ACGTCGAACCTAGAGA,56,84,28,10,348,8,0
627,ACGTCGAATCTAGAGA,59,84,25,10,338,7,0
633,ACGTCGAACCTAGAGA,59,84,25,10,348,7,0
678,AGGTCGAATCTAGAGA,60,84,24,8,223,7,0
737,ACGTCGAATCTAGAGA,61,84,23,9,184,6,0
790,ACGTCGAATCTAGAGA,61,84,23,12,528,6,0
805,ACGTCGGATCTAGAGA,62,84,22,10,194,6,0
861,ACGTCGAATCTAGAGA,62,84,22,10,576,5,0
905,ACGTCGAATCTAGAGA,63,84,21,11,467,5,0
906,ACGTCGAATCTAGAGA,63,84,21,11,468,5,0
930,ACGTCGAATCTAGAGA,63,84,21,11,623,5,0
1028,ACGTCGAATCTAGAGA,64,84,20,12,696,4,0
1157,ACGTCGAATCTAGAGA,65,84,19,13,797,2,0
1189,ACGTCGAATCTAGAGA,66,84,18,11,498,4,0
1218,ACGTCGAATCTAGAGA,66,84,18,14,661,2,0
1231,ACGTCGAATCTAGAGA,66,84,18,11,814,3,0
1286,ACGTCGAATCTAGAGA,67,84,17,9,302,2,0
1298,ACGTCGAATCTAGACA,67,84,17,12,412,1,0
1300,ACGTCGAATCTAGAGA,67,84,17,9,505,1,0
1321,ACCTCGAATCTAGAGA,67,84,17,9,688,3,0
1328,ACGTCGAATCTAGAGA,67,84,17,12,702,3,0
1394,ACGTCGAATCTAGAGA,68,84,16,10,198,2,0
1534,ACGTCGAATCTAGAGA,68,84,16,10,1033,1,0
1584,ACGTCGAATCTAGAGA,69,84,15,11,657,1,0
1615,ACGTCGAATCTAGAGA,69,84,15,8,848,1,0
1635,ACGTCGAATCTAGAGA,69,84,15,8,1050,1,0
1636,ACGTCGAATCTAGAGA,69,84,15,11,1052,1,0
1672,ACGTCGAATCTAGAGA,69,84,15,11,1106,2,0
1742,ACGTCGAATCTAGAAA,70,84,14,9,681,1,0
1832,ACGTCGAATCTAGAGA,70,84,14,9,1227,2,0
1852,ACGTCGAATCTAGAGA,70,84,14,12,1260,0,0
1868,ACGTCGAATCTAGAGA,71,84,13,10,207,1,0
1876,ACGTCGAATCTAGAGA,71,84,13,10,422,0,0
1877,ACGTCGAATCTAGAGA,71,84,13,10,431,0,0
2002,ACGTCGAATCTAGAGA,72,84,12,11,660,2,0
2017,ACTTCGAATCTAGAGA,72,84,12,11,829,1,0
2111,ACGTCGAATCTAGAGA,73,84,11,9,517,1,0
2151,ACGTCGAATCTAGAGA,73,84,11,12,930,0,0
2236,ACGTCGAATCTAGAGA,74,84,10,13,785,1,0
2248,ACGTCGAATCTAGAGA,74,84,10,14,1078,0,0
2249,ACGTCGAATCTAGAGA,74,84,10,8,1082,0,0
2263,ACGTCGAATCTAGAGA,74,84,10,11,1391,2,0
2295,ACGTCGAATCTAGAGA,75,84,9,8,463,1,0
2323,ACGTCGAATCTAGAGA,75,84,9,13,800,0,0
2419,ACGTCGAATCTAGAGA,76,84,8,11,817,1,0
2438,ACGTCGAATCTAGAGA,76,84,8,11,1462,1,0
2449,ACGTCGAATCTAGAGA,76,84,8,12,1646,1,0
2468,ACGTCGAATCTAGAGA,76,84,8,14,1942,0,0
2481,ACGTCGAATCTAGAGA,77,84,7,7,245,0,0
2511,ACGTCGAATCTAGAGA,77,84,7,11,827,0,0
2519,ACGTCGAATCTAGAGA,77,84,7,13,988,0,0
2530,ACGTCGAATCTAGAGA,77,84,7,13,1336,0,0
2545,ACGTCGAAGCTAGAGA,77,84,7,9,1557,0,0
2558,ACGTCGAATCTAGAGA,77,84,7,9,2009,0,0
2573,ACGTCGAATCTAGAGA,78,84,6,8,462,1,0
2579,ACGTCGAACCTAGAGA,78,84,6,11,502,0,0
2586,ACGTCGAATCTAGAGA,78,84,6,11,657,0,0
2597,ACGTCGAATCTAGAGA,78,84,6,10,767,1,0
2603,ACGTCGAATCTAGAGA,78,84,6,14,872,0,0
2674,ACGTCGAATCTAGAGA,79,84,5,9,185,0,0
2698,ACGTCGAATCTAGAGA,79,84,5,12,696,1,0
2734,ACGTCGAATCTAGAGA,79,84,5,12,1667,1,0
2740,ACGTCGAATCTAGAGA,79,84,5,10,1757,0,0
2789,ACGTCGAATCTAGAGA,80,84,4,12,723,0,0
2814,ACGTCGAATCTAGAGA,80,84,4,14,1512,0,0
2823,ACGTCGAATCTAGAGA,80,84,4,11,1888,0,0
2859,ACGTCGAACCTAGAGA,81,84,3,11,502,0,0
2898,ACGTCGAATCTAGAGA,81,84,3,8,1082,0,0
2899,ACGTCGAATCTAGAGA,81,84,3,11,1087,0,0
2908,ACGTCGAATCTAGAGA,81,84,3,13,1359,0,0
2916,ACGTCGAATCTAGAGA,81,84,3,9,1569,0,0
2930,ACGTCGAATCTAGAGA,81,84,3,8,1864,0,0
2967,ACGTCGAATCTAGAGA,82,84,2,12,412,0,0
2980,ACGTCGGATCTAGAGA,82,84,2,11,805,0,0
2986,ACGTCGAATCTAGAGA,82,84,2,11,852,0,0
3001,ACGTCGAATCTAGAGA,82,84,2,15,1565,0,0
3010,ACGTCGAATCTAGAGA,82,84,2,11,1900,0,0
3014,ACGTCGAATCTAGAGA,82,84,2,12,2006,0,0
3033,ACGTCGAATCTAGAGA,82,84,2,12,2305,0,0
3046,ACGTCGAATCTAGAGA,82,84,2,11,2487,0,0
3048,ACGTCGAATCTAGAGA,82,84,2,11,2494,0,0
3050,ACGTTGAATCTAGAGA,82,84,2,13,2502,0,0
3053,ACGTCGAATCTAGAGA,82,84,2,15,2541,0,0
3082,ACGTCGAATCTAGAGA,83,84,1,10,736,0,0
3102,ACGTCGAATCTAGAGA,83,84,1,12,1261,0,0
3103,ACGTCGAATCTAGAGA,83,84,1,10,1295,0,0
3107,ACGTCGAATCTAGAGA,83,84,1,14,1538,0,0
3110,ACGTCGAATCTAGAGA,83,84,1,12,1667,0,0
3114,ACGTCGAATCTAGAGA,83,84,1,11,1915,0,0
3120,ACGTCGAATCTAGAGA,83,84,1,12,2054,0,0
3136,ACGTCGAATCTAGAGA,83,84,1,12,2354,0,0
3145,TCGTCGAATCTAGAGA,83,84,1,11,2499,0,0
3146,ACGTCGAATCTAGAGA,83,84,1,13,2517,0,0
3151,ACGTCGAATCTAGAGA,83,84,1,10,2609,0,0
3152,ACGTCGAATCTAGAGA,83,84,1,12,2615,0,0
240,ACGTCGAATCTAGAGA,48,85,37,8,164,11,0
513,ACGTCGAATCTAGAGA,57,85,28,8,213,8,0
835,ACGTCGAATCTAGAGA,62,85,23,10,442,5,0
836,ACGTCGAATCTAGAGA,62,85,23,10,444,5,0
1027,ACGTCGAAGCTAGAGA,64,85,21,9,694,5,0
1092,ACGTCGAATCTAGAGA,65,85,20,10,572,3,0
1168,ACGTCGAATCTAGAGA,66,85,19,8,271,3,0
1220,ACGTCGAATCTGGAGA,66,85,19,11,664,2,0
1313,ACGTCGAATCTAGAGA,67,85,18,9,671,4,0
1370,ACGTCGAATCTAGAGA,67,85,18,12,928,3,0
1405,ACGTCGAATCTAGAGA,68,85,17,7,418,2,0
1444,ACGTCGAATCTAGAGA,68,85,17,7,733,2,0
1462,ACGTCGAATCTAGAGA,68,85,17,10,763,3,0
1762,ACGTCGAATCTAGAGA,70,85,15,9,893,1,0
1783,ACGTCGAACCTAGAGA,70,85,15,12,936,1,0
1808,ACGTCGAATCTAGAGA,70,85,15,15,1188,2,0
1823,ACGTCGAATCTAGAGA,70,85,15,15,1211,1,0
1844,ACGTCGAATCTAGAGA,70,85,15,15,1250,1,0
1864,ACGTCGAATCTAGAGA,71,85,14,7,102,2,0
1881,ACGTCGAATCTAGAGA,71,85,14,10,451,1,0
1905,ACGTCGAATCTAGAGA,71,85,14,10,736,0,0
1929,ACGTCGAATCTAGAGA,71,85,14,16,802,1,0
1964,ACGTCGAATCTAGAGA,71,85,14,10,1286,1,0
2004,ACGTCGAATCTAGAGA,72,85,13,11,663,1,0
2022,ACGTCGAATCTAGAGA,72,85,13,11,835,0,0
2026,ACGTCGAATCTAGAGA,72,85,13,11,851,0,0
2030,ACGTCGAATCTAGAGA,72,85,13,11,856,1,0
2031,ACGTCGAATCTAGAGA,72,85,13,11,861,0,0
2051,ACGTCGAATCTAGAGA,72,85,13,13,1028,2,0
2060,ACGTCGAATCTAGAGA,72,85,13,14,1138,0,0
2098,ACGTCGAATCTAGAGA,73,85,12,9,240,2,0
2120,ACGTCGAATCTAGAGA,73,85,12,9,684,0,0
2127,ACGTCGAATCTAGAGA,73,85,12,12,714,1,0
2132,ACGTCGAATCTAGAGA,73,85,12,9,886,1,0
2138,ACGTCGAATCTAGAGA,73,85,12,12,905,0,0
2140,ACGTCGAATCTAGAGA,73,85,12,12,912,1,0
2165,ACGTCGAATCTAGAGA,73,85,12,11,1115,1,0
2272,ACGTCGAATCTAGAGA,74,85,11,9,1569,1,0
2273,ACGTCGAATCTAGAGA,74,85,11,9,1635,0,0
2282,ACGTCGAATCTAGAGA,74,85,11,10,1715,1,0
2292,ACGTCGAATCTAGAGA,75,85,10,8,65,1,0
2341,ACGTCGAATCTAGAGA,75,85,10,11,1133,0,0
2343,ACGTCGAATCTAGAGA,75,85,10,15,1188,0,0
2347,ACGTCGAATCTAGAGA,75,85,10,10,1293,1,0
2379,ACGTCGAATCTAGAGA,75,85,10,10,1829,1,0
2392,ACGTCGAATCTAGAGA,76,85,9,9,240,0,0
2397,ACGTCGAATCTAGAGA,76,85,9,9,390,1,0
2409,ACGTCGAATCTAGAGA,76,85,9,12,546,1,0
2430,ACGTCGAATCTAGAGA,76,85,9,12,1264,1,0
2460,ACGTCGAATCTAGAGA,76,85,9,8,1864,0,0
2474,ACGTCGAATCTAGAGA,76,85,9,11,2038,0,0
2478,ACGTCGAATCTAGAGA,76,85,9,12,2088,0,0
2480,ACGTCGAATCTAGAGA,77,85,8,10,195,0,0
2491,ACGTCGAATCTAGAGA,77,85,8,10,560,1,0
2517,ACGTCGAATCTAGAGA,77,85,8,12,943,1,0
2527,ACGTCGAATCCAGAGA,77,85,8,14,1120,0,0
2529,ACGTCGAATCTTGAGA,77,85,8,13,1333,0,0
2548,ACGTCGAATCTAGAGA,77,85,8,12,1653,0,0
2575,ACGTCGAATCTAGAGA,78,85,7,11,474,0,0
2585,ACGTCGAATCTAGAGA,78,85,7,11,645,1,0
2609,ACGTCGAATCTAGAGA,78,85,7,9,1243,1,0
2634,ACGTCGAATCTAGAGA,78,85,7,10,1761,0,0
2639,ACGTCGAATCTAGAGA,78,85,7,13,1843,0,0
2658,ACGTCGAATCTAGAGA,78,85,7,14,2158,0,0
2678,ACGTCGAATCTAGAGA,79,85,6,12,243,0,0
2690,ACGTCGAATCTAGAGA,79,85,6,12,524,0,0
2714,ACGTCGAATCTAGAGA,79,85,6,13,1025,0,0
2730,ACGTCGAATCTAGAGA,79,85,6,9,1582,0,0
2751,ACGTCGAATCTAGAGA,79,85,6,15,2003,0,0
2761,ACGTCGAATCTAGAGA,79,85,6,8,2201,0,0
2790,ACGTCGAATCTAGAGA,80,85,5,12,724,1,0
2792,ACGTCGAATCTAGAGA,80,85,5,10,736,0,0
2846,ACGTCGAATCTAGAGA,80,85,5,10,2397,0,0
2877,ACGTCGAATCTAGAGA,81,85,4,13,797,0,0
2892,ACGTCGACTCTAGAGA,81,85,4,11,1060,0,0
2894,ACGTCGAATCTAGAGA,81,85,4,11,1067,0,0
2913,ACGTCAAATCTAGAGA,81,85,4,11,1532,0,0
2917,ACGTCGAATCTAGAGA,81,85,4,12,1611,0,0
2937,ACGTCGAATCTAGAGA,81,85,4,14,2085,0,0
2941,ACGTCGAATCTAGAGA,81,85,4,12,2187,0,0
2944,ACGTCGAATCTAGAGA,81,85,4,11,2205,0,0
2949,ACGTCGAATCTAGAGA,81,85,4,10,2402,0,0
2969,ACGTCGAATCTAGAGA,82,85,3,9,511,0,0
2973,ACGTCGAATCTAGAGA,82,85,3,12,523,0,0
2985,ACGTCGAATCTAGAGA,82,85,3,11,836,0,0
2989,ACGTCGAATCTAGAGA,82,85,3,13,1028,0,0
2999,ACGTCGAATCTAGAGA,82,85,3,8,1421,0,0
3018,ACGTCGAATCTAGAGA,82,85,3,9,2086,0,0
3077,ACGTCGAATCTAGAGA,83,85,2,10,582,0,0
3089,ACGTCGAATCTAGAGA,83,85,2,14,1160,0,0
3101,ACGTCGTATCTGGAGA,83,85,2,12,1253,0,0
3108,ACGTCGAATCTAGAGA,83,85,2,12,1587,0,0
3111,ACGTCGAATCTAGAGA,83,85,2,10,1723,0,0
3125,ACGTCGAATCTAGAGA,83,85,2,10,2098,0,0
3127,ACGTCGAATCTAGAGA,83,85,2,13,2153,0,0
3129,ACGTCGAATCTAGAGA,83,85,2,14,2236,0,0
3140,ACGTCGAATCTAGAGA,83,85,2,12,2425,0,0
3150,ACGTCGAATCTAGAGA,83,85,2,9,2573,0,0
3165,ACGTTGAATCTAGAGA,84,85,1,11,469,0,0
3176,ACGTCGAATCTAGAGA,84,85,1,10,760,0,0
3184,ACGTCGAATCTAGAGA,84,85,1,13,981,0,0
3193,ACGTCGAATCTAGAGA,84,85,1,11,1062,0,0
3197,ACGTCGAATCTAGAGA,84,85,1,8,1082,0,0
3209,ACGTCGAATCTAGAGA,84,85,1,14,1403,0,0
3211,ACGTCGAATCTAGAGA,84,85,1,9,1590,0,0
3214,ACGTCGAATCTAGAGA,84,85,1,9,1676,0,0
3223,ACGTCGAATCTAGAGA,84,85,1,9,2020,0,0
3229,ACGTCGAATCTAGAGA,84,85,1,15,2267,0,0
3241,ACGTCGAAGCTAGAGA,84,85,1,12,2560,0,0
3250,ACGTTGAATCTAGGGA,84,85,1,14,2741,0,0
469,ACGTTGAATCTAGAGA,56,86,30,10,205,9,0
504,ACGTCGAATCTAGAGA,57,86,29,8,35,9,0
554,ACGTCGAATCTAGAGA,58,86,28,9,133,8,0
610,ACGTCGAATCTAGAGA,59,86,27,10,206,8,0
760,ACGTCGAATCTAGAGA,61,86,25,9,387,7,0
767,ACGTCGAATCTAGAGA,61,86,25,9,402,7,0
1067,ACGTCGAATCTAGAGA,65,86,21,10,427,5,0
1152,ACGTCGAATCTAGAGA,65,86,21,13,791,4,0
1154,ACGTCGAATCTAGAGA,65,86,21,13,793,4,0
1259,ACGTCGAATCTAGAGA,66,86,20,11,859,5,0
1342,ACGTCGAATCTAGAGA,67,86,19,9,887,2,0
1382,ACGTCGAATCTAGAGA,67,86,19,15,944,3,0
1467,ACGTCGAATCTAGAGA,68,86,18,10,775,3,0
1507,ACGTCGAATCTAGAGA,68,86,18,13,1002,1,0
1546,ACGTCGAATCTAGAGA,69,86,17,8,87,1,0
1683,ACGTCGAATCTAGAGA,69,86,17,11,1122,0,0
1734,ACGTCGAATCTAGAGA,70,86,16,12,524,2,0
1845,ACGTCGAATCTAGAGA,70,86,16,12,1251,1,0
1869,ACGTCGAATCTAGAGA,71,86,15,7,245,1,0
1884,ACGTCGAATCTAGAGA,71,86,15,10,457,1,0
1898,ACGTCGAATCTAGAGA,71,86,15,10,589,2,0
1915,ACGTCGAATCTAGAGA,71,86,15,10,760,1,0
1954,ACGTCGAATCTAGAGA,71,86,15,13,1006,2,0
1957,ACGTCGAATCTAGATA,71,86,15,10,1013,1,0
2019,ACGTCGAATCTAGAGA,72,86,14,14,832,2,0
2020,ACGTCGAATCTAGAGA,72,86,14,8,833,1,0
2023,ACGTCGAATCTAGAGA,72,86,14,11,836,1,0
2119,ACGTCGAATCTAGAGA,73,86,13,9,680,2,0
2178,ACGTCGAATCTAGAGA,73,86,13,13,1359,0,0
2209,ACGTCGAATCTAGAGA,74,86,12,7,418,2,0
2334,ACGTCGAATCTAGAGA,75,86,11,13,981,0,0
2364,ACGTCGAATCTAGAGA,75,86,11,12,1596,1,0
2384,ACGTCGAATCTAGAGA,75,86,11,11,1946,2,0
2406,ACGTCGAATCTAGAGA,76,86,10,12,523,2,0
2463,ACGTCGAATCTAGAGA,76,86,10,11,1898,0,0
2516,ACGTCGAATCTAGAGA,77,86,9,12,940,1,0
2531,ACGTCGAATCTAGAGA,77,86,9,10,1377,1,0
2610,ACGTCGTATCTAGAGA,78,86,8,12,1253,1,0
2636,ACGTCGAATCTAGAGA,78,86,8,10,1797,0,0
2683,ACGTCGAATCTAGAGA,79,86,7,12,412,0,0
2684,ACGTCGAATCTAGAGA,79,86,7,9,504,0,0
2696,ACGTCGAATCTAGAGA,79,86,7,9,684,0,0
2712,ACGTCGAATCTAGAGA,79,86,7,12,904,0,0
2729,ACGTCGAATCTAGAGA,79,86,7,14,1473,0,0
2745,ACGTCGAATCTAGAGA,79,86,7,11,1920,0,0
2754,ACGTCGAATCTAGAGA,79,86,7,12,2034,1,0
2757,ACGTCGAATCTAGAGA,79,86,7,17,2080,0,0
2770,ACGTCGAATCTAGAGA,80,86,6,10,114,0,0
2779,ACGTCGAATCTAGAGA,80,86,6,10,564,0,0
2784,ACGTCGAATCTGGAGA,80,86,6,13,584,0,0
2843,ACGTCGACTCTAGAGA,80,86,6,11,2379,0,0
2844,ACGTCGAATCTAGAGA,80,86,6,12,2384,0,0
2885,ACGTCGAATCTAGAGA,81,86,5,10,985,0,0
2909,ACGTCGAATCTAGAGA,81,86,5,11,1439,0,0
2955,ACGTCGAATCTAGAGA,81,86,5,11,2523,0,0
2981,ACGTCGAATCTAGAGA,82,86,4,11,806,0,0
2982,ACGTCGAATCTAGAGA,82,86,4,11,811,0,0
2992,ACGTCGAATCTAGAGA,82,86,4,11,1149,0,0
2994,ACGTCGAATCTAGAGA,82,86,4,14,1157,0,0
2996,ACGTCGAATCTAGAGA,82,86,4,12,1259,0,0
3002,ACGTCGAATCTAGAGA,82,86,4,15,1608,0,0
3016,ACGTCGAATCTAGAGA,82,86,4,14,2051,0,0
3028,ACGTCGAATCTAGAGA,82,86,4,14,2235,0,0
3031,ACGTCGAATCTAGAGA,82,86,4,12,2263,0,0
3037,ACGTCGAATCTAGAGA,82,86,4,13,2364,0,0
3047,ACGTCGAATCTAGAGA,82,86,4,11,2489,0,0
3065,ACGTCGAATCTAGAGA,82,86,4,13,2650,0,0
3079,ACGTCGAATCTAGAGA,83,86,3,10,591,0,0
3081,ACGTCGAATCTAGAGA,83,86,3,12,723,0,0
3087,ACGTCGAATCTAGAGC,83,86,3,12,906,0,0
3096,ACGTCGAATCTAGAGA,83,86,3,12,1221,0,0
3099,ACGTCGAATCTAGAGA,83,86,3,12,1231,0,0
3124,ACGTCGAATCTAGAGA,83,86,3,12,2088,0,0
3148,ACGTCGAATCTAGAGC,83,86,3,15,2542,0,0
3195,ACGTCGAATCTAGAGA,84,86,2,11,1068,0,0
3198,ACGTCGAATCTAGAGA,84,86,2,11,1087,0,0
3201,ACGTCGAATCTAGAGA,84,86,2,12,1272,0,0
3217,ACGTCGAATCTAGAGT,84,86,2,13,1834,0,0
3219,ACGTCGAATCTAGAGA,84,86,2,8,1869,0,0
3248,ACGTCGGATCTAGAGA,84,86,2,12,2702,0,0
3264,ACGTCGAATCTAGAGA,85,86,1,9,517,0,0
3273,ACGTCGAATCTAGAGA,85,86,1,11,812,0,0
3294,ACGTCGAATCTAGAGA,85,86,1,14,1473,0,0
3304,ACGTCGAATCTAGAGA,85,86,1,8,1931,0,0
3308,ACGTCGAATCTAGAGA,85,86,1,12,2034,0,0
3314,ACGTCGAATCTAGAGA,85,86,1,16,2124,0,0
3326,ACGTCGAATCTAGAGA,85,86,1,14,2349,0,0
3331,ACGTCGAATCTAGAGA,85,86,1,14,2434,0,0
3349,ACGTCGAATCTAGAGA,85,86,1,12,2716,0,0
3350,ACGTCGAATCTAGAGA,85,86,1,16,2732,0,0
3359,ACGTCGAATCTAGAGA,85,86,1,15,2914,0,0
3360,ACGTCGAATCTAGAGA,85,86,1,10,2918,0,0
3364,ACGTCGAATCTAGAGA,85,86,1,17,2951,0,0
350,ACGTCGAATCTAGAGA,53,87,34,7,61,10,0
582,ACGTCGAATCTAGAGA,58,87,29,9,314,9,0
640,ACGTCGAATCTAGAGA,59,87,28,10,422,8,0
645,ACGTCGAATCTAGAGA,59,87,28,10,431,8,0
887,ACGTCGAATCTAGAGA,63,87,24,8,213,6,0
929,ACGTCGAATCTAGAGA,63,87,24,11,619,6,0
1197,ACGTCGAATCTAGAGA,66,87,21,11,611,3,0
1253,ACGTCGTATCTAGAGA,66,87,21,11,850,4,0
1261,ACGTCGAATCTAGAGA,66,87,21,11,863,4,0
1267,ACGTCGAATCTAGAGA,66,87,21,11,871,3,0
1344,ACGTCGAATCTAGAGA,67,87,20,9,890,1,0
1475,ACGTCGAATCTAGAGA,68,87,19,13,797,2,0
1484,ACGTCGAATCTAGAGA,68,87,19,13,969,2,0
1494,ACGTCGAATCTAGAGA,68,87,19,10,982,1,0
1510,ACGTCGAATCTAGAGA,68,87,19,13,1006,3,0
1545,ACGTCGAATCTAGAGA,69,87,18,8,65,2,0
1557,ACGTCGAATCTAGAGA,69,87,18,8,463,1,0
1835,ACGTCGAATCTAGAGA,70,87,17,12,1232,0,0
1851,ACGTCGAATCTAGAGA,70,87,17,12,1259,0,0
1874,ACGTCGAATCTAGAGA,71,87,16,10,415,1,0
2038,ACGTCGAATCTAGAGA,72,87,15,10,1010,2,0
2054,ACGTCGAATCTAGAGA,72,87,15,11,1055,2,0
2076,ACGTCGAATCTAGAAA,72,87,15,10,1319,3,0
2088,ACGTCGAATCTAGAGA,72,87,15,11,1451,2,0
2195,ACGTCGAATCTAGAGA,73,87,14,9,1582,1,0
2212,ACGTCGAATCTAGAGA,74,87,13,10,444,1,0
2267,ACGTCGAATCTAGAGA,74,87,13,14,1458,1,0
2269,AGGTCGAATCTAGAGA,74,87,13,11,1520,0,0
2277,ACGTCGAATCTAGAGA,74,87,13,12,1660,1,0
2338,ACGTCGAATCTAGAGA,75,87,12,11,1056,0,0
2352,ACGTCGAATCTAGAGA,75,87,12,13,1369,1,0
2411,AGGTCGAATCTAGAGA,76,87,11,9,678,1,0
2426,ACGTCGAATCTAGAGA,76,87,11,11,1119,1,0
2429,ACGTCGAATCTAGAGA,76,87,11,15,1212,1,0
2470,ACGTCGAATCTAGAGA,76,87,11,14,1953,1,0
2543,ACGTCGAATCTAGAGA,77,87,10,9,1548,0,0
2556,ACGTCGAATCTAGAGA,77,87,10,11,1962,1,0
2587,ACGTCGAATCTAGAGA,78,87,9,14,661,1,0
2591,ACGTCGAATCTAGAGA,78,87,9,7,746,0,0
2618,ACCTCGAATCTAGAGA,78,87,9,11,1524,1,0
2620,ACGTCGAATCTAGAGA,78,87,9,12,1563,0,0
2629,ACGTCGAATCTAGAGA,78,87,9,12,1695,1,0
2664,ACGTCGAATCTAGAGA,78,87,9,14,2245,0,0
2704,ACGTCGAATCTAGAGA,79,87,8,11,811,0,0
2746,ACGTCGAATCTAGAGA,79,87,8,17,1929,1,0
2747,ACGTCGAATCTAGACA,79,87,8,8,1931,0,0
2788,ACGTCGAATCTTGAGA,80,87,7,12,718,0,0
2797,ACGTCGAATCTAGAGA,80,87,7,11,861,0,0
2804,ACGTCGAAGCTAGAGA,80,87,7,10,1027,0,0
2816,ACGTCGAATCTAGAGA,80,87,7,9,1590,0,0
2862,ACGTCGAATCTAGAGA,81,87,6,11,627,0,0
2868,ACGTCGAATCTAGAGA,81,87,6,10,737,0,0
2880,ACGTCGAATCTAGAGA,81,87,6,12,940,0,0
2890,ACGTCAAATCTAGAGA,81,87,6,10,1031,0,0
2935,ACGTCGAATCTAGAGA,81,87,6,12,2002,0,0
2947,ACGTCGAATCTAGAGA,81,87,6,11,2319,1,0
2963,ACGTCGAATCTAGAGA,82,87,5,12,243,0,0
2968,ACGTCGAATCTAGAGA,82,87,5,9,504,0,0
3004,ACGTCGAATCTAGAGA,82,87,5,13,1734,0,0
3019,ACGTCGAATCTAGAGA,82,87,5,12,2165,0,0
3038,ACGTCGAATCTAGAGA,82,87,5,13,2371,1,0
3056,ACGTCGAATCTAGAGA,82,87,5,12,2585,0,0
3080,ACGTCGAATCTAGAGA,83,87,4,12,714,0,0
3086,ACGTCGAATCTAGAGA,83,87,4,12,905,0,0
3090,ACGTCGAATCTAGAGA,83,87,4,9,1168,0,0
3105,ACGTCGAATCTAGAGA,83,87,4,11,1452,0,0
3116,ACGTCGAATCTAGAGA,83,87,4,9,1972,0,0
3134,ACGTCGAATCTAGAGA,83,87,4,14,2321,0,0
3147,ACGTCGAATCTAGAGA,83,87,4,12,2526,0,0
3149,ACGTCGAATCTAGAGA,83,87,4,11,2565,0,0
3154,ACGTCGAATCTAGAGA,83,87,4,12,2644,0,0
3158,ACGTCGAATCTAGAGA,83,87,4,13,2720,0,0
3172,ACGTCGAATCTAGAGA,84,87,3,14,661,0,0
3179,ACGTCGAATCTAGAGA,84,87,3,13,785,0,0
3189,ACGTCGAATCTAGAGA,84,87,3,13,1006,0,0
3191,ACGTCAAATCTAGAGA,84,87,3,10,1031,0,0
3192,ACGTCGAATCTAGAGA,84,87,3,11,1058,0,0
3244,ACGTCGAATCTAGAGA,84,87,3,15,2587,0,0
3255,ACGTCGAATCTAGAGA,85,87,2,9,185,0,0
3271,ACGTCGAATCTAGAGA,85,87,2,11,806,0,0
3279,ACGTCGAATCTAGAGA,85,87,2,14,1152,0,0
3285,ACGTCGAATCTAGAGA,85,87,2,10,1342,0,0
3295,ACGTCGAATCTAGAGA,85,87,2,14,1475,0,0
3299,ACGTCGAATCAAGAGA,85,87,2,13,1831,0,0
3319,ACGTCGAATCTAGAGA,85,87,2,12,2167,0,0
3335,ACGTCGAATCTAGAGA,85,87,2,11,2489,0,0
3337,ACGTCGAATCTGGAGA,85,87,2,14,2521,0,0
3373,ACGTCGAATCTAGAGA,86,87,1,10,582,0,0
3376,ACGTCGAATCTAGAGA,86,87,1,12,714,0,0
3378,ACGTCGAATCTAGAGA,86,87,1,10,736,0,0
3383,ACGTCGAATATAGAGA,86,87,1,12,1197,0,0
3415,ACGTCGAATCTAGAGA,86,87,1,11,1962,0,0
3418,ACGTCGAATCTAGAGA,86,87,1,9,2025,0,0
3419,ACGTCGAATCTAGAGA,86,87,1,11,2039,0,0
3458,ACGTCGAATCTAGAGA,86,87,1,12,3049,0,0
412,ACGTCGAATCTAGAGA,54,88,34,11,288,10,0
517,ACGTCGAATCTAGAGA,57,88,31,8,269,9,0
521,ACGTCGAATCTAGAGA,57,88,31,11,274,9,0
714,ACGTCGAATCTAGAGA,60,88,28,11,476,8,0
748,ACGTCGAATCTAGAGA,61,88,27,9,299,8,0
797,ACGTCGAATCTAGAGA,61,88,27,12,541,8,0
904,ACGTCGAATCTAGAGA,63,88,25,11,465,6,0
1058,ACGTCGAATCTAGAGA,65,88,23,10,321,6,0
1124,ACGTCGAATCTAGAGA,65,88,23,10,749,5,0
1338,ACGTCGAATCTAGAGA,67,88,21,12,727,2,0
1421,ACGTCGAATCTAGAGA,68,88,20,7,548,2,0
1512,ACGTCGAATCTAGAGA,68,88,20,13,1009,2,0
1514,ACGTCGAATCTAGAGA,68,88,20,10,1011,2,0
1541,ACGTCGAATCTAGAGC,68,88,20,13,1041,3,0
1565,ACGTCGAATCTAGAGA,69,88,19,14,497,2,0
1727,ACGTCGAATCTAGAGA,70,88,18,12,412,1,0
1754,ACGTCGAATCTAGAGA,70,88,18,12,723,1,0
1849,ACCTCGAATCTAGAGA,70,88,18,12,1257,0,0
1904,ACGTCGAATCTAGAGA,71,88,17,10,735,3,0
2036,ACGTCGAATCTAGAGA,72,88,16,11,873,1,0
2077,ACCTCGAATCTAGAGA,72,88,16,10,1321,2,0
2187,ACGTCGAATCTAGAGA,73,88,15,11,1467,2,0
2291,ACGTCGAATCTAGAGA,75,88,13,8,35,2,0
2293,ACGTCGAATCTAGAGA,75,88,13,8,350,1,0
2305,ACGTCGAATCTAGAGA,75,88,13,11,627,1,0
2342,ACGTCGAATCTAGAGA,75,88,13,9,1176,1,0
2344,ACGTCGAATCTAGAGA,75,88,13,9,1194,1,0
2369,ACGTCGAATCTAGAGA,75,88,13,12,1611,1,0
2403,ACGTCGAATCTAGAGA,76,88,12,9,513,1,0
2455,ACGTCGAACCTAGAGA,76,88,12,13,1783,1,0
2457,ACGTCGAATCTAGAGA,76,88,12,13,1793,1,0
2459,ACGTCGAATCTAGAGA,76,88,12,10,1841,0,0
2487,ACGTCGAATCTAGAGA,77,88,11,10,436,2,0
2512,ACGTCGAATCTAGAGA,77,88,11,14,832,1,0
2520,ACGTCGAATCTAGAGA,77,88,11,13,1003,1,0
2541,ACGTCGAATCTAGAGA,77,88,11,14,1510,2,0
2615,ACGTCGAATCTAGAGA,78,88,10,11,1439,2,0
2650,ACGTCGAATCTAGAGA,78,88,10,12,2011,1,0
2657,ACGTCGAATCTAGAGA,78,88,10,13,2140,1,0
2669,ACGTCGAATCTAGAGA,78,88,10,10,2272,0,0
2670,ACGTCGAATCTAGAGA,78,88,10,11,2282,0,0
2716,ACGTCGAATCTAGAGA,79,88,9,11,1149,1,0
2759,ACGTCGAATCTAGAGA,79,88,9,13,2137,0,0
2778,ACGTCGAATCTAGAGA,80,88,8,10,560,0,0
2794,ACGTCGAATCTAGAGA,80,88,8,11,827,1,0
2802,ACGTCGAATCTAGAGA,80,88,8,12,912,0,0
2809,ACGTCGAATCTAGAGA,80,88,8,13,1337,0,0
2815,ACGTCGCATCTAGAGA,80,88,8,9,1550,1,0
2820,ACGTCGAATCTAGAGA,80,88,8,10,1773,0,0
2861,ACGTCGAATCTAGAGA,81,88,7,11,610,0,0
2914,ACGTCGAATCTAGAGA,81,88,7,14,1533,1,0
2921,ACGTCGAATCTAGAGA,81,88,7,10,1762,0,0
2924,ACGTCGAATCTAGAGA,81,88,7,13,1799,0,0
2952,ACGTCGAATCTAGAGA,81,88,7,14,2434,0,0
3062,ACGTCGAATCTAGAGA,82,88,6,10,2628,0,0
3066,ACGTCGAATCTAGAGA,82,88,6,14,2657,1,0
3092,ACGTCGAATCTAGAGA,83,88,5,12,1189,0,0
3119,ACGTCGAATCTAGAGA,83,88,5,15,2019,0,0
3128,ACGTCGAATCTAGAGA,83,88,5,11,2213,0,0
3130,ACGTCGAATCTAGAGA,83,88,5,16,2279,0,0
3137,ACGTCGAATCTAGAAA,83,88,5,12,2361,0,0
3153,ACGTCGAATCTAGAGA,83,88,5,12,2642,1,0
3155,ACGTCGAATCTAGAGA,83,88,5,15,2646,1,0
3174,ACGTCGAATCTAGAGA,84,88,4,10,748,0,0
3178,ACGTCGAATCTAGAGA,84,88,4,10,767,0,0
3180,ACGTCGAATCTAGAGA,84,88,4,13,797,0,0
3183,ACGTCGGATCTAGAGA,84,88,4,10,963,0,0
3187,ACGTCGAATCTAGAGA,84,88,4,13,986,0,0
3225,ACGTCGAATCTAGAGA,84,88,4,12,2162,0,0
3231,ACGTCGAATCTAGAGA,84,88,4,12,2326,0,0
3234,ACGTCGAATCTAGAGA,84,88,4,14,2457,0,0
3242,ACGTTGAATCTAGAGA,84,88,4,12,2574,0,0
3267,ACGTCGAATCTAGAGA,85,88,3,12,546,0,0
3268,ACCTCGAATCTAGAGA,85,88,3,9,688,0,0
3282,ACGTCGAATCTAGAGA,85,88,3,12,1259,0,0
3292,ACGTCGAATCTAGAGA,85,88,3,11,1457,0,0
3313,ACGTCGAATCTAGAGA,85,88,3,7,2100,0,0
3332,ACGTCGAATCTAGAGA,85,88,3,12,2461,0,0
3346,ACGTCGAATCTAGAGA,85,88,3,13,2659,0,0
3351,ACGTCGAATCTAGAGA,85,88,3,13,2754,0,0
3352,ACGTCGAATCTAGAGA,85,88,3,16,2767,0,0
3368,ACGTCGAATCTAGAGA,86,88,2,10,444,0,0
3384,ACGTCGAATCTAGAGA,86,88,2,15,1212,0,0
3385,ACGTCGAATCTAGAGA,86,88,2,12,1221,0,0
3416,ACGTCGAATCTAGAGA,86,88,2,11,1969,0,0
3437,ACGTCGAATCTAGAGA,86,88,2,18,2746,0,0
3438,ACGTCGAATCTAGACA,86,88,2,15,2756,0,0
3442,ACGTCGAATCTAGAGA,86,88,2,11,2786,0,0
3451,ACGTCGAATCTAGAGA,86,88,2,13,2995,0,0
3453,ACGTCGAATCTAGAGA,86,88,2,13,3003,0,0
3459,ACGTCGAATCTAGAGA,86,88,2,15,3066,0,0
3474,ACGTCGAATCTAGAGA,87,88,1,10,982,0,0
3479,ACGTCGAATCTAGAGA,87,88,1,10,1011,0,0
3486,ACGTCGAATCTAGAGA,87,88,1,11,1087,0,0
3490,TCGTCGAATCTAGAGA,87,88,1,13,1288,0,0
3496,ACGTCGAATCTAGAGC,87,88,1,14,1541,0,0
3509,ACGTCGAATTTAGAGA,87,88,1,9,2091,0,0
3515,ACGTCGAATCTAGAGA,87,88,1,12,2339,0,0
3527,ACGTCGAATCTAGAGA,87,88,1,14,2633,0,0
3537,ACGTCGAATCAAGAGA,87,88,1,11,2873,0,0
3542,ACGTCGAATCTAGAGA,87,88,1,7,2964,0,0
3544,ACGTCGAATCTAGAGA,87,88,1,14,3005,0,0
3546,ACGTCGAATCTAGAGA,87,88,1,16,3039,0,0
3548,ACGTCGAATCTAGAGA,87,88,1,12,3083,0,0
3550,ACGTCGAATCTAGAGA,87,88,1,13,3091,0,0
3556,ACGTCGAATCTAGAGA,87,88,1,14,3156,0,0
35,ACGTCGAATCTAGAGA,29,89,60,7,12,19,0
133,ACGTCGAATCTAGAGA,42,89,47,8,85,15,0
785,ACGTCGAATCTAGAGA,61,89,28,12,523,8,0
811,ACGTCGAATCTAGAGA,62,89,27,10,253,8,0
1669,ACGTCGAATCTGGAGA,69,89,20,14,1101,3,0
1723,ACGTCGAATCTAGAGA,70,89,19,9,390,2,0
1933,ACGTCGAATCTAGAGA,71,89,18,10,968,1,0
1946,ACGTCGAATCTAGAGA,71,89,18,10,987,2,0
1985,ACGTCGAATCTAGAGA,72,89,17,11,493,1,0
2021,ACGTCGAATCTAGAGA,72,89,17,11,834,1,0
2137,ACGTCGAATCTAGAGA,73,89,16,12,904,2,0
2162,ACGTCGAATCTAGAGA,73,89,16,11,1067,2,0
2192,ACGTCGAATCTAGAGA,73,89,16,12,1552,1,0
2316,ACGTCGAATCTAGAGA,75,89,14,10,763,1,0
2372,ACGTCGAATCTAGAGA,75,89,14,12,1688,0,0
2391,ACGTCGAATCTAGAGA,76,89,13,9,239,0,0
2456,ACGTCGAATCTAGAGA,76,89,13,16,1790,2,0
2500,ACGTCGAATCTAGAGA,77,89,12,10,591,0,0
2526,ACGTCGAATCTAGAGA,77,89,12,11,1100,1,0
2568,ACGTCGAATCTAGAGA,77,89,12,13,2173,0,0
2596,ACGTCGAATCAAGAGA,78,89,11,10,764,2,0
2635,ACGTCGAATCTAGAGA,78,89,11,13,1795,1,0
2675,ACGTCGAATCTAGAGA,79,89,10,9,228,1,0
2728,ATGTCGAATCTAGAGA,79,89,10,11,1431,0,0
2786,ACGTCGAATCTAGAGA,80,89,9,10,591,1,0
2807,ACGTCGAATCTAGAGA,80,89,9,12,1189,0,0
2825,ACGTCGAATCTAGAGA,80,89,9,11,2069,1,0
2831,ACGTCGAATCTAGAGA,80,89,9,13,2127,0,0
2855,ACGTCGAATCTAGAGA,81,89,8,8,462,0,0
2879,ACGTCGAATCTAGAGA,81,89,8,12,930,1,0
2882,ACGTCGAATCTAGAGA,81,89,8,10,963,0,0
2883,ACGTCGAATCTACAGA,81,89,8,13,981,0,0
2900,ACGTCGAATCTAGAGA,81,89,8,11,1104,0,0
2905,ACGTCGAATCTAGAGA,81,89,8,12,1272,0,0
2938,ACGTCGAATCTAGAGA,81,89,8,10,2109,1,0
2954,ACGTCGAATCTAGAGA,81,89,8,13,2516,0,0
2993,ACGTCGAATCTAGAGA,82,89,7,14,1154,1,0
3003,ACGTCGAATCTAGAGA,82,89,7,12,1665,1,0
3024,ACGTCGAATCTAGAGA,82,89,7,8,2209,0,0
3061,ACCTCGAATCTAGAGA,82,89,7,12,2618,0,0
3072,ACGTCGAATCTAGAGA,83,89,6,10,451,0,0
3073,ACGTCGAATCTAGAGA,83,89,6,10,554,0,0
3094,ACGTCGAATCTAGAGA,83,89,6,15,1212,0,0
3104,ACGTCGAATCTAGAGA,83,89,6,10,1377,0,0
3138,ACGTCGAATCTAGAGA,83,89,6,13,2406,1,0
3224,ACGTCGAATCTAGAGA,84,89,5,10,2119,0,0
3270,ACGTCGAATCTAGAGA,85,89,4,15,700,0,0
3275,ACGTCGAATCTAGAGA,85,89,4,12,904,0,0
3277,ACGTCGAATCTAGAGA,85,89,4,11,1124,0,0
3290,ACGTCGAATCTAGAGA,85,89,4,8,1421,0,0
3311,ACGTCGAATCTAGAGA,85,89,4,12,2055,0,0
3327,ACGTCGAATCTAGAGA,85,89,4,12,2384,0,0
3348,ACGTCGAATCTAGAGA,85,89,4,13,2692,0,0
3362,ACGTCGAATCTAGAGA,85,89,4,13,2942,0,0
3375,ACGTCGAATCTAGAGA,86,89,3,10,591,0,0
3389,ACGTCGTATCTAGAGA,86,89,3,12,1253,0,0
3402,ACGTCGAATCTAGAGA,86,89,3,14,1512,0,0
3417,ACGTCGAATCTAGAGA,86,89,3,12,2021,0,0
3424,ACGTCGAATCTAGAGA,86,89,3,13,2367,0,0
3428,ACGTCGAATCTAGAGA,86,89,3,11,2523,0,0
3447,ACGTCGAATCAAGAGA,86,89,3,15,2956,0,0
3462,ACGTCGAATCTAGAGA,87,89,2,8,608,0,0
3470,ACGTCGAATCTAGAGA,87,89,2,13,797,0,0
3472,ACGTCGAATCTAGAGA,87,89,2,10,963,0,0
3475,ACGTCGAATCTAGAGA,87,89,2,10,985,0,0
3482,ACGTCGAATCTAGAGA,87,89,2,11,1062,0,0
3499,ACGTCGAATCTAGAGA,87,89,2,15,1565,0,0
3511,ACGTCGAATCTAGAGA,87,89,2,11,2213,0,0
3512,ACGTCGAATCTAGAGA,87,89,2,16,2279,0,0
3558,ACGTCGAATCTAGAGA,88,89,1,9,133,0,0
3568,ACCTCGAATCTAGAGA,88,89,1,9,688,0,0
3580,ACGTCGAATCTAGAGA,88,89,1,11,1416,0,0
3588,ACGTCGAATCTAGAGA,88,89,1,12,1617,0,0
3593,ACGTCGAATCTGGAGA,88,89,1,15,1669,0,0
3598,ACGTCGAATCTAGAGA,88,89,1,11,1865,0,0
3601,ACGTCGAATCTAGAGA,88,89,1,14,2081,0,0
3614,ACGTCGAATCTAGAGA,88,89,1,13,2513,0,0
3616,ACGTCGAATCTAGAGC,88,89,1,15,2542,0,0
3643,ACGTCGAATCTAGAGA,88,89,1,14,3160,0,0
3650,ACGTCGAATCTAGAGA,88,89,1,13,3232,0,0
290,ACGTCGAATCTAGAGA,51,90,39,5,18,12,0
696,ACGTCGAATCTAGAGA,60,90,30,11,369,9,0
723,ACGTCGAATCTAGAGA,60,90,30,11,494,9,0
736,ACGTCGAATCTAGAGA,61,90,29,9,182,9,0
806,ACGTCGAATCTAGAGA,62,90,28,10,195,8,0
988,ACGTCGAATCTAGAGA,64,90,26,12,410,6,0
1196,ACGTCGAATCTAGAGA,66,90,24,11,610,5,0
1333,ACGTCGAATCTTGAGA,67,90,23,12,718,4,0
1667,ACGTCGAATCTAGAGA,69,90,21,11,1097,4,0
1969,ACGTCGAATCTAGAGA,71,90,19,10,1293,2,0
1997,ACGTCGAATCTAGAGA,72,90,18,11,645,1,0
2034,ACGTCGAATCTAGAGA,72,90,18,11,867,2,0
2058,ACGTCGAATCTAGAGA,72,90,18,11,1092,2,0
2145,ACGTCGAATCTAGAGA,73,90,17,12,923,1,0
2175,ACGTCGAATCTAGAGA,73,90,17,13,1330,1,0
2349,ACGTCGAATCTAGAGA,75,90,15,13,1326,3,0
2374,ACGTCGAATCTAGAGA,75,90,15,13,1733,0,0
2442,ACGTCGAATCTAGAGA,76,90,14,11,1540,1,0
2458,ACGTCGAATCTAGAGA,76,90,14,13,1816,1,0
2482,ACGTCGAATCTAGAGA,77,90,13,10,263,1,0
2494,ACGTCGAATCTAGAGA,77,90,13,10,574,1,0
2528,ACGTCGAATCTAGAGA,77,90,13,12,1267,2,0
2542,ACGTCGAATCTAGAGC,77,90,13,14,1541,2,0
2565,ACGTCGAATCTAGAGA,77,90,13,10,2111,1,0
2590,ACGTCGAATCTAGAGA,78,90,12,10,740,2,0
2653,ACCTCGAATCTAGAGA,78,90,12,11,2045,0,0
2663,ACGTCGAATCTAGAGA,78,90,12,11,2226,0,0
2668,ACGTCGAATCTAGAGA,78,90,12,12,2263,0,0
2695,ACGTCGAATCTAGAGA,79,90,11,9,680,0,0
2735,ACGTCGAATCTGGAGA,79,90,11,15,1669,1,0
2744,ACGTCGAATCTAGAGA,79,90,11,11,1913,0,0
2800,ACGTCGAATCTAGAGA,80,90,10,12,905,0,0
2818,ACGTCGAATCTAGAGA,80,90,10,10,1723,1,0
2829,ACGTCGAATCTAGAGA,80,90,10,7,2100,0,0
2838,ACGTCGAATCTAGAGA,80,90,10,11,2233,0,0
2858,ACGTCGAATCTAGAGA,81,90,9,11,498,0,0
2875,ACGTCGAATCTAGAGA,81,90,9,13,785,0,0
2915,ACGTCGAATCTAGAGA,81,90,9,12,1563,1,0
2932,ACGTCGAATCTAGAGA,81,90,9,14,1954,0,0
2942,ACGTCGAATCTAGAGA,81,90,9,12,2189,1,0
2953,ACGTCGAATCTAGAGA,81,90,9,13,2449,1,0
2959,ACGTCGAATCTAGAGA,82,90,8,9,185,0,0
2966,ACGTCGAATCTAGAGA,82,90,8,9,394,0,0
2984,ACGTCGAATCTAGAGA,82,90,8,11,835,1,0
2988,ACGTCGAATCTAGAGA,82,90,8,13,1025,0,0
2995,ACGTCGAATCTAGAGA,82,90,8,12,1196,2,0
3057,ACGTCGAATCTAGAGA,82,90,8,11,2590,1,0
3076,ACGTCGAATCTAGAGA,83,90,7,10,574,0,0
3078,ACGTCGAATCTGGAGA,83,90,7,13,584,0,0
3126,ACGTCGAATCTAGAGA,83,90,7,13,2114,0,0
3182,ACGTCGAATCTAGAGA,84,90,6,12,940,1,0
3204,ACGTCGAATCTAGAGA,84,90,6,10,1290,0,0
3208,ACGTCGAATCTTGAGA,84,90,6,13,1333,0,0
3218,ACGTGGAATCTAGAGA,84,90,6,13,1858,0,0
3220,ACGTCGAATCTAGAGA,84,90,6,11,1879,0,0
3265,ACGTCGAATCTAGAGA,85,90,5,12,521,0,0
3307,ACGTCGAATCTAGAGA,85,90,5,12,2023,0,0
3309,ACGTCGAATCTAGAGA,85,90,5,12,2036,0,0
3315,ACGTCGAATCTAGAGA,85,90,5,13,2137,0,0
3318,ACGTCGAATCTAGAGA,85,90,5,13,2148,0,0
3339,ACGTCGAATCTAGAGA,85,90,5,12,2537,0,0
3342,ACGTCGAATCTAGAGA,85,90,5,11,2590,0,0
3365,ACGTCGAATCTAGAGA,86,90,4,10,114,0,0
3377,ACGTCGAATCTAGAGA,86,90,4,12,723,0,0
3398,ACGTCGAATCTAGAGT,86,90,4,11,1492,0,0
3429,ACGTCGAATCTAGAGA,86,90,4,15,2541,0,0
3441,TCGTCGAATCTAGAGA,86,90,4,11,2781,0,0
3449,ACGTCGAATCTAGAGA,86,90,4,12,2984,0,0
3457,ACGTCGAATCTAGAGA,86,90,4,14,3038,0,0
3487,ACGTCGAATCTAGAGA,87,90,3,11,1104,0,0
3504,ACGTCGAATCTAGAGA,87,90,3,13,1858,0,0
3513,ACGTCGAATCTAGAGA,87,90,3,9,2291,0,0
3518,ACGTCGAATCTAGAGA,87,90,3,14,2435,0,0
3519,ACGTCGAATCTAGAGA,87,90,3,15,2440,0,0
3526,ACGTCGAATCTAGAGA,87,90,3,13,2622,0,0
3529,ACGTCGAATCTAGAGA,87,90,3,12,2706,0,0
3552,ACGTCGAATCTAGAGA,87,90,3,16,3117,0,0
3555,ACGTCGAATCTAGAGA,87,90,3,16,3155,0,0
3557,ACGTCGAATCTAGAGA,87,90,3,14,3159,0,0
3587,ACGTCGAATCTAGAGA,88,90,2,12,1611,0,0
3589,ACGTAGAATCTAGAGA,88,90,2,12,1622,0,0
3594,ACGTCGAATCTAGAGA,88,90,2,9,1676,0,0
3605,ACGTCGAATCTAGAGA,88,90,2,11,2314,0,0
3613,ACGTCGAATCTAGAGA,88,90,2,11,2489,0,0
3632,ACGTCGAATCTAGAGA,88,90,2,14,2922,0,0
3667,ACGTCGAATCTAGAGA,89,90,1,12,1173,0,0
3675,ACGTCGAATCTAGAGA,89,90,1,11,1452,0,0
3685,ACGTCGAATCAAGAGA,89,90,1,15,1689,0,0
3686,ACGTCGAATCTAGAGA,89,90,1,12,1695,0,0
3687,ACGTCGAATCTAGAGA,89,90,1,15,1702,0,0
3696,ACGTCGAATCTAGAGA,89,90,1,9,2025,0,0
3705,ACGACGAATCTAGAGA,89,90,1,13,2528,0,0
3723,ACGTCGAATCTAGAGA,89,90,1,13,2995,0,0
3724,ACGTCGAATCTAGAGA,89,90,1,14,3007,0,0
245,ACGTCGAATCTAGAGA,49,91,42,6,22,13,0
661,ACGTCGAATCTAGAGA,59,91,32,13,452,10,0
749,ACGTCGAATCTAGAGA,61,91,30,9,301,9,0
1096,ACGTCGAATCTAGAGA,65,91,26,10,577,6,0
1288,ACGTCGAATCTAGAGA,67,91,24,12,309,4,0
1299,ACGTCGAATCTAGAGA,67,91,24,9,504,4,0
1457,ACGTCGAATCTAGAGA,68,91,23,10,756,4,0
1582,ACGTCGAATCTAGAGA,69,91,22,8,651,4,0
1587,ACGTCGAATCTAGAGA,69,91,22,11,663,2,0
1611,ACGTCGAATCTAGAGA,69,91,22,11,835,3,0
1665,ACGTCGAATCTAGAGA,69,91,22,11,1095,3,0
1728,ACGTCGAATCTAGAGA,70,91,21,9,504,2,0
1736,ACGTCGAATCTAGAGA,70,91,21,12,545,2,0
1757,ACGTCGAATCTAGAGA,70,91,21,9,883,3,0
1840,ACGTCGAATCTAGAGA,70,91,21,12,1241,2,0
1846,ACGTCGAATCTAGAGA,70,91,21,9,1252,1,0
1902,ACGTCGAATCTAGAGA,71,91,20,7,733,2,0
1967,ACGTCGAATCTAGAGA,71,91,20,10,1290,1,0
1989,ACGTCGAATCTAGAGA,72,91,19,14,503,0,0
2074,ACGTCGAATCTAGAGA,72,91,19,10,1314,3,0
2100,ACGTCGAATCTAGAGA,73,91,18,6,290,2,0
2114,ACGTCGAATCTAGAGA,73,91,18,12,524,1,0
2203,ACGTCGAATCTAGAGA,74,91,17,10,195,2,0
2234,ACGTCGAATCTAGAGA,74,91,17,10,740,1,0
2247,ACGTCGAATCTAGAGA,74,91,17,11,1068,1,0
2303,ACGTCGAATCTAGAGA,75,91,16,11,610,0,0
2328,ACGTCGAATCTAGAGA,75,91,16,11,811,1,0
2401,ACGTCGAATCTAGAGA,76,91,15,9,504,2,0
2440,ACGTCGAATCTAGAGA,76,91,15,14,1509,2,0
2578,ACGTCGAATCTAGAGA,78,91,13,11,498,1,0
2598,ACGTCGAATCTAGAGA,78,91,13,10,780,2,0
2646,ACGTCGAATCTAGAGA,78,91,13,14,1954,1,0
2651,ACGTCGAATCTAGAGA,78,91,13,9,2025,1,0
2702,ACGTCGGATCTAGAGA,79,91,12,11,805,2,0
2741,ACGTTGAATCTAGGGA,79,91,12,13,1768,1,0
2750,ACGTCGAATCTAGAGA,79,91,12,12,1984,2,0
2756,ACGTCGAATCTAGACA,79,91,12,14,2067,2,0
2782,ACGTCGAATCTAGAGA,80,91,11,10,576,1,0
2805,ACGTCGAATCTGGAGA,80,91,11,14,1101,2,0
2839,ACGTCGAATCTTGAGA,80,91,11,14,2283,1,0
2895,ACGTCGAATCTAGAGA,81,91,10,11,1068,1,0
2919,ACGTCGAATCTAGAGA,81,91,10,13,1727,0,0
2926,ACGTCGAATCTAGAGA,81,91,10,10,1812,0,0
2927,ACGTCGAATCTAGAGA,81,91,10,13,1817,0,0
2928,ACGTCGAATCTAGAGA,81,91,10,16,1823,0,0
2940,ACGTCGAATCTAGAGA,81,91,10,13,2174,1,0
2960,ACGTCGAATCTAGAGA,82,91,9,9,228,1,0
2991,ACGTCGAATCTAGAGA,82,91,9,11,1096,1,0
3032,ACGTCGAACCTAGAGA,82,91,9,12,2301,1,0
3039,ACGTCGAATCTAGAGA,82,91,9,15,2385,1,0
3052,ACGTCGAATCTAGAGA,82,91,9,12,2540,0,0
3075,ACGTCGAATCTAGAGA,83,91,8,10,572,1,0
3141,ACGTCGAATCTAGAGA,83,91,8,13,2430,0,0
3159,ACGTCGAATCTAGAGA,83,91,8,13,2734,1,0
3166,ACGTCGAATCTAGAGA,84,91,7,11,474,0,0
3185,ACGTCGAATCTTGAGA,84,91,7,10,982,1,0
3207,ACGTCGAATCTAGAGA,84,91,7,13,1332,0,0
3210,ACGTCGAATCTAGAGC,84,91,7,14,1541,1,0
3212,ACGTCGAATCTAGAGA,84,91,7,12,1617,0,0
3239,ACGTCGAATCTAGAGA,84,91,7,11,2531,0,0
3247,ACGTCGAATCTAGAGA,84,91,7,10,2675,0,0
3259,ACGTCGAATCTAGAGA,85,91,6,6,290,0,0
3274,ACGTCGAATCTAGAGA,85,91,6,11,852,0,0
3286,ACGTCGAATCTAGAGA,85,91,6,10,1344,0,0
3325,ACGTCGAATCTAGAGA,85,91,6,10,2344,0,0
3356,ACGTCGAATCTAGAGA,85,91,6,13,2879,0,0
3366,ACGTCGAATCTAGAGA,86,91,5,7,245,1,0
3371,ACGTCGAATCTAGAGA,86,91,5,10,572,0,0
3380,ACGTCGAATCTAGAGA,86,91,5,9,887,0,0
3391,ACGTCGAATCTAGAGA,86,91,5,10,1295,0,0
3396,ACGTCGATTCTAGAGA,86,91,5,11,1488,0,0
3432,ACGTCGAATCTAGAGA,86,91,5,13,2688,0,0
3448,ACGTCGAATCTAGAGA,86,91,5,12,2983,0,0
3463,ACGTCGAATCTAGAGA,87,91,4,11,657,0,0
3469,ACGTCGAATCTAGAGA,87,91,4,13,785,0,0
3480,ACGTCAAATCTAGAGA,87,91,4,10,1031,0,0
3489,ACGTCGAATCTAGAGA,87,91,4,10,1287,0,0
3516,ACGTCGAATCTAGAGA,87,91,4,12,2354,0,0
3517,ACGTCGAATCTAGAGA,87,91,4,13,2421,0,0
3528,ACGTCGAATCTAGAGG,87,91,4,13,2665,0,0
3543,ACGTCGAATCTAGAGA,87,91,4,10,2970,0,0
3545,ACGTCGAATCTAGAGA,87,91,4,13,3020,0,0
3547,ACGTCGAATCTAGAGA,87,91,4,12,3057,0,0
3560,ACGTCGAATCTAGAGA,88,91,3,9,228,0,0
3562,ACGTCGAATCTAGAGA,88,91,3,12,243,0,0
3583,ACGTCGAATCTAGAGA,88,91,3,14,1473,0,0
3586,ACGTCGAATCTAGAGA,88,91,3,15,1608,0,0
3591,ACGTCGAATCTAGAGA,88,91,3,12,1665,0,0
3602,ACGTCGAATCTAGAGA,88,91,3,12,2189,0,0
3609,ACGTCGAATCTAGAGA,88,91,3,10,2410,0,0
3612,ACGTCGAATCTAGAGA,88,91,3,12,2461,0,0
3627,ACGTCGAATCTAGAGA,88,91,3,9,2810,0,0
3648,ACGTCGAATCTAGAGA,88,91,3,14,3188,0,0
3702,ACGTCGAATCTAGAGA,89,91,2,7,2394,0,0
3714,ACGTCGAATCTATAGA,89,91,2,13,2833,0,0
3730,ACGTCGAATCTAGAGA,89,91,2,10,3109,0,0
3771,ACGTCGAATCTAGAGA,90,91,1,12,1558,0,0
3779,AAGTCGAATCTAGAGA,90,91,1,11,2074,0,0
3781,ACGTCGAATCTTGAGA,90,91,1,14,2177,0,0
3786,ACGTCGAATCTAGAGA,90,91,1,8,2486,0,0
3800,ACGTCGAATCTAGAGA,90,91,1,13,2834,0,0
3807,ACGTCGAAGCTAGAGA,90,91,1,13,2957,0,0
3810,ACGTCGAATCTAGAGA,90,91,1,12,2990,0,0
3830,ACGTCGAATCTAGAGA,90,91,1,12,3379,0,0
243,ACGTCGAATCTAGAGA,48,92,44,11,169,14,0
394,ACGTCGAATCTAGAGA,54,92,38,8,213,12,0
451,ACGTCGAATCTAGAGA,55,92,37,9,308,11,0
688,ACCTCGAATCTAGAGA,60,92,32,8,357,10,0
700,ACGTCGAATCTAGAGA,60,92,32,14,380,10,0
812,ACGTCGAATCTAGAGA,62,92,30,10,255,9,0
940,ACGTCGAATCTAGAGA,63,92,29,11,641,8,0
1377,ACGTCGAATCTAGAGA,67,92,25,9,938,5,0
1403,ACGTCGAATCTAGAGA,68,92,24,13,349,5,0
1411,ACGTCGAATCTAGAGA,68,92,24,13,437,4,0
1473,ACGTCGAATCTAGAGA,68,92,24,13,790,5,0
1491,ACGTCGAATCTAGAGA,68,92,24,10,978,3,0
1550,ACGTCGCATCTAGAGA,69,92,23,8,273,4,0
1558,ACGTCGAATCTAGAGA,69,92,23,11,465,2,0
1617,ACGTCGAATCTAGAGA,69,92,23,11,852,4,0
1702,ACGTCGAATCTAGAGA,69,92,23,14,1152,3,0
1703,ACGTCGAATCTAGAGA,69,92,23,14,1154,2,0
1748,ACGTCGAATCTAGAGA,70,92,22,12,702,2,0
1831,ACGTCGAATCAAGAGA,70,92,22,12,1226,4,0
2025,ACGTCGAATCTAGAGA,72,92,20,8,848,3,0
2081,ACGTCGAATCTAGAGA,72,92,20,13,1328,3,0
2085,ACGTCGAATCTAGAGA,72,92,20,13,1388,1,0
2215,ACGTCGAATCTAGAGA,74,92,18,7,553,0,0
2237,ACGTCGAATCTAGAGA,74,92,18,12,940,2,0
2332,ACGTCGAATCTAGAGA,75,92,17,13,977,0,0
2339,ACGTCGAATCTAGAGA,75,92,17,11,1097,1,0
2600,ACGTCGAATCTAGAGA,78,92,14,13,790,2,0
2612,ACGTCAAATCTAGAGA,78,92,14,10,1349,1,0
2637,ACGTCGAATCTAGAGA,78,92,14,10,1812,2,0
2676,ACGTCGAATCTAGAGA,79,92,13,9,239,1,0
2717,ACGTCGAATCAAGAGA,79,92,13,12,1196,1,0
2720,ACGTCGAATCTAGAGA,79,92,13,12,1259,1,0
2732,ACGTCGAATCTAGAGA,79,92,13,15,1608,2,0
2845,ACGTCGAATCTAGAGA,80,92,12,10,2388,1,0
2897,ACGTCGAATCTAGAGA,81,92,11,14,1078,2,0
2943,ACGTCGAATCTAGAGA,81,92,11,11,2203,1,0
2976,ACGTCGAATCTAGAGA,82,92,10,9,680,0,0
2990,ACGTCGAATCTAGAGA,82,92,10,11,1092,1,0
2997,ACGTCGAATCTAGAGA,82,92,10,13,1370,2,0
3000,ACGTCGAATCTAGAGA,82,92,10,11,1462,0,0
3035,ACGTCGAATCTAGAGA,82,92,10,11,2314,0,0
3045,ACGTCGAATCTAGAGA,82,92,10,8,2486,0,0
3068,ACGTCGAATCTAGAGA,83,92,9,7,245,0,0
3088,ACGTCGAAGCTAGAGA,83,92,9,10,1027,1,0
3093,ACGTCGAATCTAGAGA,83,92,9,12,1197,1,0
3132,ACGTCGAATCTAGAGA,83,92,9,9,2292,1,0
3157,ACGTCGAATCTAGAGA,83,92,9,13,2698,1,0
3167,ACGTCGAATCTAGAGA,84,92,8,8,608,0,0
3181,ACGTCGAATCTAGAGA,84,92,8,12,929,1,0
3252,ACGTCGCATCTAGAGA,84,92,8,10,2815,0,0
3269,ACGTCGAATCTAGAGA,85,92,7,12,696,0,0
3276,ACGTCGAATCTAGAGA,85,92,7,11,1096,1,0
3287,ACGTCGAATCTAGAGA,85,92,7,16,1382,0,0
3302,ACGTCGAATCTAGAGA,85,92,7,14,1882,0,0
3317,ACGTCGAATCTAGAGA,85,92,7,13,2145,1,0
3370,ACGTCGAATCTAGAGA,86,92,6,10,564,0,0
3382,ACGTCGAATCTAGAGA,86,92,6,12,1173,0,0
3394,ACGTCGAATCTAGAGA,86,92,6,14,1484,0,0
3401,ACGTCGAATCTAGAGA,86,92,6,14,1510,0,0
3403,ACGTCGAATCTAGAGA,86,92,6,11,1514,0,0
3410,ACGTCGAATCTAGAGA,86,92,6,10,1846,0,0
3452,ACGTCGAATCTAGAGA,86,92,6,14,2997,0,0
3473,ACGTCGAATCTAGAGA,87,92,5,13,981,0,0
3476,ACGTCGAATCTAGAGA,87,92,5,13,986,0,0
3514,ACGTTGAATCTAGAGA,87,92,5,12,2296,0,0
3521,ACGTCGAATCTAGAGA,87,92,5,13,2544,0,0
3539,ACGTCGAATCTAGAGA,87,92,5,15,2897,0,0
3585,ACGTCGAATCTAGAGA,88,92,4,9,1590,0,0
3597,ACGTCGAATCTAGAGA,88,92,4,10,1757,0,0
3607,ACGTCGAATCTAGAAA,88,92,4,12,2361,0,0
3608,ACGTCGAATCTAGAGA,88,92,4,13,2371,0,0
3617,ACGTCGAATCTAGAGA,88,92,4,15,2616,0,0
3621,ACGTCGAATCTAGAGA,88,92,4,7,2672,0,0
3622,ACGTCGAATCAAGAGA,88,92,4,13,2717,0,0
3625,ACGTCGAATCAAGAGA,88,92,4,12,2796,0,0
3636,ACGTCGAATCTAGATA,88,92,4,11,3067,0,0
3639,ACGTCGAATCTAGAGA,88,92,4,10,3131,0,0
3649,ACGTCGAATCTAGAGA,88,92,4,14,3226,0,0
3651,ACGTCGAATCTAGAGA,88,92,4,14,3235,0,0
3652,ACGTCGAATCTAGAGA,88,92,4,10,3243,0,0
3656,ACGTCGAATCTAGAGA,89,92,3,10,444,0,0
3676,ACGTCGAATCTAGAGA,89,92,3,8,1485,0,0
3677,ACGTCGAATCTAGAGA,89,92,3,11,1488,0,0
3683,ACGTCGCATCTAGAGA,89,92,3,9,1550,0,0
3707,ACGTCGAATCTAGAGA,89,92,3,11,2598,0,0
3716,ACGTCGAATCTAGAGA,89,92,3,11,2884,0,0
3732,ACGTCGAATCTAGAGA,89,92,3,13,3227,0,0
3759,ACGTCGAATCTAGAGA,90,92,2,11,1076,0,0
3770,ACGTCGAATCTAGAGA,90,92,2,12,1553,0,0
3802,ACGTCGAACCTAGAGA,90,92,2,12,2863,0,0
3806,ACGTCGAATCTAGAGA,90,92,2,12,2943,0,0
3832,ACGTCGAATCTAGAGA,90,92,2,13,3430,0,0
3835,ACGTCGAATCTAGAGA,91,92,1,9,185,0,0
3862,ACGTCGAATCTAGAGA,91,92,1,13,1774,0,0
3868,ACGTCAAATCTAGAGA,91,92,1,10,1801,0,0
3874,ACGTCGAATCTAGAGA,91,92,1,13,1858,0,0
3877,ACGTCGAATCTAGAGA,91,92,1,8,1908,0,0
3891,ACGTCGAATCTAGAGA,91,92,1,14,2600,0,0
3893,ACGTCGAATCTAGAGA,91,92,1,13,2659,0,0
3899,ACGTCGAATCTAGAGA,91,92,1,10,2806,0,0
3901,ACGTCGAATCTAGAGA,91,92,1,15,2897,0,0
3903,ACGTCGAATCTAGAGA,91,92,1,12,2931,0,0
228,ACGTCGAATCTAGAGA,48,93,45,8,85,14,0
546,ACGTCGAATCTAGAGA,57,93,36,11,378,11,0
572,ACGTCGAATCTAGAGA,58,93,35,9,295,11,0
852,ACGTCGAATCTAGAGA,62,93,31,10,561,8,0
981,ACGTCGAATCTAGAGA,64,93,29,12,318,7,0
1492,ACGTCGAATCTAGAGT,68,93,25,10,980,3,0
1538,ACGTCGAATCTAGAGA,68,93,25,13,1037,4,0
1608,ACGTCGAATCTAGAGA,69,93,24,14,832,4,0
1676,ACGTCGAATCTAGAGA,69,93,24,8,1113,4,0
1773,ACGTCGAATCTAGAGA,70,93,23,9,922,3,0
1801,ACGTCAAATCTAGAGA,70,93,23,9,1174,2,0
1879,ACGTCGAATCTAGAGA,71,93,22,10,444,4,0
1921,ACGTCGAATCTAGAGA,71,93,22,10,780,1,0
1972,ACGTCGAATCTAGAGA,72,93,21,8,35,2,0
2055,ACGTCGAATCTAGAGA,72,93,21,11,1056,3,0
2148,ACGTCGAATCTAGAGA,73,93,20,12,927,3,0
2211,ACGTCGAATCTAGAGA,74,93,19,10,436,3,0
2410,ACGTCGAATCTAGAGA,76,93,17,9,670,3,0
2434,ACGTCGAATCTAGAGA,76,93,17,13,1328,2,0
2461,ACGTCGAATCTAGAGA,76,93,17,11,1865,2,0
2502,ACGTTGAATCTAGAGA,77,93,16,12,714,2,0
2523,ACGTCGAATCTAGAGA,77,93,16,10,1013,2,0
2537,ACGTCGAATCTAGAGA,77,93,16,11,1434,3,0
2544,ACGTCGAATCTAGAGA,77,93,16,12,1553,2,0
2566,ACGTCAAATCTAGAGA,77,93,16,10,2136,1,0
2571,ACGTCGAATCTAGAGA,78,93,15,8,35,1,0
2574,ACGTTGAATCTAGAGA,78,93,15,11,469,1,0
2647,ACGTCGAATCTAGAGA,78,93,15,11,1969,1,0
2671,ACGTCGAATCTAGAGA,78,93,15,14,2289,1,0
2713,ACGTCGAATCTAGAGA,79,93,14,10,1019,1,0
2764,ACGTCGAATCTAGAGA,79,93,14,16,2257,2,0
2767,ACGTCGAATCTAGAGA,79,93,14,15,2310,2,0
2803,ACCTCGAATCTAGAGA,80,93,13,10,1022,1,0
2847,ACGTCGAATCTAGAGA,80,93,13,10,2401,2,0
2912,ACGTCGAATCTAGAGA,81,93,12,14,1510,0,0
2936,ACGTCGAATCTAGAGA,81,93,12,12,2014,2,0
2964,ACGTCGAATCTAGAGA,82,93,11,6,290,1,0
2970,ACGTCGAATCTAGAGA,82,93,11,9,513,2,0
3021,ACGTCGAATCTAGAGA,82,93,11,14,2175,0,0
3059,ACGTCGAATCTAGAGA,82,93,11,11,2597,0,0
3143,ACGTCGAATCTAGAGA,83,93,10,15,2470,0,0
3161,ACGTCGAATCTAGACA,83,93,10,15,2756,0,0
3173,ACGTCGAATCTAGAGA,84,93,9,7,746,0,0
3213,ACGTCGAATCTGGAGA,84,93,9,15,1669,0,0
3215,ACGTCGAATCTAGAGA,84,93,9,12,1677,0,0
3216,ACCTCGAATCTAGAGA,84,93,9,10,1744,0,0
3228,ACGTCGAATCTAGAGA,84,93,9,15,2265,0,0
3230,ACGTTGAATCTAGAGA,84,93,9,12,2296,0,0
3243,ACGTCGAATCTAGAGA,84,93,9,9,2580,1,0
3251,ACGTCGAATCTAGAGA,84,93,9,13,2790,0,0
3254,ACGTCGAATCTAGAGA,85,93,8,9,133,0,0
3263,ACGTCGAATCCAGAGA,85,93,8,9,511,0,0
3283,ACGTCGAATCTAGAGA,85,93,8,13,1297,0,0
3284,ACGTCGAATCTAGAGA,85,93,8,13,1338,0,0
3320,ACGTCGAATCTAGAGA,85,93,8,13,2277,1,0
3343,ACGTCAAATCTAGAGA,85,93,8,11,2612,1,0
3345,ACGTCGAATCTAGAGA,85,93,8,14,2640,0,0
3361,ACGTCGAATCTAGAGA,85,93,8,11,2938,0,0
3414,ACGTCGAATCTAGAGA,86,93,7,11,1920,0,0
3421,ACGTCGAATCTAGAGA,86,93,7,12,2187,0,0
3443,ACGTCGAATCTAGAGA,86,93,7,11,2845,1,0
3464,ACGTCGAATCTAGAGA,87,93,6,14,661,0,0
3478,ACGTCGAATCTAGAGA,87,93,6,13,1006,0,0
3493,ACGTCGAATCTAGAGA,87,93,6,13,1332,0,0
3495,ACGTCGAATCTAGAGA,87,93,6,14,1403,0,0
3507,ACGTCGAATCTAGAGA,87,93,6,12,2058,0,0
3554,ACGTCGAATCTAGAGA,87,93,6,13,3153,0,0
3576,ACGTCGAATCTAGAGA,88,93,5,11,1149,0,0
3581,ACGTCGAATCTAGAGA,88,93,5,11,1439,0,0
3611,ACGTCGAATCTAGAGA,88,93,5,14,2458,0,0
3624,ACGTCGAATCTAGAGA,88,93,5,11,2782,0,0
3644,ACGTCGAATCTAGAGA,88,93,5,11,3175,0,0
3660,ACGTCGAATCTAGAGA,89,93,4,10,574,0,0
3670,ACGTCGAATCTAGAGA,89,93,4,9,1223,0,0
3689,ACGTCGAATCTAGAGA,89,93,4,10,1725,0,0
3691,ACCTCGAATCTAGAGA,89,93,4,10,1744,0,0
3706,ACGTCGAATCTAGAGA,89,93,4,9,2571,0,0
3709,ACGTCGAATCTAGAGA,89,93,4,10,2676,0,0
3712,ACGTCGAATCTAGAGA,89,93,4,13,2808,0,0
3718,ACGTCGAATCTAGAGA,89,93,4,14,2887,0,0
3726,ACGTCGAATCTAGAGA,89,93,4,15,3064,0,0
3727,ACGTCGAATCTAGAGA,89,93,4,11,3074,0,0
3744,ACGTCGAATCTAGAGA,90,93,3,14,661,0,0
3765,ACGTCGAATCTAGAGA,90,93,3,13,1288,0,0
3778,ACGTCGAATCTAGAGA,90,93,3,11,2039,0,0
3831,ACGTCGAATCTAGAGA,90,93,3,15,3399,0,0
3837,ACGTCGAATCTAGAGA,91,93,2,9,239,0,0
3855,ACGTCGAATCTAGAGA,91,93,2,12,1617,0,0
3866,ACGTCGAATCTAGAGA,91,93,2,13,1795,0,0
3872,ACGTCGAATCTAGAGA,91,93,2,10,1841,0,0
3880,ACGTCGAATCTAGAGA,91,93,2,14,2081,0,0
3885,ACGTCGAATCTAGAGA,91,93,2,15,2256,0,0
3902,ACGTCGAATCTAGAGA,91,93,2,11,2920,0,0
3904,ACGTCGAATCTAGAGA,91,93,2,13,2936,0,0
3906,ACGTCGAATCTAGAGA,91,93,2,17,2951,0,0
3923,ACGTCGAATCTAGAGA,92,93,1,12,1224,0,0
3929,ACGTCGAATCTAGAGT,92,93,1,11,1492,0,0
3946,ACGTCGAATCTAGAGA,92,93,1,9,1979,0,0
3948,ACGTCGAATCTAGAGA,92,93,1,12,1987,0,0
3959,ACGTCGAATCTAGAGA,92,93,1,16,2142,0,0
3962,ACGTCGAATCTAGAGA,92,93,1,12,2167,0,0
3964,ACGTCGAATCTAGAGA,92,93,1,12,2189,0,0
3979,ACGTCGGACCTAGAGA,92,93,1,12,2301,0,0
3982,ACGTCGAATCTAGAGA,92,93,1,12,2326,0,0
3990,ACGTCGAATCTAGAGA,92,93,1,10,2390,0,0
3999,ACGTCGAATCTAGAGA,92,93,1,12,2901,0,0
4002,ACGTCGATTCTAGAGA,92,93,1,14,3005,0,0
4003,ACGTCGAATCTAGAGA,92,93,1,14,3007,0,0
608,ACGTCGAATCTAGAGA,59,94,35,7,196,11,0
1082,ACGTCGAATCTAGAGA,65,94,29,7,548,7,0
1087,ACGTCGAATCTAGAGA,65,94,29,10,560,6,0
1104,ACGTCGAATCTAGAGA,65,94,29,10,589,6,0
1452,ACGTCGAATCTAGAGA,68,94,26,10,748,5,0
1689,ACGTCGAATCTAGAGA,69,94,25,14,1134,4,0
1920,ACGTCGAATCTAGAGA,71,94,23,10,777,5,0
1990,ACGTCGAATCTAGAGA,72,94,22,8,608,1,0
2039,ACGTCGAATCTAGAGA,72,94,22,10,1011,3,0
2326,ACGTCGAATCTAGAGA,75,94,19,11,806,3,0
2394,ACGTCGAATCTAGAGA,76,94,18,6,290,3,0
2553,ACGTCGAATCAAGAGA,77,94,17,13,1831,2,0
2581,ACGTCGAATCTAGAGA,78,94,16,11,610,1,0
2601,ACGTCGAATCTAGAGA,78,94,16,13,797,1,0
2616,ACGTCGAATCTAGAGA,78,94,16,14,1511,2,0
2621,ACGTCGAATCTAGAGA,78,94,16,15,1603,2,0
2709,ACGTCGAATCTAGAGA,79,94,15,8,848,1,0
2793,ACGTCGAATCTAGAGA,80,94,14,11,818,3,0
2881,ACGTCGAATCTAGAGA,81,94,13,10,960,2,0
2889,ACGTCGAATCTAGAGA,81,94,13,10,1011,0,0
2893,ACGTCGAATCTAGAGA,81,94,13,11,1062,1,0
2922,ACGTCGAATCTAGAGA,81,94,13,13,1770,1,0
2931,ACGTCGAATCTAGAGA,81,94,13,11,1868,1,0
2957,ACGTCGAAGCTAGAGA,81,94,13,12,2560,2,0
2961,ACGTCGAATCTAGAGA,82,94,12,9,239,1,0
2971,ACGTCGAATCTAGAGA,82,94,12,9,517,1,0
2983,ACGTCGAATCTAGAGA,82,94,12,11,812,1,0
2998,ACGTCGAATCTAGAGA,82,94,12,11,1416,1,0
3012,ACGTCGAATCTAGAGA,82,94,12,11,1913,0,0
3020,ACGTCGAATCTAGAGA,82,94,12,12,2167,1,0
3026,ACGTCGAATCTAGAGA,82,94,12,11,2212,0,0
3067,ACGTCGAATCTAGAGA,83,94,11,10,114,1,0
3084,ACGTCGAATCTAGAGA,83,94,11,11,861,1,0
3160,ACGTCGAATCTAGAGA,83,94,11,13,2750,1,0
3194,ACGTCGAATCTAGAGA,84,94,10,11,1067,0,0
3238,ACGTCGAATCTAGAGA,84,94,10,14,2520,0,0
3246,ACGTCGTATCTAGAGA,84,94,10,13,2610,0,0
3258,ACGTCGAATCTAGAGA,85,94,9,12,243,0,0
3312,ACGTCGAATCTAGAAA,85,94,9,11,2076,1,0
3322,ACGTCGAATCTAGAGG,85,94,9,12,2298,0,0
3334,ACGACGAATCTAGAGA,85,94,9,11,2487,0,0
3400,ACGTCGAATCTAGAGA,86,94,8,11,1494,0,0
3427,ACGTCGAATCTAGAGA,86,94,8,12,2464,0,0
3434,ACGTAGAATCTAGAGA,86,94,8,12,2703,0,0
3497,ACGTCGAATCTAGAGA,87,94,7,12,1553,0,0
3522,ACGTCGAAGCTAGAGA,87,94,7,12,2560,0,0
3541,ACGTCGAATCTAGAGA,87,94,7,13,2948,0,0
3575,ACGTCGAATCTAGAGA,88,94,6,11,1096,0,0
3600,ACGTCGAATCTAGAGA,88,94,6,12,2055,0,0
3615,ACGTCGAATCTGGAGA,88,94,6,14,2521,0,0
3630,ACGTCGAATCTAGAGA,88,94,6,12,2864,0,0
3663,ACGTCGAATCTAGAGA,89,94,5,12,723,0,0
3674,ACGTCGAATCTAGAGA,89,94,5,10,1377,0,0
3704,ACGTTGAATCTAGAGA,89,94,5,13,2502,0,0
3741,ACGTCGAATCTAGAGA,90,94,4,11,474,0,0
3742,ACGTCGAATCTAGAGA,90,94,4,8,608,0,0
3743,ACGTCGAATCTAGAGA,90,94,4,11,657,0,0
3745,ACGTCGAATCTAGAGA,90,94,4,7,746,0,0
3746,ACGTCGAATCTAGAGA,90,94,4,10,749,0,0
3747,ACGTCGAATCAAGAGA,90,94,4,10,764,0,0
3748,ACGTCGAATCTAGAGA,90,94,4,12,940,0,0
3749,ACGTCGAATCTAGAGA,90,94,4,10,963,0,0
3750,ACGTCGAATCTAGAGA,90,94,4,13,981,0,0
3751,ACGTCGAATCTAGAGA,90,94,4,10,982,0,0
3752,ACGTCGAATCTAGAGA,90,94,4,10,985,0,0
3753,ACGTCGAATCTAGAGA,90,94,4,13,986,0,0
3754,ACGTCGAATCTAGAGA,90,94,4,13,1006,0,0
3755,ACGTCGAATCTAGAGA,90,94,4,10,1011,0,0
3756,ACGTCAAATCTAGAGA,90,94,4,10,1031,0,0
3757,ACGTCGAATCTAGAGA,90,94,4,11,1062,0,0
3758,ACGTCGAATCTAGAGA,90,94,4,11,1068,0,0
3760,ACGTCGAATCTAGAGA,90,94,4,8,1082,0,0
3761,ACGTCGAATCTAGAGA,90,94,4,11,1087,0,0
3762,ACGTCGAATCTAGAGA,90,94,4,11,1104,0,0
3763,ACGTCGAATCTAGAGA,90,94,4,12,1272,0,0
3764,ACGTCGAATCTAGAGA,90,94,4,10,1287,0,0
3766,ACGTCGAATCTAGAGA,90,94,4,10,1290,0,0
3767,ACGTCGAATCTAGAGA,90,94,4,10,1299,0,0
3768,ACGTCGAATCTAGAGA,90,94,4,13,1332,0,0
3769,ACGTCGAATCTAGAGA,90,94,4,14,1403,0,0
3772,ACGTCGAATCTAGAGA,90,94,4,9,1569,0,0
3773,ACGTCGAATCTAGAGA,90,94,4,12,1570,0,0
3774,ACGTCGAATCTAGAGA,90,94,4,9,1582,0,0
3775,ACGTCGAATCTAGGGA,90,94,4,10,1759,0,0
3776,ACGTCGAATCTAGAGA,90,94,4,9,1972,0,0
3777,ACGTCGAATCTAGAGA,90,94,4,15,2003,0,0
3780,ACGTCGAATCTAGAGA,90,94,4,13,2148,0,0
3782,ACGTCGAATCTAGAGA,90,94,4,12,2354,0,0
3783,ACGTCGAATCTAGAGA,90,94,4,11,2375,0,0
3784,ACGTCGAATCTAGAGA,90,94,4,13,2445,0,0
3785,ACGTCGAATCTAGAGA,90,94,4,12,2464,0,0
3787,ACGTCGAATCTAGAGA,90,94,4,11,2499,0,0
3788,ACGTCGAATCTAGAGA,90,94,4,12,2537,0,0
3789,ACGTCGAATCTAGAGA,90,94,4,13,2544,0,0
3790,ACGTCAAATCTAGAGA,90,94,4,11,2566,0,0
3791,ACGTCGAATCTAGAGA,90,94,4,11,2592,0,0
3792,ACGTCGAATCTAGAGA,90,94,4,15,2654,0,0
3793,ACGTCGAATCTAGAGG,90,94,4,13,2665,0,0
3794,ACGTCGAATCTAGAGA,90,94,4,13,2681,0,0
3795,ACGTCGGATCTAGAGA,90,94,4,12,2702,0,0
3796,ACGTCGAATCTAGAGA,90,94,4,13,2736,0,0
3797,ACGTCGAATCTAGAGA,90,94,4,15,2748,0,0
3798,ACGTCGAATCTGGAGA,90,94,4,15,2805,0,0
3799,ACATCGAATCTAGAGA,90,94,4,17,2822,0,0
3801,ACGTCGAATCTTGAGA,90,94,4,15,2839,0,0
3803,ACGTCGAATCTAGAGA,90,94,4,11,2881,0,0
3804,ACGTCGAATCTAGAGA,90,94,4,10,2918,0,0
3805,ACGTCGAATCTAGAGA,90,94,4,13,2934,0,0
3808,ACGTCGAATCTAGAGA,90,94,4,10,2960,0,0
3809,ACGTCGAATCTAGAGA,90,94,4,10,2970,0,0
3811,ACGTCGAATCTAGAGA,90,94,4,12,2991,0,0
3812,ACGTCGAATCTAGAGA,90,94,4,14,2997,0,0
3813,ACGTCGAATCAAGAGA,90,94,4,12,3058,0,0
3814,ACGTCGAATCTAGAGA,90,94,4,12,3083,0,0
3815,ACGTCGAATCTAGAGA,90,94,4,12,3084,0,0
3816,ACGTCGAATCTAGAGA,90,94,4,12,3133,0,0
3817,ACGTCGAATCTAGAGA,90,94,4,11,3186,0,0
3818,ACGTCGAATCTAGAGA,90,94,4,11,3205,0,0
3819,ACGTCGAATCTAGAGC,90,94,4,15,3210,0,0
3820,ACGTCGAATCTAGAGA,90,94,4,12,3221,0,0
3821,ACGTCGAATCTAGAGA,90,94,4,13,3222,0,0
3822,ACGTCGAATCTAGAGA,90,94,4,13,3266,0,0
3823,ACGTCGAATCTAGAGA,90,94,4,12,3310,0,0
3824,ACGTCGAATCTAGAGA,90,94,4,17,3316,0,0
3825,ACGTCGAATCTAGAGA,90,94,4,14,3317,0,0
3826,ACGTCGAATCTAGAGA,90,94,4,14,3320,0,0
3827,ACCTCGAATCTAGAGA,90,94,4,12,3340,0,0
3828,ACGTCAAATATAGAGA,90,94,4,12,3343,0,0
3829,ACGTCGAATCTAGAGA,90,94,4,8,3366,0,0
3833,ACGTCGAATCTAGAGA,90,94,4,12,3443,0,0
3834,ACGTCGAATCTAGAGA,90,94,4,16,3450,0,0
3848,ACGTCGAATCTAGAGA,91,94,3,13,1297,0,0
3853,ACGTCGAATCTAGAGA,91,94,3,9,1590,0,0
3864,ACGTCGAATCTAGAGA,91,94,3,13,1779,0,0
3871,ACGTCGAATCTAGAGA,91,94,3,13,1834,0,0
3894,ACGTCGAATCTAGAGA,91,94,3,12,2703,0,0
3900,ACGTCGAATCTAGAGA,91,94,3,15,2841,0,0
3911,ACGTCGAATCTAGAGA,92,94,2,10,444,0,0
3931,ACGTCGAATCTAGAGA,92,94,2,14,1533,0,0
3951,ACGTCGAATCTAGAGA,92,94,2,12,2006,0,0
3971,ACGTCGAATCTAGAGA,92,94,2,11,2233,0,0
3978,ACGTCGAATCTAGAGG,92,94,2,12,2298,0,0
3983,ACCTCGAATCTAGAGA,92,94,2,11,2336,0,0
3991,ACGTCGAATCTAGAGA,92,94,2,14,2601,0,0
4008,ACGTCGAATCTAGAGA,93,94,1,7,746,0,0
4010,ACGTCGAATCTAGAGA,93,94,1,10,963,0,0
4015,ACGTCGAATCTAGAGA,93,94,1,10,1011,0,0
4018,ACGTCGAATCTAGAGA,93,94,1,11,1068,0,0
4028,ACGTCGAATCTAGAGA,93,94,1,9,1569,0,0
4030,ACGTCGAATCTAGGGA,93,94,1,10,1759,0,0
4051,ACGTCGAATCTAGAGA,93,94,1,13,2506,0,0
4075,ACGTCGAATCTAGAGA,93,94,1,7,2672,0,0
4083,ACGTCGAATCTAGAGA,93,94,1,9,2709,0,0
4086,ACGTCGAATCTAGAGA,93,94,1,13,2736,0,0
4090,ACGTCGAATCTAGAGA,93,94,1,11,2775,0,0
1569,ACGTCGAATCTAGAGA,69,95,26,8,608,5,0
2256,ACGTCGAATCTAGAGA,74,95,21,14,1154,4,0
2336,ACCTCGAATCTAGAGA,75,95,20,10,1022,2,0
2354,ACGTCGAATCTAGAGA,75,95,20,11,1395,4,0
2435,ACGTCGAATCTAGAGA,76,95,19,13,1332,2,0
2503,ACGTCGAATCTTGAGA,77,95,18,12,718,1,0
2560,ACGTCGAAGCTAGAGA,77,95,18,11,2065,4,0
2640,ACGTCGAATCTAGAGA,78,95,17,13,1858,2,0
2665,ACGTCGAATCTAGAGG,78,95,17,12,2247,3,0
2773,ACGTCGAATCTAGAGA,80,95,15,7,418,1,0
2851,ACGTCGAATCTAGAGA,80,95,15,12,2438,1,0
2863,ACGTCGAACCTAGAGA,81,95,14,11,633,3,0
2866,ACGTCGAATCTAGAGA,81,95,14,11,657,1,0
2906,ACGTCGAATCTAGAGA,81,95,14,13,1338,2,0
2911,ACGTCGAATCTAGAGA,81,95,14,8,1485,1,0
2923,ACGTCGAATCTAGAGA,81,95,14,13,1789,1,0
2925,ACGTCAAATCTAGAGA,81,95,14,10,1801,2,0
2951,ACGTCGAATCTAGAGA,81,95,14,16,2429,3,0
2958,ACGTCGAATCTAGAGA,82,95,13,9,133,1,0
3017,ACGTCGAATCTAGAAA,82,95,13,11,2076,2,0
3049,ACGTCGAATCTAGAGA,82,95,13,11,2497,2,0
3063,ACGTCGAATCTAGAGA,82,95,13,13,2629,1,0
3083,ACGTCGAATCTAGAGA,83,95,12,11,856,2,0
3097,ACGTCGAATCTAGAGA,83,95,12,9,1223,0,0
3109,ACGTCGAATCTAGAGA,83,95,12,9,1633,1,0
3133,ACGTCGAATCTAGAGA,83,95,12,11,2316,1,0
3168,ACGTCGAATCTAGAGA,84,95,11,11,610,0,0
3170,ACGTCGAATCTAGAGA,84,95,11,11,645,0,0
3186,ACGTCGAATCTAGAGA,84,95,11,10,985,1,0
3205,ACGTCGAATCTAGAGA,84,95,11,10,1299,1,0
3221,ACGTCGAATCTAGAGA,84,95,11,11,1881,1,0
3222,ACGTCGAATCTAGAGA,84,95,11,12,2004,1,0
3235,ACGTCGAATCTAGAGA,84,95,11,13,2471,1,0
3266,ACGTCGAATCTAGAGA,85,95,10,12,523,1,0
3272,ACGTCGAATCTAGAGA,85,95,10,11,811,1,0
3281,ACGTCGAATCTAGAGA,85,95,10,12,1196,0,0
3303,ACGTCGAATCTAGAGA,85,95,10,8,1908,0,0
3310,ACGTCGAATCTAGAGA,85,95,10,11,2038,1,0
3316,ACGTCGAATCTAGAGA,85,95,10,16,2142,1,0
3324,ACGTCGAATCTAGAGA,85,95,10,10,2342,0,0
3340,ACCTCGAATCTAGAGA,85,95,10,11,2551,1,0
3344,ACGTCGAATCTAGAGA,85,95,10,14,2635,0,0
3355,ACGTCGAATCTAGAGA,85,95,10,11,2847,0,0
3379,ACGTCGAATCTAGAGA,86,95,9,11,856,1,0
3399,ACGTCGAATCTAGAGA,86,95,9,14,1493,1,0
3408,ACGTCGAATCTAGAGA,86,95,9,15,1689,0,0
3430,ACGTCGAATCTAGAGA,86,95,9,12,2615,1,0
3433,ACGTCGAATCTAGAGA,86,95,9,10,2693,0,0
3450,ACGTCGAATCTAGAGA,86,95,9,15,2993,1,0
3455,ACGTCGAATCTAGAGA,86,95,9,16,3029,0,0
3468,ACGTCGAATCAAGAGA,87,95,8,10,764,0,0
3481,ACGTCGAATCTAGAGA,87,95,8,11,1058,0,0
3488,ACGTCGAATCTAGAGA,87,95,8,12,1272,0,0
3549,ACGTCGAAGCTAGAGA,87,95,8,11,3088,0,0
3561,ACGTCGAATCTAGAGA,88,95,7,9,239,0,0
3569,ACGTCGAATCTAGAGA,88,95,7,12,696,0,0
3571,ACGTCGAATCTAGAGA,88,95,7,11,806,0,0
3599,ACGTCGAATCCAGAGA,88,95,7,8,1908,0,0
3633,ACGTCAAATCTAGAGA,88,95,7,11,2925,0,0
3640,ACGTCGAATCTAGAGA,88,95,7,10,3132,0,0
3653,ACGTCGAATCTAGAGA,89,95,6,10,114,0,0
3654,ACGTCGAATCTAGAGA,89,95,6,7,245,0,0
3655,ACGTCGAATCTAGAGA,89,95,6,10,436,0,0
3657,ACGTCGAATCTAGAGA,89,95,6,10,451,0,0
3658,ACGTCGAATCTAGAGA,89,95,6,10,564,0,0
3659,ACGTCGAATCTAGAGA,89,95,6,10,572,0,0
3661,ACGTCGAATCTGGAGA,89,95,6,13,584,0,0
3662,ACGTCGAATCTAGAGA,89,95,6,10,591,0,0
3664,ACGTCGAATCTAGAGA,89,95,6,10,736,0,0
3665,ACGTCGAATCTAGAGA,89,95,6,11,856,0,0
3666,ACGTCGAATCTAGAGA,89,95,6,14,1160,0,0
3668,ACGTCGAATCTAGAGA,89,95,6,15,1212,0,0
3669,ACGTCGAATCTAGAGA,89,95,6,12,1221,0,0
3671,ACGTCGAATCTAGAGA,89,95,6,12,1224,0,0
3672,ACGTCGAATCTAGAGA,89,95,6,12,1235,0,0
3673,ACGTCGAATCTAGAGA,89,95,6,10,1295,0,0
3678,ACGTCGAATCTAGAGA,89,95,6,11,1491,0,0
3679,ACGTCGAATCTAGAGT,89,95,6,11,1492,0,0
3680,ACGTCGAATCTAGAGA,89,95,6,14,1493,0,0
3681,ACGTCGAATCTAGAGA,89,95,6,14,1533,0,0
3682,ACGTCGAATCTAGAGA,89,95,6,14,1538,0,0
3684,ACGTCGAATCTAGAGA,89,95,6,9,1682,0,0
3688,ACGTCGAATCTAGAGA,89,95,6,15,1703,0,0
3690,ACGTCGAATCTAGAGA,89,95,6,13,1736,0,0
3692,ACGTCGAATCTAGAGA,89,95,6,13,1748,0,0
3693,GCGTCGAATCTAGAGA,89,95,6,14,1942,0,0
3694,ACGTCGAATCTAGAGA,89,95,6,14,1952,0,0
3695,ACGTCGAATCTAGAGA,89,95,6,12,1987,0,0
3697,ACGTCGAATCTAGAGA,89,95,6,16,2142,0,0
3698,ACGTCGAATCTAGAGA,89,95,6,12,2167,0,0
3699,ACGTCGAATCTAGAGA,89,95,6,11,2203,0,0
3700,ACGTCGAATCTAGAGA,89,95,6,14,2321,0,0
3701,ACGTCGAATCTAGAGA,89,95,6,14,2373,0,0
3703,ACGTCGAATCTAGAGA,89,95,6,12,2462,0,0
3708,ACGTCGAATCTAGAGA,89,95,6,11,2637,0,0
3710,ACGTCGAATCTAGAGA,89,95,6,16,2732,0,0
3711,ACGTCGAATCTAGAGA,89,95,6,12,2793,0,0
3713,ACGTCGAATCTAGAGA,89,95,6,11,2827,0,0
3715,ACGTTGAATCTAGAGA,89,95,6,12,2856,0,0
3717,ACGTCGAATCTAGAGA,89,95,6,14,2886,0,0
3719,ACGTCGAATCTAGAGA,89,95,6,12,2901,0,0
3720,ACGTCGAATCTAGAGA,89,95,6,14,2906,0,0
3721,ACGTCGAATCTAGAGA,89,95,6,14,2940,0,0
3722,ACGTCGAATCAAGAGA,89,95,6,15,2956,0,0
3725,ACGTCGAATCTAGAGA,89,95,6,12,3025,0,0
3728,ACGTCGAATCTAGAGA,89,95,6,11,3075,0,0
3729,ACGTCGAATCTGGAGA,89,95,6,13,3095,0,0
3731,ACGTCGAATCTAGAGA,89,95,6,14,3139,0,0
3733,ACGTCGAATCTAGAGA,89,95,6,12,3272,0,0
3734,ACGTCGAATCTAGAGA,89,95,6,12,3276,0,0
3735,ACGTCGAATCTAGAGA,89,95,6,12,3278,0,0
3736,ACGTCGAATCTAGAGA,89,95,6,12,3291,0,0
3737,ACGTCGAATCTAGAAA,89,95,6,12,3312,0,0
3738,ACGTCGAATCTAGAGA,89,95,6,8,3328,0,0
3739,ACGTCGAATCTAGAGA,89,95,6,13,3353,0,0
3740,ACGTCGAATCTAGAGA,89,95,6,13,3363,0,0
3841,ACGTCGAATCTAGAGA,91,95,4,12,523,0,0
3845,ACGTCGAATCTAGAGA,91,95,4,11,812,0,0
3847,ACGTCGAATCTAGAGA,91,95,4,11,1149,0,0
3878,ACGTCGAATCTAGAGA,91,95,4,9,1976,0,0
3890,ACGTCGAATCTAGAGA,91,95,4,9,2580,0,0
3919,ACGTCGAATCTAGAGA,92,95,3,12,1173,0,0
3941,ACGTCGAATCTAGAGA,92,95,3,11,1921,0,0
3956,ACGTCGAATTTAGAGA,92,95,3,9,2091,0,0
3958,ACGTCGAATCTAGAGA,92,95,3,10,2125,0,0
3974,ACGTCGAATCTAGAGA,92,95,3,12,2264,0,0
4000,ACGTCGAATCAAGAGA,92,95,3,15,2956,0,0
4005,ACGTCGAATCTAGAGA,93,95,2,11,474,0,0
4006,ACGTCGAATCTAGAGA,93,95,2,8,608,0,0
4017,ACGTCGAATCTAGAGA,93,95,2,11,1062,0,0
4023,ACGTCGAATCTAGAGA,93,95,2,12,1272,0,0
4037,ACGTCGAATCTAGAGA,93,95,2,13,2421,0,0
4044,ACGTCGAATCTAGAGA,93,95,2,13,2471,0,0
4048,ACGTCGAATCTAGAGA,93,95,2,11,2492,0,0
4050,ACGTCGAATCTTGAGA,93,95,2,13,2503,0,0
4053,ACGTCGAATCTAGAGA,93,95,2,13,2513,0,0
4055,ACGTCGAATCTAGAGA,93,95,2,13,2546,0,0
4061,ACGTCGAATCTAGAGA,93,95,2,12,2576,0,0
4065,ACGTCGAATCTAGAGA,93,95,2,16,2621,0,0
4074,ACGTCGAATCTAGAGA,93,95,2,16,2667,0,0
4095,ACGTCGAATCTAGAGA,93,95,2,12,2798,0,0
4097,ACGTCGAATCTAGAGA,93,95,2,13,2808,0,0
4109,ACGTCGAATCTAGAGA,94,95,1,12,523,0,0
4115,ACGTCGAATCTAGAGA,94,95,1,12,1622,0,0
4131,ACGTCGAATCTAGAGA,94,95,1,11,1870,0,0
4137,ACGTCGAATCTAGAGA,94,95,1,11,2314,0,0
4160,ACGTTGAATCTAGAGA,94,95,1,12,2856,0,0
4177,ACGTCGAATCTAGAGA,94,95,1,14,2923,0,0
4197,ACGTCGAATCTAGAGA,94,95,1,14,3042,0,0
574,ACGTCGAATCTAGAGA,58,96,38,9,299,12,0
1149,ACGTCGAATCTAGAGA,65,96,31,10,788,8,0
1160,ACGTCGAATCTAGAGA,65,96,31,13,801,6,0
1485,ACGTCGAATCTAGAGA,68,96,28,7,970,5,0
1633,ACGTCGAATCTAGAGA,69,96,27,8,1047,5,0
1774,ACGTCGAATCTAGAGA,70,96,26,12,923,3,0
1779,ACGTCGAATCTAGAGA,70,96,26,12,929,3,0
1834,ACGTCGAATCTAGAGA,70,96,26,12,1231,5,0
1870,ACGTCGAATCTAGAGA,71,96,25,10,263,3,0
1952,ACGTCGAATCTAGAGA,71,96,25,13,1003,4,0
1994,ACGTCGAACCTAGAGA,72,96,24,11,633,2,0
2009,ACGTCGAATCTAGAGA,72,96,24,8,810,3,0
2092,ACGTCGAATCTAGAGA,73,96,23,6,22,2,0
2124,ACGTCGAATCTAGAGA,73,96,23,15,700,3,0
2153,ACGTCGAATCTAGAGA,73,96,23,12,933,3,0
2218,ACGTCGAATCTAGAGA,74,96,22,10,564,2,0
2471,ACGTCGAATCTAGAGA,76,96,20,12,1978,3,0
2489,ACGTCGAATCTAGAGA,77,96,19,10,451,4,0
2506,ACGTCGAATCTAGAGA,77,96,19,12,724,1,0
2666,ACGTCGAATCTAGAGA,78,96,18,12,2254,1,0
2672,ACGTCGAATCTAGAGA,79,96,17,6,95,2,0
2710,ACGTCGAATCTAGAGA,79,96,17,11,851,1,0
2850,ACGTCGAATCTAGAGA,80,96,16,12,2425,1,0
2864,ACGTCGAATCTAGAGA,81,96,15,11,640,2,0
2865,ACGTCGAATCTAGAGA,81,96,15,11,645,1,0
2904,ACGTCGAATCTAGAGA,81,96,15,15,1218,1,0
2907,ACGTCGAATCTAGAGA,81,96,15,10,1342,1,0
3054,ACGTCGAATCTAGAGA,82,96,14,12,2556,1,0
3070,ACGTCGAATCTAGAGA,83,96,13,10,436,0,0
3074,ACGTCGAATCTAGAGA,83,96,13,10,564,1,0
3095,ACGTCGAATCTGGAGA,83,96,13,12,1220,1,0
3100,ACGTCGAATCTAGAGA,83,96,13,12,1235,0,0
3117,ACGTCGAATCTAGAGA,83,96,13,15,2003,1,0
3122,ACCTCGAATCTAGAGA,83,96,13,11,2077,0,0
3139,ACGTCGAATCTAGAGA,83,96,13,13,2409,1,0
3144,ACGTCGAATCTAGAGA,83,96,13,11,2491,0,0
3188,ACGTCGAATCTAGAGA,84,96,12,13,988,1,0
3257,ACGTCGAATCTAGAGA,85,96,11,9,239,0,0
3291,ACGTCGAATCTAGAGA,85,96,11,11,1439,1,0
3330,ACGTCGAATCTAGAGA,85,96,11,10,2410,0,0
3353,ACGTCGAATCTAGAGA,85,96,11,12,2793,1,0
3358,ACGTCGAATCTAGAGA,85,96,11,12,2895,0,0
3363,ACGTCGAATCTAGAGA,85,96,11,12,2947,1,0
3435,ACGTCGAATCTAGAGA,86,96,10,11,2713,0,0
3445,ACGTCGAATCTAGAGA,86,96,10,14,2886,0,0
3471,ACGTCGAATCTAGAGA,87,96,9,12,940,0,0
3485,ACGTCGAATCTAGAGA,87,96,9,8,1082,0,0
3491,ACGTCGAATCTAGAGA,87,96,9,10,1290,0,0
3494,ACGTCGAATCTTGAGA,87,96,9,13,1333,0,0
3559,ACGTCGAATCTAGAGA,88,96,8,9,185,0,0
3563,ACGTCGAATCTAGAGA,88,96,8,6,290,0,0
3564,ACGTCGAATCTAGAGA,88,96,8,9,394,0,0
3565,ACGTCGAATCTAGAGA,88,96,8,9,511,0,0
3566,ACGTCGAATCTAGAGA,88,96,8,12,523,0,0
3567,ACGTCGAATCTAGAGA,88,96,8,12,546,0,0
3570,ACGTCGAATCTAGAGA,88,96,8,15,700,0,0
3572,ACGTCGAATCTAGCGA,88,96,8,11,811,0,0
3573,ACGTCGAATCTAGAGA,88,96,8,11,812,0,0
3574,ACGTCGAATCTAGAGA,88,96,8,11,852,0,0
3577,ACGTCGAATCTAGAGA,88,96,8,12,1196,0,0
3578,ACGTCGAATCTAGAGA,88,96,8,13,1297,0,0
3579,ACGCCGAATCTAGAGA,88,96,8,14,1411,0,0
3582,ACGTCGAATCTAGAGA,88,96,8,11,1457,0,0
3584,ACGTCGAATCTAGAGA,88,96,8,12,1587,0,0
3590,ACGTCGAATCTAGAGA,88,96,8,9,1633,0,0
3592,ACGTCGAATCTAGAGA,88,96,8,12,1667,0,0
3595,ACGTCGAATCTAGAGA,88,96,8,12,1677,0,0
3596,ACGTCGAATCTAGAGA,88,96,8,10,1728,0,0
3603,ACGTCAAATCTAGAGG,88,96,8,12,2298,0,0
3604,ACGTCGAACCTAGAGA,88,96,8,12,2301,0,0
3606,ACGTCGAATCTAGAGA,88,96,8,14,2349,0,0
3610,ACGTCGAATCTAGAGA,88,96,8,17,2456,0,0
3618,ACGTCGAATCTAGAGA,88,96,8,10,2651,0,0
3619,ACGTCGAATCTAGAGA,88,96,8,13,2659,0,0
3620,ACGTCGAATCTAGAGA,88,96,8,15,2671,0,0
3623,ACGTCGAATCTAGAGA,88,96,8,11,2760,0,0
3626,ACCTCGAATCTAGAGA,88,96,8,11,2803,0,0
3628,ACGTCGAATCTAGAGA,88,96,8,11,2818,0,0
3629,ACGTCGAATCTAGAGA,88,96,8,11,2821,0,0
3631,ACGTCGAATCTAGAGA,88,96,8,13,2915,0,0
3634,ACGTCGAATCTAGAGA,88,96,8,14,2953,0,0
3635,ACGTCGAATCTAGAGA,88,96,8,14,3063,0,0
3637,ACGTCGAATCTAGAGA,88,96,8,13,3093,0,0
3638,ACGTCGAATCTAGAGA,88,96,8,12,3121,0,0
3641,ACGTCGAATCTAGATA,88,96,8,14,3138,0,0
3642,ACGTCGAATCTAGAGA,88,96,8,14,3157,0,0
3645,ACGTCGAATCTAGAGA,88,96,8,13,3181,0,0
3646,ACGTCGAATCTAGAGA,88,96,8,13,3182,0,0
3647,ACGTCGAATCTTGAGA,88,96,8,11,3185,0,0
3839,ACGTCGAATCTAGAGA,91,96,5,9,394,0,0
3843,ACCTCGAATCTAGAGA,91,96,5,9,688,0,0
3846,ACGTCGAATCTAGAGA,91,96,5,11,852,0,0
3852,ACGTCGAATCTAGAGA,91,96,5,14,1473,0,0
3861,ACGTCGAATCTAGAGA,91,96,5,10,1773,0,0
3865,ACGTCGAATCTAGAGA,91,96,5,13,1781,0,0
3882,ACGTCGAATCTAGAGA,91,96,5,16,2124,0,0
3884,ACGTCGAATCTAGAGA,91,96,5,13,2237,0,0
3888,ACGTCGAATCTAGAGA,91,96,5,10,2410,0,0
3933,ACGTCGAATCTAGAGA,92,96,4,9,1682,0,0
3950,ACGTCGAACCTAGAGA,92,96,4,12,1994,0,0
3970,ACGTCGAATCTAGAGA,92,96,4,11,2218,0,0
3973,ACGTCGAATCTAGAGA,92,96,4,16,2257,0,0
3975,ACGTCGAATCTAGAGA,92,96,4,15,2265,0,0
3976,ACGTCGAATCTAGAGA,92,96,4,16,2279,0,0
3977,ACGTTGAATCTAGAGA,92,96,4,12,2296,0,0
3980,ACGTCGAATCTAGAGA,92,96,4,9,2302,0,0
3981,ACGTCGAATCTAGAGA,92,96,4,14,2321,0,0
3984,ACGTCGAATCTAGAAA,92,96,4,12,2361,0,0
3985,ACGTCGAATCTAGAGA,92,96,4,13,2367,0,0
3986,ACGTCGAATCTAGAGA,92,96,4,13,2371,0,0
3987,ACGTCGAATCTAGAGA,92,96,4,14,2373,0,0
3988,ACGTCGAATCTAGAGA,92,96,4,15,2385,0,0
3989,ACGTCGAATCTAGAGA,92,96,4,10,2388,0,0
3992,ACGTCGAATCTAGAGA,92,96,4,15,2616,0,0
3993,ACGTCGAATCTAGAGA,92,96,4,14,2640,0,0
3994,ACGTCGAATCTAGAGA,92,96,4,10,2682,0,0
3995,ACGTCGAATCTAGAGA,92,96,4,11,2722,0,0
3996,ACCTCGAATCTAGAGA,92,96,4,11,2723,0,0
3997,ACGTCGAATCTAGAGA,92,96,4,16,2767,0,0
3998,ACGTCGAATCTAGAGA,92,96,4,11,2847,0,0
4001,ACCTCGAATCTAGAGA,92,96,4,10,2977,0,0
4004,ACGTCGAATCTAGAGA,92,96,4,17,3008,0,0
4024,ACGTCGAATCTAGAGA,93,96,3,10,1287,0,0
4027,ACGTCGAATCTAGAGA,93,96,3,12,1553,0,0
4036,ACGTCGAATCTAGAGA,93,96,3,7,2394,0,0
4066,ACGTCGAATCTAGAGA,93,96,3,13,2622,0,0
4076,ACGTCGAATCTAGAGA,93,96,3,13,2681,0,0
4079,ACGTCGAATCTAGAGA,93,96,3,10,2693,0,0
4091,TCGTCGAATCTAGAGA,93,96,3,11,2781,0,0
4100,ACGTCGAATCTAGAGA,93,96,3,14,2848,0,0
4107,ACGTCGAATCTAGAGA,94,96,2,9,239,0,0
4127,ACGTCGAATCTAGAGA,94,96,2,10,1841,0,0
4147,ACGTCGAATCTAGAGA,94,96,2,15,2813,0,0
4187,ACGTCGAATCTAGAGA,94,96,2,16,2979,0,0
4218,ACGTCGAATCTAGAGA,95,96,1,12,1224,0,0
4236,ACGTCGAATCTAGAGA,95,96,1,12,1987,0,0
4238,ACGTCGAACCTAGAGA,95,96,1,12,1994,0,0
4248,ACGTCGAATCTAGAGA,95,96,1,13,2153,0,0
4258,ACGTCGAATCTAGAGA,95,96,1,11,2233,0,0
4266,ACGTCGAACCTAGAGA,95,96,1,12,2301,0,0
963,ACGTCGAATCTAGAGA,64,97,33,9,182,9,0
1173,ACGTCGAATCTAGAGA,66,97,31,11,370,7,0
1287,ACGTCGAATCTAGAGA,67,97,30,9,304,7,0
1570,ACGTCGAATCTAGAGA,69,97,28,11,610,5,0
1979,ACGTCGAATCTAGAGA,72,97,25,8,462,3,0
2046,ACGTCGAATCTAGAGA,72,97,25,13,1023,4,0
2091,ACGTCGAATTTAGAGA,72,97,25,8,1479,3,0
2125,ACGTCGAATCTAGAGA,73,97,24,9,704,3,0
2196,ACGTCGAATCTAGAGA,73,97,24,15,1586,3,0
2302,ACGTCGAATCTAGAGA,75,97,22,8,608,2,0
2330,ACGTCGAATCTAGAGA,75,97,22,11,830,2,0
2371,ACGTCGAATCTAGAGA,75,97,22,12,1672,4,0
2385,ACGTCGAATCTAGAGA,75,97,22,14,1947,4,0
2447,ACGTCGAATCTAGAGA,76,97,21,15,1624,2,0
2467,ACGTCGAATCTAGAGA,76,97,21,11,1941,2,0
2492,ACGTCGAATCTAGAGA,77,97,20,10,564,3,0
2499,ACGTCGAATCTAGAGA,77,97,20,10,588,4,0
2628,ACGTCGAATCTAGAGA,78,97,19,9,1676,3,0
2692,ACGTCGAATCTAGAGA,79,97,18,12,546,3,0
2703,ACGTCGAATCTAGAGA,79,97,18,11,806,3,0
2772,ACGTCGAATCTAGAGA,80,97,17,13,349,3,0
2781,TCGTCGAATCTAGAGA,80,97,17,10,574,3,0
2808,ACGTCGAATCTAGAGA,80,97,17,12,1235,3,0
2822,ACATCGAATCTAGAGA,80,97,17,16,1844,2,0
2827,ACGTCGAATCTAGAGA,80,97,17,10,2097,2,0
2853,ACGTCGAATCTAGAGA,81,97,16,8,35,1,0
2886,ACGTCGAATCTAGAGA,81,97,16,13,986,3,0
2934,ACGTCGAATCTAGAGA,81,97,16,12,1985,2,0
2948,ACGTCGAATCTAGAGA,81,97,16,12,2326,3,0
3007,ACGTCGAATCTAGAGA,82,97,15,13,1795,3,0
3190,ACGTCGAATCTAGAGA,84,97,13,10,1011,0,0
3227,ACGTCGAATCTAGAGA,84,97,13,12,2264,1,0
3237,ACGTCGAATCTAGAGA,84,97,13,15,2512,0,0
3262,ACGTCGAATCTAGAGA,85,97,12,9,504,0,0
3278,ACGTCGAATCTAGAGA,85,97,12,11,1149,1,0
3280,ACGTCGAATCTAGAGA,85,97,12,14,1154,0,0
3321,ACGTCGAATCTAGAGA,85,97,12,9,2293,0,0
3354,ACGTCGAATCTAGAGA,85,97,12,12,2794,0,0
3357,ACGTCGAATCTAGAGA,85,97,12,12,2893,0,0
3409,ACGTCGAATCTAGAGA,86,97,11,13,1736,0,0
3412,ACGTCGAATCTAGAGA,86,97,11,8,1902,0,0
3436,ACGTCGAATCTAGAGA,86,97,11,13,2736,0,0
3460,ACGTCGAATCTAGAGA,87,97,10,8,35,0,0
3461,ACGTCGAATCTAGAGA,87,97,10,11,474,0,0
3465,ACGTCGAATCTAGAGA,87,97,10,7,746,0,0
3466,ACGTCGAATCTAGAGA,87,97,10,10,748,0,0
3467,ACGTCGAATCTAGAGA,87,97,10,10,749,0,0
3477,ACGTCGAATCTAGAGA,87,97,10,13,988,0,0
3483,ACGTCGAATCTAGAGA,87,97,10,11,1068,0,0
3484,ACGTCGAATCTAGAGA,87,97,10,11,1076,0,0
3492,ACGTCGAATCTAGAGA,87,97,10,10,1299,0,0
3498,ACGTCGAATCTAGAGA,87,97,10,12,1558,0,0
3500,ACGTCGAATCTAGAGA,87,97,10,9,1569,0,0
3501,ACGTCGAATCTAGAGA,87,97,10,12,1570,0,0
3502,ACGTCGAATCTAGAGA,87,97,10,9,1582,0,0
3503,ACGTCGAATCTAGAGA,87,97,10,13,1840,0,0
3505,ACGTCGAATCTAGAGA,87,97,10,11,1879,0,0
3506,ACGTCGAATCTAGAGA,87,97,10,14,2046,0,0
3508,ACCTCGAATCTAGAGA,87,97,10,11,2077,0,0
3510,ACGTCGAATCTAGAGA,87,97,10,16,2196,0,0
3520,ACGTCGAATCTAGAGA,87,97,10,13,2471,0,0
3523,ACGTCGAATCTAGAGA,87,97,10,11,2592,0,0
3524,ACGTCGAATCAAGAGA,87,97,10,11,2596,0,0
3525,ACGTCGAATCTAGAGA,87,97,10,16,2621,0,0
3530,ACGTCGAATCTAGAGA,87,97,10,15,2748,0,0
3531,ACGTCGAATCTAGAGA,87,97,10,13,2750,0,0
3532,ACGTCGAATCTAGAGA,87,97,10,12,2795,0,0
3533,ACGTCGAATCTAGAGA,87,97,10,12,2798,0,0
3534,ACGTCGAATCTGGAGA,87,97,10,15,2805,0,0
3535,ACGTCGAATCTAGAGA,87,97,10,8,2817,0,0
3536,ACGTCGAACCTAGAGA,87,97,10,12,2863,0,0
3538,ACGTCGAATCTAGAGA,87,97,10,11,2881,0,0
3540,ACGTCGAATCTAGAGA,87,97,10,13,2936,0,0
3551,ACGTCGAATCTAGAGA,87,97,10,12,3106,0,0
3553,ACGTCGAATCTAGAGA,87,97,10,13,3135,0,0
3838,ACGTCGAATCTAGAGA,91,97,6,12,243,0,0
3898,ACGTCGAATCTAGAGA,91,97,6,11,2783,0,0
3907,ACGTCGAATCTAGAGA,91,97,6,10,2961,0,0
3921,ACGTCGAATCTAGAGA,92,97,5,12,1221,0,0
3954,ACGTCGAATCTAGAGA,92,97,5,14,2046,0,0
4012,ACGTCGAATCTAGAGA,93,97,4,10,985,0,0
4026,ACGTCGAATCTAGAGA,93,97,4,13,1332,0,0
4052,ACGTCGAATCTAGAGA,93,97,4,11,2509,0,0
4054,ACGTCGAATCTGGAGA,93,97,4,14,2521,0,0
4056,ACCTCGAATCTAGAGA,93,97,4,11,2551,0,0
4057,ACGTCGAATCAAGAGA,93,97,4,14,2553,0,0
4058,ACGTCGAAGCTAGAGA,93,97,4,12,2560,0,0
4059,ACGTCGAATCTAGAGA,93,97,4,11,2563,0,0
4060,ACGTCGAATCTAGAGA,93,97,4,14,2567,0,0
4062,ACGTCGAATCTAGAGA,93,97,4,12,2581,0,0
4063,ACGTCGAACCTAGAGA,93,97,4,12,2583,0,0
4064,ACGTCGAATCTAGAGA,93,97,4,11,2592,0,0
4067,ACGTCGAATCTAGAGA,93,97,4,10,2628,0,0
4068,ACGTCGAATCTAGAGA,93,97,4,14,2633,0,0
4069,ACGTCGAATCTAGAGA,93,97,4,12,2642,0,0
4070,ACGTCGAATCTAGAGA,93,97,4,12,2644,0,0
4071,ACGTCGAATCTAGAGA,93,97,4,15,2654,0,0
4072,ACGTCGAATCTAGAGG,93,97,4,13,2665,0,0
4073,ACGTCGAATCTAGAGA,93,97,4,13,2666,0,0
4077,ACGTCGAATCTAGAGA,93,97,4,13,2688,0,0
4078,ACGTCGAATCTAGAGA,93,97,4,13,2692,0,0
4080,AGGTCGAATCTAGAGA,93,97,4,10,2694,0,0
4081,ACGTCGAATCTAGAGA,93,97,4,12,2706,0,0
4082,ACGTCGAATCTAGAGA,93,97,4,12,2708,0,0
4084,ACGTCGAATCTAGAGA,93,97,4,12,2710,0,0
4085,ACGTCGAATCTAGAGA,93,97,4,14,2725,0,0
4087,ACGTCGAATCTAGAGA,93,97,4,15,2748,0,0
4088,ACGTCGAATCTAGAGA,93,97,4,14,2772,0,0
4089,ACGTCGAATCTAGAGA,93,97,4,8,2773,0,0
4092,ACGTCGAATCTAGAGA,93,97,4,12,2793,0,0
4093,ACGTCGAATCTAGAGA,93,97,4,12,2795,0,0
4094,ACGTCGAATCAAGAGA,93,97,4,12,2796,0,0
4096,ACGTCGAATCTAGAGA,93,97,4,10,2799,0,0
4098,ACCTCGAATCTAGAGA,93,97,4,9,2810,0,0
4099,ACGTCGAATCTAGAGA,93,97,4,9,2812,0,0
4101,ACGTCGAATCTAGAGA,93,97,4,10,2918,0,0
4102,ACGTCGAAGCTAGAGA,93,97,4,13,2957,0,0
4103,ACGTCGAATCTAGAGA,93,97,4,10,2971,0,0
4104,ACGTCGAATCTAGAGA,93,97,4,13,2972,0,0
4105,ACGTCGAATCTTGAGA,93,97,4,15,3022,0,0
4123,ACGTCGAATCTAGAGA,94,97,3,13,1795,0,0
4124,ACGTCGAATCTAGAGA,94,97,3,13,1799,0,0
4125,ACGTCGAATCTAGAGA,94,97,3,13,1817,0,0
4126,ACGTCGAATCTAGAGA,94,97,3,13,1834,0,0
4143,ACGTCGAATCTAGAGA,94,97,3,11,2758,0,0
4146,ACGTCGAATCTAGAGA,94,97,3,10,2806,0,0
4153,ACGTCGAATCTAGAGA,94,97,3,13,2834,0,0
4155,ACGTCGAATCTAGAGA,94,97,3,15,2841,0,0
4186,ACGTCGAATCTAGAGA,94,97,3,13,2978,0,0
4193,ACGTCGAATCTAGAGA,94,97,3,12,3025,0,0
4198,ACGTCGAACCTAGAGA,94,97,3,15,3043,0,0
4199,ACGTCGAATCTAGAGA,94,97,3,18,3044,0,0
4214,ACGTCGAATCTAGAGA,95,97,2,12,1173,0,0
4216,ACGTCGAATCTAGAGA,95,97,2,12,1221,0,0
4217,ACGTCGAATCTAGAGA,95,97,2,9,1223,0,0
4224,ACGTCGAATCTAGAGA,95,97,2,14,1533,0,0
4226,ACGTCGAATCTAGAGA,95,97,2,12,1695,0,0
4230,ACGTCGAATCTAGAGA,95,97,2,8,1931,0,0
4244,ACGTCGAATCTAGAGA,95,97,2,7,2092,0,0
4246,ACGTCCAATCTAGAGA,95,97,2,16,2142,0,0
4256,ACGTCGAATCTAAAGA,95,97,2,11,2217,0,0
4284,ACGTCGAATCTAGAGA,95,97,2,17,3008,0,0
4289,ACGTCGAATCTAGAGA,96,97,1,10,963,0,0
4295,ACGTCAAATCTAGAGA,96,97,1,10,1031,0,0
4297,ACGTCGAATCTAGAGA,96,97,1,11,1068,0,0
4299,ACGTCGAATCTAGAGA,96,97,1,12,1272,0,0
4304,ACGTCGAATCTAGAGA,96,97,1,12,1570,0,0
4337,ACGTCGAATCTAGAGA,96,97,1,13,2688,0,0
4338,ACGTCGAATCTAGAGA,96,97,1,13,2692,0,0
1006,ACGTCGAATCTAGAGA,64,98,34,12,542,9,0
1290,ACGTCGAATCTAGAGA,67,98,31,9,314,6,0
1493,ACGTCGAATCTAGAGA,68,98,30,13,981,4,0
1590,ACGTCGAATCTAGAGA,69,98,29,8,803,6,0
1677,ACGTCGAATCTAGAGA,69,98,29,11,1115,5,0
1776,ACGTCGAATCTAGAGA,70,98,28,12,926,4,0
1931,ACGTCGAATCTAGAGA,71,98,27,7,961,4,0
1942,ACGTCGAATCTAGAGA,71,98,27,13,981,5,0
1981,ACGTCGAGTCTAGAGA,72,98,26,11,465,2,0
1987,ACGTCGAATCTAGAGA,72,98,26,11,498,3,0
2174,ACGTCGAATCTAGAGA,73,98,25,12,1259,3,0
2264,ACGTCGAATCTAGAGA,74,98,24,11,1424,4,0
2486,ACGTCGAATCTAGAGA,77,98,21,7,418,5,0
2681,ACGTCGAATCTAGAGA,79,98,19,12,392,4,0
2682,ACGTCGAATCTAGAGA,79,98,19,9,394,3,0
2706,ACGTCGAATCTAGAGA,79,98,19,11,817,3,0
2867,ACGTCGAATCTAGAGA,81,98,17,14,661,2,0
2962,ACGTCGAATCTAGAGA,82,98,16,9,240,2,0
2977,ACCTCGAATCTAGAGA,82,98,16,9,688,2,0
3041,ACGTCGAATCTAGAGA,82,98,16,10,2403,2,0
3098,ACGTCGAATCTAGAGA,83,98,15,12,1224,0,0
3106,ACGTCGAATCTAGAGA,83,98,15,11,1534,1,0
3112,ACGTCGAATCTAGAGA,83,98,15,13,1779,0,0
3113,ACGTCGAATCTAGAGA,83,98,15,11,1904,0,0
3164,ACGTCGAATCTAGAGA,84,98,14,8,350,0,0
3203,ACGTCGAATCTAGAGA,84,98,14,13,1288,0,0
3306,ACGTCGAATCTAGAGA,85,98,13,12,2006,0,0
3329,ACGTCGAATCTAGAGA,85,98,13,10,2401,0,0
3372,ACGTCGAATCTAGAGA,86,98,12,10,574,0,0
3374,ACGTCGAATCTGGAGA,86,98,12,13,584,0,0
3387,ACGTCGAATCTAGAGA,86,98,12,12,1224,0,0
3388,ACGTCGAATCTAGAGA,86,98,12,12,1235,0,0
3390,ACGTCGAATCTAGAGA,86,98,12,12,1261,0,0
3392,ACGTCGAATCTAGAGA,86,98,12,10,1377,0,0
3393,ACGTCGAATCTAGAGA,86,98,12,11,1452,0,0
3395,ACGTCGAATCTAGAGA,86,98,12,8,1485,0,0
3397,ACGTCGAATCTAGAGA,86,98,12,11,1491,0,0
3406,ACGTCGAATCTAGAGA,86,98,12,9,1545,0,0
3407,ACGTCGCATCTAGAGA,86,98,12,9,1550,0,0
3411,ACGTCGAATCTAGAGA,86,98,12,11,1870,0,0
3413,ACGTCGAATCTAGAGA,86,98,12,11,1904,0,0
3420,ACGTCGAATCTAGAGA,86,98,12,10,2125,0,0
3422,ACGTCGAATCTAGAGA,86,98,12,11,2211,0,0
3423,ACCTCGAATCTAGAGA,86,98,12,11,2336,0,0
3425,ACGTCGAATCTAGAGA,86,98,12,15,2385,0,0
3426,AGGTCGAATCTAGAGA,86,98,12,10,2411,0,0
3439,ACGTCGAATCTAGAGA,86,98,12,11,2758,0,0
3440,ACGTCGAATCTAGAGA,86,98,12,14,2772,0,0
3444,ACGTCGAATCTAGAGA,86,98,12,14,2848,0,0
3446,ACGTCGAATCTAGAGA,86,98,12,15,2910,0,0
3454,ACGTCGAATCTAGAAA,86,98,12,12,3017,0,0
3836,ACGTCGAATCTAGAGA,91,98,7,9,228,0,0
3895,ACGTCGAATCTAGAGA,91,98,7,11,2758,0,0
3896,ACGTCGAATCTAGAGA,91,98,7,11,2760,0,0
3915,ACGTCGAATCTGGAGA,92,98,6,13,584,0,0
3922,ACGTCGAATCTAGAGA,92,98,6,9,1223,0,0
3924,ACGTCGAATCTAGAGA,92,98,6,12,1235,0,0
3934,ACGTCGAATCTAGAGA,92,98,6,15,1689,0,0
3955,ACGTCGAATCTAGAGA,92,98,6,12,2055,0,0
3957,ACGTCGAATCTAGAGA,92,98,6,7,2092,0,0
3960,ACGTCGAATATAGAGA,92,98,6,13,2149,0,0
3961,ACGTCGAATCTAGAGA,92,98,6,13,2153,0,0
3963,ACGTCGAATCTAGAGA,92,98,6,13,2174,0,0
3965,ACGTCGAACCTAGAGA,92,98,6,15,2191,0,0
3966,ACGTCGAATCTAGAGA,92,98,6,16,2196,0,0
3967,ACGTCGAATCTAGAGA,92,98,6,11,2213,0,0
3968,ACGTCGAATCTAGAGA,92,98,6,11,2214,0,0
3969,ACGTCGAATCTAAAGA,92,98,6,11,2217,0,0
3972,ACGTCGAATCTAGAGA,92,98,6,14,2245,0,0
4038,ACGTCGAATCTAGAGA,93,98,5,12,2425,0,0
4049,ACGTCGAATCTAGAGA,93,98,5,11,2499,0,0
4118,ACGTCGAATCTAGAGA,94,98,4,13,1770,0,0
4136,ACGTCGAATCTAGAGA,94,98,4,15,2256,0,0
4150,ACATCGAATCTAGAGA,94,98,4,17,2822,0,0
4167,ACGTCGAATCTAGAGA,94,98,4,11,2884,0,0
4168,ACGTCGAATCTAGAGA,94,98,4,14,2886,0,0
4169,ACGTCGAATCTAGAGA,94,98,4,14,2887,0,0
4170,ACGTCGAATCTAGAGA,94,98,4,14,2888,0,0
4171,ACGTCGAATCTAGAGA,94,98,4,16,2904,0,0
4172,ACGTCGAATCTAGAGA,94,98,4,14,2906,0,0
4173,ACGTCGAATCTAGAGA,94,98,4,11,2907,0,0
4174,ACGTCGAATCTAGAGA,94,98,4,15,2910,0,0
4175,ACGTCGAATCTAGAGA,94,98,4,9,2911,0,0
4176,ACGTCGAATCTAGAGA,94,98,4,11,2920,0,0
4178,ACGTCAAATCTAGAGA,94,98,4,11,2925,0,0
4179,ACATCGAATCTAGAGA,94,98,4,13,2934,0,0
4180,ACGTCGAATCTAGAGA,94,98,4,13,2948,0,0
4181,ACGTCGAATCTAGAGA,94,98,4,17,2951,0,0
4182,ACGTCGAATCTACAGA,94,98,4,10,2958,0,0
4183,ACGTCGAATCTAGAGA,94,98,4,10,2962,0,0
4184,ACGTCGAATCTAGAGA,94,98,4,13,2974,0,0
4185,AGGTCGAATCTAGAGA,94,98,4,10,2975,0,0
4188,ACGTCGAATCTAGAGA,94,98,4,11,3009,0,0
4189,ACGTCGAATCTAGAGA,94,98,4,9,3011,0,0
4190,ACGTCGAATCTAGAGA,94,98,4,10,3013,0,0
4191,ACGTCGAATCTAGAAA,94,98,4,12,3017,0,0
4192,ACGTCGAATCTAGAGA,94,98,4,14,3023,0,0
4194,ACGTCGAATCTAGAGA,94,98,4,16,3029,0,0
4195,ACGTCGAATCTAGAGA,94,98,4,17,3030,0,0
4196,ACGTCGAATCTAGAGA,94,98,4,11,3041,0,0
4200,TCGTCGAATCTAGAGA,94,98,4,12,3049,0,0
4201,ACGTCGAATCTAGAGA,94,98,4,13,3051,0,0
4202,ACGTCGAATCTAGAGA,94,98,4,13,3054,0,0
4203,ACGTCGAATCTAGAGA,94,98,4,13,3055,0,0
4204,ACGTCGAATCTAGAGA,94,98,4,15,3060,0,0
4206,ACGTCGAATCTAGAGA,95,98,3,10,436,0,0
4267,ACGTCGAATCTAGAGA,95,98,3,9,2302,0,0
4273,ACGTCGAATCTAGAGA,95,98,3,15,2385,0,0
4283,ACGTCGAATCTAGAGA,95,98,3,14,3007,0,0
4293,ACGTCGAATCTAGAGA,96,98,2,13,1006,0,0
4296,ACGTCGAATCTAGAGA,96,98,2,11,1062,0,0
4322,ACGTCGAATCTAGAGA,96,98,2,13,2546,0,0
4333,ACGTCGAATCTAGAGA,96,98,2,12,2644,0,0
4340,AGGTCGAATCTAGAGA,96,98,2,10,2694,0,0
4341,ACGTCGAATCTAGAGA,96,98,2,12,2706,0,0
4358,ACGTCGAATCTAGAGA,96,98,2,13,2972,0,0
4372,ACGTCGAATCTAGAGA,97,98,1,13,1776,0,0
4381,ACGTCGAATCTAGAGA,97,98,1,8,1908,0,0
4386,ACGTCGAATCTAGAGA,97,98,1,13,2659,0,0
4405,ACGTCGAATCTAGAGA,97,98,1,15,2910,0,0
4419,ACGTCGAATCTAGAGA,97,98,1,11,3041,0,0
4421,ACGTCGAACCTAGAGA,97,98,1,15,3043,0,0
239,ACGTCGAATCTAGAGA,48,99,51,8,163,16,0
474,ACGTCGAATCTAGAGA,56,99,43,10,251,13,0
523,ACGTCGAATCTAGAGA,57,99,42,11,284,13,0
657,ACGTCGAATCTAGAGA,59,99,40,10,446,12,0
746,ACGTCGAATCTAGAGA,61,99,38,6,290,11,0
764,ACGTCGAATCAAGAGA,61,99,38,9,394,11,0
1011,ACGTCGAATCTAGAGA,64,99,35,9,669,9,0
1212,ACGTCGAATCTAGAGA,66,99,33,14,647,9,0
1817,ACGTCGAATCTAGAGA,70,99,29,12,1203,6,0
2191,ACGTCGAACCTAGAGA,73,99,26,14,1543,4,0
2257,ACGTCGAATCTAGAGA,74,99,25,15,1186,5,0
2301,ACGTCGAACCTAGAGA,75,99,24,11,502,6,0
2373,ACGTCGAATCTAGAGA,75,99,24,13,1716,4,0
2472,ACGTCGAATCTAGAGA,76,99,23,12,1993,2,0
2760,ACGTCGAATCTAGAGA,79,99,20,10,2195,4,0
2783,ACGTCGAATCTAGAGA,80,99,19,10,582,3,0
2841,ACGTCGAATCTAGAGA,80,99,19,14,2352,3,0
3011,ACGTCGAATCTAGAGA,82,99,17,8,1902,2,0
3043,ACGTCGAACCTAGAGA,82,99,17,14,2455,2,0
3064,ACGTCGAATCTAGAGA,82,99,17,14,2633,2,0
3175,ACGTCGAATCTAGAGA,84,99,15,10,749,1,0
3236,ACGTCGAATCTAGAGA,84,99,15,11,2482,0,0
3405,ACGTCGAATCTAGAGA,86,99,13,14,1538,0,0
3431,ACGTCGAATCTAGAGA,86,99,13,11,2637,0,0
3842,ACGTCGAATCTAGAGA,91,99,8,12,546,0,0
3844,ACGTCGAGTCTAGAGA,91,99,8,15,700,0,0
3850,ACGTCGAATCTAGAGA,91,99,8,11,1416,0,0
3883,ACGTCGAATCTAGAGA,91,99,8,11,2211,0,0
4011,ACGTCGAATCTAGAGA,93,99,6,10,982,0,0
4034,ACGTCGAATCTAGAGA,93,99,6,12,2354,0,0
4035,ACGTCGAATCTAGAGA,93,99,6,11,2375,0,0
4039,ACGTCGAATCTAGAGA,93,99,6,14,2435,0,0
4040,ACGTCGAATCTAGAGA,93,99,6,13,2445,0,0
4041,ACGTCGAATCTAGAGA,93,99,6,12,2462,0,0
4042,ACGTCGAATCTAGAGA,93,99,6,12,2464,0,0
4043,ACGTCGAATCTAGAGA,93,99,6,12,2467,0,0
4045,ACGTCGAATCTAGAGA,93,99,6,13,2472,0,0
4046,ACGTCGAATCTAGAGA,93,99,6,8,2486,0,0
4047,ACGTCGAATCTAGAGA,93,99,6,11,2489,0,0
4157,ACGTCGAATCTAGAGA,94,99,5,13,2851,0,0
4161,ACGTCGAACCTAGAGA,94,99,5,12,2863,0,0
4222,ACGTCGAATCTAGAGA,95,99,4,11,1488,0,0
4245,ACGTCGAATCTAGAGA,95,99,4,10,2125,0,0
4251,ACGTCGAATCTAGAGA,95,99,4,12,2189,0,0
4262,ACGTCGAATCTAGAGA,95,99,4,15,2265,0,0
4263,ACGTCGAATCTAGAGA,95,99,4,16,2279,0,0
4264,ACGTTGAATCTAGAGA,95,99,4,12,2296,0,0
4265,ACGTCGAATCTAGAGG,95,99,4,12,2298,0,0
4268,ACGTCGAATCTAGAGA,95,99,4,14,2321,0,0
4269,ACGTCGAATCTAGAAA,95,99,4,12,2361,0,0
4270,ACGTCGAATCTAGAGA,95,99,4,13,2367,0,0
4271,ACGTCGAATCTAGAGA,95,99,4,13,2371,0,0
4272,ACGTCGAATCTAGACA,95,99,4,14,2373,0,0
4274,ACGTCGATTCTAGAGA,95,99,4,10,2388,0,0
4275,ACGTCGAATCTAGAGA,95,99,4,10,2390,0,0
4276,ACGTCGAATCTAGAGA,95,99,4,10,2682,0,0
4277,ACGTCGAATCTAGAGA,95,99,4,11,2722,0,0
4278,ACCTCGAATCTGGAGA,95,99,4,11,2723,0,0
4279,ACGTCGAATCTAGAGA,95,99,4,12,2901,0,0
4280,ACGTCGAATCAAGAGA,95,99,4,15,2956,0,0
4281,ACCTCGAATCTAGAGA,95,99,4,10,2977,0,0
4282,ACGTCGAATCTAGAGA,95,99,4,14,3005,0,0
4307,ACGTCGAATCTTGAGA,96,99,3,14,2177,0,0
4309,ACGTCGAATCTAGAGA,96,99,3,13,2421,0,0
4317,ACGTCGAATCTAGAGA,96,99,3,11,2492,0,0
4319,ACGTCGAATCTAGAGA,96,99,3,11,2509,0,0
4327,ACGTCGAACCTAGAGA,96,99,3,12,2583,0,0
4345,ACGTCGAATCTAGAGA,96,99,3,15,2748,0,0
4357,ACGTCGAATCTAGAGA,96,99,3,10,2918,0,0
4362,ACGTCGAATCTAGAGA,97,99,2,9,239,0,0
4373,ACGTCGAATCTAGAGA,97,99,2,13,1781,0,0
4378,ACGTCGTATCTAGAGA,97,99,2,13,1847,0,0
4383,ACGTCGAATCTAGAGA,97,99,2,10,2109,0,0
4387,ACGTCGAATCTAGAGA,97,99,2,11,2758,0,0
4427,ACGTCGAATCTAGAGA,98,99,1,10,114,0,0
4443,ACGTCGAATCTAGAGA,98,99,1,12,1695,0,0
4452,ACGTCGAATATAGAGA,98,99,1,13,2149,0,0
4463,ACGTCGAATCTAGAGA,98,99,1,16,2279,0,0
4467,ACGTCGAATCTAGAGA,98,99,1,14,2321,0,0
4478,ACGTCGAATCTAGAGA,98,99,1,17,3008,0,0
4482,CCGTCGAATCTAGAGA,98,99,1,11,3909,0,0
4483,ACGTCGAATCTAGAGA,98,99,1,11,3910,0,0
114,ACGTCGAATCTAGAGA,40,100,60,9,72,19,1
185,ACGTCGAATCTAGAGA,45,100,55,8,115,17,1
436,ACGTCGAATCTAGAGA,55,100,45,9,240,14,1
444,ACGTCGAATCTAGAGA,55,100,45,9,297,14,1
511,ACGTCGAATCTAGAGA,57,100,43,8,166,13,1
564,ACGTCGAATCTAGAGA,58,100,42,9,231,13,1
584,ACGTCGAATCTGGAGA,58,100,42,12,318,13,1
591,ACGTCGAATCTAGAGA,58,100,42,9,393,13,1
856,ACGTCGAATCTAGAGA,62,100,38,10,569,10,1
982,ACGTCGAATCTAGAGA,64,100,36,9,387,10,1
985,ACGTCGAATCTAGAGA,64,100,36,9,394,10,1
986,ACGTCGAATCTAGAGA,64,100,36,12,401,10,1
1031,ACGTCAAATCTAGAGA,64,100,36,9,701,9,1
1062,ACGTCGAATCTAGAGA,65,100,35,10,415,9,1
1068,ACGTCGAATCTAGAGA,65,100,35,10,431,9,1
1076,ACGTCGAATCTAGAGA,65,100,35,10,451,9,1
1221,ACGTCGAATCTAGAGA,66,100,34,11,665,7,1
1223,ACGTCGAATCTAGAGA,66,100,34,8,803,8,1
1224,ACGTCGAATCTAGAGA,66,100,34,11,804,7,1
1235,ACGTCGAATCTAGAGA,66,100,34,11,820,8,1
1272,ACGTCGAATCTAGAGA,66,100,34,11,878,9,1
1295,ACGTCGAATCTAGAGA,67,100,33,9,394,7,1
1297,ACGTCGAATCTAGAGA,67,100,33,12,410,6,1
1332,ACGTCGAATCTAGAGA,67,100,33,12,714,8,1
1416,ACGTCGAATCTAGAGA,68,100,32,10,445,7,1
1439,ACGTCGAATCTAGAGA,68,100,32,10,592,7,1
1488,ACGTCGAATCTAGAGA,68,100,32,10,973,6,1
1533,ACGTCGAATCTAGAGA,68,100,32,13,1032,7,1
1553,ACGTCGAATCTAGAGA,69,100,31,11,370,6,1
1622,ACGTCGAATCTAGAGA,69,100,31,11,861,5,1
1682,ACGTCGAATCTAGAGA,69,100,31,8,1121,5,1
1695,ACGTCGAATCTAGAGA,69,100,31,11,1143,5,1
1725,ACGTCGAATCTAGAGA,70,100,30,9,394,5,1
1744,ACCTCGAATCTAGAGA,70,100,30,9,688,6,1
1759,ACGTCGAATCTAGGGA,70,100,30,9,887,5,1
1770,ACGTCGAATCTAGAGA,70,100,30,12,913,5,1
1781,ACGTCGAATCTAGAGA,70,100,30,12,931,3,1
1795,ACGTCGAATCTAGAGA,70,100,30,12,955,6,1
1799,ACGTCGAATCTAGAGA,70,100,30,12,1172,4,1
1841,ACGTCGAATCTAGAGA,70,100,30,9,1243,4,1
1847,ACGTCGTATCTAGAGA,70,100,30,12,1253,3,1
1858,ACGTCGAATCTAGAGA,70,100,30,12,1267,6,1
1865,ACGTCGAATCTAGAGA,71,100,29,10,114,6,1
1882,ACGTCGAATCTAGAGA,71,100,29,13,452,4,1
1908,ACGTCGAATCTAGAGA,71,100,29,7,746,6,1
1962,ACGTCGAATCTAGAGA,71,100,29,10,1284,5,1
1976,ACGTCGAATCTAGAGA,72,100,28,8,273,4,1
1993,ACGTCGAATCTAGAGA,72,100,28,11,627,4,1
2003,ACGTCGAATCTAGAGA,72,100,28,14,661,6,1
2006,ACGTCGAATCTAGAGA,72,100,28,11,804,5,1
2013,ACGTCGAATCTAGAGA,72,100,28,11,817,4,1
2109,ACGTCGAATCTAGAGA,73,100,27,9,511,5,1
2142,ACGTCGAATCTAGAGA,73,100,27,15,914,5,1
2149,ACGTCGAATATAGAGA,73,100,27,12,928,3,1
2167,ACGTCGAATCTAGAGA,73,100,27,11,1149,6,1
2177,ACGTCGAATCTTGAGA,73,100,27,13,1333,6,1
2189,ACGTCGAATCTAGAGA,73,100,27,11,1503,5,1
2213,ACGTCGAATCTAGAGA,74,100,26,10,451,5,1
2214,ACGTCGAATCTAGAGA,74,100,26,10,457,3,1
2217,ACGTCGAATCTAAAGA,74,100,26,10,560,4,1
2233,ACGTCGAATCTAGAGA,74,100,26,10,737,4,1
2245,ACGTCGAATCTAGAGA,74,100,26,13,1003,4,1
2265,ACGTCGAATCTAGAGA,74,100,26,14,1456,4,1
2279,ACGTCGAATCTAGAGA,74,100,26,15,1702,5,1
2296,ACGTTGAATCTAGAGA,75,100,25,11,469,5,1
2298,ACGTCGAATCTAGAGG,75,100,25,11,485,5,1
2314,ACGTCGAATCTAGAGA,75,100,25,10,749,5,1
2321,ACGTCGAATCTAGAGA,75,100,25,13,790,5,1
2361,ACGTCGAATCTAGAAA,75,100,25,11,1522,6,1
2367,ACGTCGAATCTAGAGA,75,100,25,12,1604,4,1
2375,ACGTCGAATCTAGAGA,75,100,25,10,1738,4,1
2388,ACGTCGAATCTAGAGA,76,100,24,9,133,4,1
2390,ACGTCGAATCTAGAGA,76,100,24,9,228,4,1
2421,ACGTCGAATCTAGAGA,76,100,24,12,933,5,1
2425,ACGTCGAATCTAGAGA,76,100,24,11,1058,5,1
2445,ACGTCGAATCTAGAGA,76,100,24,12,1570,5,1
2462,ACGTCGAATCTAGAGA,76,100,24,11,1887,4,1
2464,ACGTCGAATCTAGAGA,76,100,24,11,1911,5,1
2509,ACGTCGAATCTAGAGA,77,100,23,10,736,3,1
2513,ACGTCGAATCTAGAGA,77,100,23,12,927,4,1
2521,ACGTCGAATCTGGAGA,77,100,23,13,1006,5,1
2546,ACGTCGAATCTAGAGA,77,100,23,12,1584,4,1
2551,ACCTCGAATCTAGAGA,77,100,23,10,1744,4,1
2563,ACGTCGAATCTAGAGA,77,100,23,10,2106,3,1
2567,ACGTCGAATCTAGAGA,77,100,23,13,2155,3,1
2576,ACGTCGAATCTAGAGA,78,100,22,11,485,4,1
2580,ACGTCGAATCTAGAGA,78,100,22,8,608,4,1
2583,ACGTCGAACCTAGAGA,78,100,22,11,633,3,1
2592,ACGTCGAATCTAGAGA,78,100,22,10,748,5,1
2622,ACGTCGAATCTAGAGA,78,100,22,12,1604,4,1
2633,ACGTCGAATCTAGAGA,78,100,22,13,1721,5,1
2642,ACGTCGAATCTAGAGA,78,100,22,11,1874,4,1
2644,ACGTCGAATCTAGAGA,78,100,22,11,1894,4,1
2654,ACGTCGAATCTAGAGA,78,100,22,14,2051,4,1
2659,ACGTCGAATCTAGAGA,78,100,22,12,2161,5,1
2667,ACGTCGAATCTAGAGA,78,100,22,15,2256,3,1
2688,ACGTCGAATCTAGAGA,79,100,21,12,521,4,1
2693,ACGTCGAATCTAGAGA,79,100,21,9,670,4,1
2694,AGGTCGAATCTAGAGA,79,100,21,9,678,3,1
2708,ACGTCGAATCTAGAGA,79,100,21,11,836,3,1
2722,ACGTCGAATCTAGAGA,79,100,21,10,1313,3,1
2723,ACCTCGAATCTAGAGA,79,100,21,10,1321,3,1
2725,ACGTCGAATCTAGAGA,79,100,21,13,1353,3,1
2736,ACGTCGAATCTAGAGA,79,100,21,12,1672,5,1
2748,ACGTCGAATCTAGAGA,79,100,21,14,1942,5,1
2758,ACGTCGAATCTAGAGA,79,100,21,10,2094,4,1
2775,ACGTCGAATCTAGAGA,80,100,20,10,444,3,1
2795,ACGTCGAATCTAGAGA,80,100,20,11,854,4,1
2796,ACGTCGAATCAAGAGA,80,100,20,11,856,4,1
2798,ACGTCGAATCTAGAGA,80,100,20,11,878,4,1
2799,ACGTCGAATCTAGAGA,80,100,20,9,887,3,1
2806,ACGTCGAATCTAGAGA,80,100,20,9,1168,3,1
2810,ACGTCGAATCTAGAGA,80,100,20,8,1405,4,1
2812,ACGTCGAATCTAGAGA,80,100,20,8,1444,3,1
2813,ACGTCGAATCTAGAGA,80,100,20,14,1484,2,1
2817,ACGTCGAATCTAGAGA,80,100,20,7,1717,3,1
2821,ACGTCGAATCTAGAGA,80,100,20,10,1798,3,1
2833,ACGTCGAATCTAGAGA,80,100,20,12,2162,3,1
2834,ACGTCGAATCTAGAGA,80,100,20,12,2183,3,1
2835,ACGTCGAACCTAGAGA,80,100,20,15,2191,2,1
2848,ACGTCGAATCTAGAGA,80,100,20,13,2406,4,1
2852,ACGTCGAATCTAGAGA,80,100,20,13,2445,2,1
2856,ACGTTGAATCTAGAGA,81,100,19,11,469,3,1
2873,ACGTCGAATCAAGAGA,81,100,19,10,764,3,1
2884,ACGTCGAATCTAGAGA,81,100,19,10,982,3,1
2887,ACGTCGAATCTAGAGA,81,100,19,13,988,3,1
2888,ACGTCGAATCTAGAGA,81,100,19,13,1006,2,1
2901,ACGTCGAATCTAGAGA,81,100,19,11,1106,4,1
2910,ACGTCGAATCTAGAGA,81,100,19,14,1475,3,1
2918,ACGTCGAATCTAGAGA,81,100,19,9,1657,5,1
2920,ACGTCGAATCTAGAGA,81,100,19,10,1728,3,1
2956,ACGTCGAATCAAGAGA,81,100,19,14,2553,5,1
2972,ACGTCGAATCTAGAGA,82,100,18,12,521,3,1
2974,ACGTCGAATCTAGAGA,82,100,18,12,546,2,1
2975,AGGTCGAATCTAGAGA,82,100,18,9,678,2,1
2978,ACGTCGAATCTAGAGA,82,100,18,12,696,2,1
2979,ACGTCGAATCTAGAGA,82,100,18,15,700,2,1
3005,ACGTCGAATCTAGAGA,82,100,18,13,1774,4,1
3008,ACGTCGAATCTAGAGA,82,100,18,16,1808,3,1
3009,ACGTCGAATCTAGAGA,82,100,18,10,1832,2,1
3013,ACGTCGAATCTAGAGA,82,100,18,9,1979,2,1
3022,ACGTCGAATCTTGAGA,82,100,18,14,2177,3,1
3023,ACGTCGAATCTAGAGA,82,100,18,13,2192,2,1
3025,ACGTCGAATCTAGAGA,82,100,18,11,2211,3,1
3029,ACGTCGAATCTAGAGA,82,100,18,15,2256,3,1
3030,ACGTCGAATCTAGAGA,82,100,18,16,2257,2,1
3042,ACGTCGAATCTAGAGA,82,100,18,13,2421,2,1
3044,ACGTCGAATCTAGAGA,82,100,18,17,2456,2,1
3051,ACGTCGAATCTAGAGA,82,100,18,12,2537,2,1
3055,ACGTCGAATCTAGAGA,82,100,18,12,2578,2,1
3058,ACGTCGAATCAAGAGA,82,100,18,11,2596,2,1
3060,ACGTCGAATCTAGAGA,82,100,18,14,2600,2,1
3069,ACGTCGAATCTAGAGA,83,100,17,13,349,1,1
3071,ACGTCGAATCTAGAGA,83,100,17,10,444,0,1
3085,ACGTCGAATCTAGAGA,83,100,17,9,887,1,1
3091,ACGTCGAATCTAGAGA,83,100,17,12,1173,2,1
3115,ACGTCGAATCTAGAGA,83,100,17,11,1920,0,1
3118,ACTTCGAATCTAGAGA,83,100,17,12,2017,0,1
3121,ACGTCGAATCTAGAGA,83,100,17,11,2074,1,1
3123,ACGTCGAATCTAGAGA,83,100,17,14,2081,0,1
3131,ACGTCGAATCTAGAGA,83,100,17,9,2291,1,1
3135,ACGTCGAATCTAGAGA,83,100,17,12,2328,2,1
3142,ACGTCGAATCTAGAGA,83,100,17,15,2440,0,1
3156,ACGTCGAATCTAGAGA,83,100,17,13,2681,1,1
3162,ACGTCGAATCTAGAGA,83,100,17,17,2764,0,1
3163,ACGTCGAATCTAGAGA,84,100,16,8,35,0,1
3169,ATGTCGAATCTAGAGA,84,100,16,11,640,0,1
3171,ACGTCGAATCTAGAGA,84,100,16,11,657,0,1
3177,ACGTCGAATCAAGAGA,84,100,16,10,764,0,1
3196,ACGTCGAATCTAGAGA,84,100,16,11,1076,0,1
3199,ACGTCGAATCTAGAGA,84,100,16,11,1104,0,1
3200,ACGTCGAATCTAGAGA,84,100,16,12,1267,0,1
3202,ACGTCGAATCTAGAGA,84,100,16,10,1287,0,1
3206,ACGTCGAATCTAGAGA,84,100,16,10,1313,1,1
3226,ACGTCGAATCTAGAGA,84,100,16,13,2237,1,1
3232,ACGTCGAATCTAGAGA,84,100,16,12,2426,1,1
3233,ACGTCGATTCTAGAGA,84,100,16,12,2442,0,1
3240,ACGTCGAATCTAGAGA,84,100,16,13,2546,0,1
3245,ACGTCGAATCTAGAGA,84,100,16,11,2598,0,1
3249,ACGTCGAATCTGGAGA,84,100,16,16,2735,0,1
3253,ACGTCGAATCTAGAGA,84,100,16,12,2825,0,1
3256,ACGTCGAATCTAGAGA,85,100,15,9,228,0,1
3260,ACGTCGAATCTAGAGA,85,100,15,9,394,0,1
3261,ACGTCGAATCTAGAGA,85,100,15,12,412,0,1
3288,ACGTCGAATCTAGAGA,85,100,15,14,1411,0,1
3289,ACGTCGAATCTAGAGA,85,100,15,11,1416,0,1
3293,ACGTCGAGTCTAGAGA,85,100,15,11,1467,0,1
3296,ACGTCGAATCTAGAGA,85,100,15,13,1770,0,1
3297,ACGTCGAATCTAGAGA,85,100,15,13,1795,0,1
3298,ACGTCGAATCTAGAGA,85,100,15,13,1817,0,1
3300,ACGTCGAATCTAGAGC,85,100,15,13,1845,0,1
3301,ACGTCGAATCTAGAGA,85,100,15,11,1865,0,1
3305,ACGTCGAATCTAGAGA,85,100,15,11,1967,0,1
3323,ACGTCGAACCTAGAGA,85,100,15,12,2301,0,1
3328,ACGTCGAATCTAGAGA,85,100,15,7,2394,1,1
3333,ACGTCGAATCTAGAGA,85,100,15,8,2486,0,1
3336,ACGTCGAATCTAGAGA,85,100,15,11,2492,0,1
3338,ACGTCGAATCTAGAGA,85,100,15,13,2528,0,1
3341,ACTTCGAATCTAGAGA,85,100,15,12,2576,0,1
3347,ACGTCGAATCTAGAGA,85,100,15,10,2682,0,1
3367,ACGTCGAATCTAGAGA,86,100,14,10,436,0,1
3369,ACGTCGAATCTAGAGA,86,100,14,10,451,0,1
3381,ACGTCGAATCTAGAGA,86,100,14,14,1160,0,1
3386,ACGTCGAATCTAGAGA,86,100,14,9,1223,0,1
3404,ACGTCGAATCTAGAGA,86,100,14,14,1533,0,1
3456,ACGTCGAACCTAGAGA,86,100,14,13,3032,0,1
3840,ACGTCGAATCTAGAGA,91,100,9,9,511,1,1
3849,ACGTCGAATCTAGAGA,91,100,9,14,1411,1,1
3851,ACGTCGAATCTAGAGA,91,100,9,11,1439,1,1
3854,ACGTCGAATCTAGAGA,91,100,9,15,1608,1,1
3856,ACGTCGAATCTAGAGA,91,100,9,12,1622,1,1
3857,ACGTCGAATCTCGAGA,91,100,9,9,1633,1,1
3858,ACGTCGAATCTAGAGG,91,100,9,9,1676,1,1
3859,ACGTCGAATCTAGAGA,91,100,9,12,1677,1,1
3860,ACGTCGAATCTAGAGA,91,100,9,13,1770,1,1
3863,ACGTCGAATCTAGAGA,91,100,9,13,1776,1,1
3867,ACGTCGAATCTAGAGA,91,100,9,13,1799,1,1
3869,ACGTCGAATCTAGAGA,91,100,9,13,1817,1,1
3870,ACGTCGAATCAAGAGA,91,100,9,13,1831,1,1
3873,ACGTCGTATCTAGAGA,91,100,9,13,1847,1,1
3875,ACGTCGAATCTAGAGA,91,100,9,11,1865,1,1
3876,ACGTCGAATCTAGAGA,91,100,9,11,1870,1,1
3879,ACGTCGAATCTAGAGA,91,100,9,9,1990,1,1
3881,ACGTCGAATCTAGAGA,91,100,9,10,2109,1,1
3886,ACGTGGAATCTAGAGA,91,100,9,11,2314,1,1
3887,ACGTCGAATCTAGAGA,91,100,9,12,2330,1,1
3889,ACGTCGAATCTAGAGA,91,100,9,16,2447,1,1
3892,ACGTCGAATCTAGAGA,91,100,9,12,2647,1,1
3897,ACGTCGAATCTAGAGA,91,100,9,17,2764,1,1
3905,ACGTCGAATCTAGAGA,91,100,9,13,2948,1,1
3908,ACGTCGAATCTAGAGA,91,100,9,12,2998,1,1
3909,CCGTCGAATCTAGAGA,92,100,8,10,114,1,1
3910,ACGTCGAATCTAGAGA,92,100,8,10,436,1,1
3912,ACGTCGAATCTAGAGA,92,100,8,10,564,1,1
3913,ACGTCGAATCTAGAGA,92,100,8,10,572,1,1
3914,ACGTCGAATCTAGAGA,92,100,8,10,574,1,1
3916,ACGTCGAATCTAGAGA,92,100,8,10,591,0,1
3917,ACGTCGAATCTAGAGA,92,100,8,11,856,0,1
3918,ACGTCGAATCTAGAGA,92,100,8,14,1160,0,1
3920,ACGTCGAATCTAGAGA,92,100,8,15,1212,0,1
3925,ACGTCGAATCTAGAGA,92,100,8,10,1295,0,1
3926,ACGTCGAATCTAGAGA,92,100,8,11,1452,0,1
3927,ACGTCGAATCTAGAGA,92,100,8,8,1485,0,1
3928,ACGTCGAATCTAGAGA,92,100,8,11,1488,0,1
3930,ACGTCGAATCTAGAGA,92,100,8,14,1493,0,1
3932,ACGTTGAATCTAGAGA,92,100,8,14,1538,0,1
3935,ACGTCGAATCTAGAGA,92,100,8,12,1695,0,1
3936,ACGTCGAATCTAGAGA,92,100,8,10,1725,0,1
3937,ACCTCGAATCTAGAGA,92,100,8,10,1744,0,1
3938,ACGTCGAATCTAGAGA,92,100,8,11,1879,0,1
3939,ACGTCGAATCTAGAGC,92,100,8,14,1882,0,1
3940,ACGTCGAATCTAGAGA,92,100,8,11,1920,0,1
3942,ACGTCGAATCTAGAGA,92,100,8,8,1931,0,1
3943,ACGTCGAATCTAGAGA,92,100,8,14,1942,0,1
3944,ACGTCGAATCTAGAGA,92,100,8,14,1952,0,1
3945,ACGTCGAATCTAGAGA,92,100,8,11,1962,0,1
3947,ACGTCGAGTCTAGAGA,92,100,8,12,1981,0,1
3949,ACGTCGAATCTAGAGA,92,100,8,12,1993,0,1
3952,ACGTCGAATCTAGAGA,92,100,8,9,2009,0,1
3953,ACGTCGAATCTAGAGA,92,100,8,12,2013,0,1
4007,ACGTCGAATCTAGAGA,93,100,7,11,657,0,1
4009,ACGTCGAATCAAGAGA,93,100,7,10,764,0,1
4013,ACGTCGAATCTAGAGA,93,100,7,13,986,0,1
4014,ACGTCGAATCTAGAGA,93,100,7,13,1006,0,1
4016,ACGTCAAATCTAGAGA,93,100,7,10,1031,0,1
4019,ACGTCGAATCTAGAGA,93,100,7,11,1076,0,1
4020,ACGTCGAATCTAGAGA,93,100,7,8,1082,0,1
4021,ACGTCGAATCTAGAGA,93,100,7,11,1087,0,1
4022,ACGTCGAATATAGAGA,93,100,7,11,1104,0,1
4025,ACGTCGAATCTAGAGA,93,100,7,10,1290,0,1
4029,ACGTCGAATCTAGAGA,93,100,7,12,1570,0,1
4031,ACGTCGAATCTAGAGA,93,100,7,15,2003,0,1
4032,ACGTCGAATCTAGAGA,93,100,7,11,2039,0,1
4033,ACGTCGAATCTTGAGA,93,100,7,14,2177,0,1
4106,ACGTCGAATCTAGAGA,94,100,6,9,185,0,1
4108,ACGTCGAATCTAGAGA,94,100,6,9,511,0,1
4110,ACGTCGAATCTAGAGA,94,100,6,11,1149,0,1
4111,ACGTCGAATCAAGAGA,94,100,6,13,1297,0,1
4112,ACGTCGAATCTAGAGA,94,100,6,11,1416,0,1
4113,ACGTCGAATCTAGAGA,94,100,6,11,1439,0,1
4114,ACGTCGAATCTAGAGA,94,100,6,9,1590,0,1
4116,ACGTCGAATCTAGAGA,94,100,6,9,1633,0,1
4117,ACGTCGAATCTAGAGA,94,100,6,12,1677,0,1
4119,ACGTCGAATCTAGAGA,94,100,6,13,1774,0,1
4120,ACGTCGAATCTAGAGA,94,100,6,13,1776,0,1
4121,ACGTCGAATCTAGAGA,94,100,6,13,1779,0,1
4122,ACGTCGAATCTAGAGA,94,100,6,13,1781,0,1
4128,ACGTCGTATCTAGAGA,94,100,6,13,1847,0,1
4129,ACGTCGAATCTAGAGA,94,100,6,13,1858,0,1
4130,ACGTCGAATCTAGAGA,94,100,6,11,1865,0,1
4132,ACGTCGAATCTAGAGA,94,100,6,8,1908,0,1
4133,ACGTCGAATCTAGAGA,94,100,6,9,1976,0,1
4134,ACGTCGAATCTAGAGA,94,100,6,10,2109,0,1
4135,ACGTCGAATCTAGAGA,94,100,6,16,2124,0,1
4138,ACGTCGAATCTAGAGA,94,100,6,12,2330,0,1
4139,ACGTCGAATCTAGAGA,94,100,6,16,2447,0,1
4140,ACGTCGAATCTAGAGA,94,100,6,9,2580,0,1
4141,ACGTCGAATCTAGAGA,94,100,6,13,2659,0,1
4142,ACGTCGAATCTAGAGA,94,100,6,12,2703,0,1
4144,ACGTCGAATCTAGAGA,94,100,6,11,2760,0,1
4145,ACGTCGAATCTAGAGA,94,100,6,11,2783,0,1
4148,ACGTCGAATCTAGAGA,94,100,6,8,2817,0,1
4149,ACGTCGAATCTAGAGA,94,100,6,11,2821,0,1
4151,ACGTCGAATCTAGAGA,94,100,6,11,2827,0,1
4152,ACGTCGAATCTAGAGA,94,100,6,13,2833,0,1
4154,ACGTCGAACCTAGAGA,94,100,6,16,2835,0,1
4156,ACGTCGAATCTAGAGA,94,100,6,13,2850,0,1
4158,ACGTCGAATCTAGAGA,94,100,6,14,2852,0,1
4159,ACGTCGAATCTAGAGA,94,100,6,9,2853,0,1
4162,ACGTCGAATCTAGAGA,94,100,6,12,2864,0,1
4163,ACGTCGAATCTAGAGA,94,100,6,12,2865,0,1
4164,ACGTCGAATCTAGAGA,94,100,6,12,2866,0,1
4165,ACGTCGAATCTAGAGA,94,100,6,15,2867,0,1
4166,ACGTCGAATCAAGAGA,94,100,6,11,2873,0,1
4205,ACGTCGAATCTAGAGA,95,100,5,10,114,0,1
4207,ACGTCGAATCTAGAGA,95,100,5,10,444,0,1
4208,ACGTCGAATCTAGAGA,95,100,5,10,564,0,1
4209,ACGTCGAATCTAGAGA,95,100,5,10,574,0,1
4210,ACGTCGAATCTGGAGA,95,100,5,13,584,0,1
4211,ACGTCGAATCTAGAGA,95,100,5,10,591,0,1
4212,ACGTCGAATCTAGAGA,95,100,5,11,856,0,1
4213,ACGTCGAATCTAGAGA,95,100,5,14,1160,0,1
4215,ACGTCGAATCTAGAGA,95,100,5,15,1212,0,1
4219,ACGTCGAATCTAGAGA,95,100,5,12,1235,0,1
4220,ACGTCGAATCTAGAGA,95,100,5,10,1295,0,1
4221,ACGTCGAATCTAGAGA,95,100,5,8,1485,0,1
4223,ACGTCGAATCTAGAGA,95,100,5,14,1493,0,1
4225,ACGTCGAATCTAGAGA,95,100,5,9,1682,0,1
4227,ACGTCGAATCTAGAGA,95,100,5,10,1725,0,1
4228,ACCTCGAATCTAGAGA,95,100,5,10,1744,0,1
4229,ACGTCGAATCTAGAGA,95,100,5,14,1882,0,1
4231,ACGTCGAATCTAGAGA,95,100,5,14,1942,0,1
4232,ACGTCGAATCTAGAGA,95,100,5,14,1952,0,1
4233,ACGTCGAATCTAGAGA,95,100,5,11,1962,0,1
4234,ACGTCGAATCTAGAGA,95,100,5,9,1979,0,1
4235,ACGTCGAGTCTAGAGA,95,100,5,12,1981,0,1
4237,ACGTCGAATCTAGAGA,95,100,5,12,1993,0,1
4239,ACGTCGAATCTAGAGA,95,100,5,12,2006,0,1
4240,ACGTCGAATCTAGAGA,95,100,5,9,2009,0,1
4241,ACGTCGAATCTAGAGA,95,100,5,12,2013,0,1
4242,ACGTCGAATCTAGAGA,95,100,5,14,2046,0,1
4243,ACGTCGAATTTAGAGA,95,100,5,9,2091,0,1
4247,ACGTCGAATATAGAGA,95,100,5,13,2149,0,1
4249,ACGTCGAATCTAGAGA,95,100,5,12,2167,0,1
4250,ACGTCGAATCTAGAGA,95,100,5,13,2174,0,1
4252,ACGTCGAACCTAGAGA,95,100,5,15,2191,0,1
4253,ACGTCGAATCTAGAGT,95,100,5,16,2196,0,1
4254,ACGTCGAATCTAGAGA,95,100,5,11,2213,0,1
4255,ACGTCGAATCTAGAGA,95,100,5,11,2214,0,1
4257,ACGTCGAATCTAGAGA,95,100,5,11,2218,0,1
4259,ACGTCGAATCTAGAGA,95,100,5,14,2245,0,1
4260,ACGTCGAATCTAGAGA,95,100,5,16,2257,0,1
4261,ACGTCGAATCTAGAGA,95,100,5,12,2264,0,1
4285,ACGTCGAATCTAGAGA,96,100,4,11,474,0,1
4286,ACGTCGAATCTAGAGA,96,100,4,11,657,0,1
4287,ACGTCGAATCTAGAGA,96,100,4,7,746,0,1
4288,ACGTCGAATCAAGAGA,96,100,4,10,764,0,1
4290,ACGTCGAATCTAGAGA,96,100,4,10,982,0,1
4291,ACGTCGAATCTAGAGA,96,100,4,10,985,0,1
4292,ACGTCGAATCTAGAGA,96,100,4,13,986,0,1
4294,ACGTCGAATCTAGAGA,96,100,4,10,1011,0,1
4298,ACCTCGAATCTAGAGA,96,100,4,11,1076,0,1
4300,ACGTCGAATCTAGAGA,96,100,4,10,1287,0,1
4301,ACGTCGAATCTAGAGA,96,100,4,10,1290,0,1
4302,ACGTCGAATCTAGAGA,96,100,4,13,1332,0,1
4303,ACGTCGAATCTAGAGA,96,100,4,12,1553,0,1
4305,ACGTCGAATCTAGGGA,96,100,4,10,1759,0,1
4306,ACGTCGAATCTAGAGA,96,100,4,15,2003,0,1
4308,ACGTCGAATCTAGAGA,96,100,4,11,2375,0,1
4310,ACGTCGAATCTAGAGA,96,100,4,12,2425,0,1
4311,ACGTCGAATCTAGAGA,96,100,4,13,2445,0,1
4312,ACGTCGAATCTAGAGA,96,100,4,12,2462,0,1
4313,ACGTCGAATCTAGAGA,96,100,4,12,2464,0,1
4314,ACGTCGAATCTAGAGA,96,100,4,12,2467,0,1
4315,ACGTCGAATCTAGAGA,96,100,4,13,2472,0,1
4316,ACGTCGAATCTAGAGA,96,100,4,8,2486,0,1
4318,ACGTCGAATCTAGAGA,96,100,4,11,2499,0,1
4320,ACGTCGAATCTAGAGA,96,100,4,13,2513,0,1
4321,ACGTCGAATCTGGAGA,96,100,4,14,2521,0,1
4323,ACCTCGAATCTAGAGA,96,100,4,11,2551,0,1
4324,ACGTCGAATCTAGAGA,96,100,4,11,2563,0,1
4325,ACGTCGAATCTAGAGA,96,100,4,14,2567,0,1
4326,ACGTCGAATCTAGAGA,96,100,4,12,2576,0,1
4328,ACGTCGAATCTAGAGA,96,100,4,11,2592,0,1
4329,ACGTCGAATCTAGAGA,96,100,4,13,2622,0,1
4330,ACGTCGAATCTAGAGA,96,100,4,10,2628,0,1
4331,ACGTCGAATCTAGAGA,96,100,4,14,2633,0,1
4332,ACGTCGAATCTAGAGA,96,100,4,12,2642,0,1
4334,ACGTCGAATCTAGAGA,96,100,4,15,2654,0,1
4335,ACGTCGAATCTAGAGA,96,100,4,16,2667,0,1
4336,ACGTCGAATCTAGAGA,96,100,4,13,2681,0,1
4339,ACGTTGAATCTAGAGA,96,100,4,10,2693,0,1
4342,ACGTCGAATCTAGAGA,96,100,4,12,2708,0,1
4343,ACGTCGAATCTAGAGA,96,100,4,14,2725,0,1
4344,ACGTCGAATCTAGAGA,96,100,4,13,2736,0,1
4346,ACGTCGAATCTAGAGA,96,100,4,14,2772,0,1
4347,ACGTCGAATCTAGAGA,96,100,4,11,2775,0,1
4348,TCGTCGAATCTAGAGA,96,100,4,11,2781,0,1
4349,ACGTCGAATCTAGAGA,96,100,4,12,2795,0,1
4350,ACGTCGAATCAAGAGA,96,100,4,12,2796,0,1
4351,ACGTCGAATCTAGAGA,96,100,4,12,2798,0,1
4352,ACGTCGAATCTAGAGA,96,100,4,10,2799,0,1
4353,ACGTCGAATCTAGAGA,96,100,4,13,2808,0,1
4354,ACGTCGAATCTAGAGA,96,100,4,9,2810,0,1
4355,ACGTCGAATCTAGAGA,96,100,4,9,2812,0,1
4356,ACGTCGAATCTAGAGA,96,100,4,14,2848,0,1
4359,ACGTCGAATCTTGAGA,96,100,4,15,3022,0,1
4360,ACGTCGAATCTAGAGA,96,100,4,15,3064,0,1
4361,ACGTCGAATCTAGAGA,97,100,3,9,185,0,1
4363,ACGTCGAATCTAAAGA,97,100,3,9,511,0,1
4364,ACGTCGAATCTAGAGA,97,100,3,12,523,0,1
4365,ACGTCGAATCTAGAGA,97,100,3,13,1297,0,1
4366,ACGTCGAATCTAGAGA,97,100,3,11,1416,0,1
4367,ACGTCGAATCTAGAGA,97,100,3,11,1439,0,1
4368,ACGTCGAATCTAGAGA,97,100,3,9,1590,0,1
4369,ACGTCGAATCTAGAGA,97,100,3,12,1622,0,1
4370,ACGTCGAATCTAGAGA,97,100,3,12,1677,0,1
4371,ACGTCGAATCTAGAGA,97,100,3,13,1770,0,1
4374,ACGTCGAATCTAGAGA,97,100,3,13,1795,0,1
4375,ACGTCGAATCTAGAGA,97,100,3,13,1799,0,1
4376,ACGTCGAATCTAGAGA,97,100,3,13,1817,0,1
4377,ACGTCGAATCTAGAGA,97,100,3,10,1841,0,1
4379,ACGTCGAATCTAGAGA,97,100,3,13,1858,0,1
4380,ACGTCGAATCTAGAGA,97,100,3,11,1865,0,1
4382,ACGTCGAATCTAGAGA,97,100,3,9,1976,0,1
4384,ACGTCGAATCTAGAGA,97,100,3,11,2314,0,1
4385,ACGTCGAATCTAGAGA,97,100,3,9,2580,0,1
4388,ACGTCGAATCTAGAGA,97,100,3,11,2760,0,1
4389,ACGTCGAATCTAGAGA,97,100,3,11,2783,0,1
4390,ACGTCGAATCTAGAGA,97,100,3,10,2806,0,1
4391,ACGTCGAATCTAGAGA,97,100,3,15,2813,0,1
4392,ACGTCGAATCTAGAGA,97,100,3,8,2817,0,1
4393,ACGTCGAATCTAGAGA,97,100,3,11,2821,0,1
4394,ACGTCGAATCTAGAGA,97,100,3,13,2833,0,1
4395,ACGGCGAATCTAGAGA,97,100,3,13,2834,0,1
4396,ACGTCGAACCTAGAGA,97,100,3,16,2835,0,1
4397,ACGTCGAATCTAGAGA,97,100,3,15,2841,0,1
4398,ACGTCGAATCTAGAGA,97,100,3,14,2852,0,1
4399,ACGTTGAATCTAGAGA,97,100,3,12,2856,0,1
4400,ACGTCGAATCTAGAGA,97,100,3,15,2867,0,1
4401,ACGTCGAATCAAGAGA,97,100,3,11,2873,0,1
4402,ACGTCGAATCTAGAGA,97,100,3,11,2884,0,1
4403,ACGTCGAATCTAAAGA,97,100,3,14,2887,0,1
4404,ACGTCGAATCTAGAGA,97,100,3,14,2888,0,1
4406,ACGTCGAATCTAGAGA,97,100,3,11,2920,0,1
4407,ACGTCGAATCTAGAGA,97,100,3,10,2962,0,1
4408,ACGTCGAATCTAGAGA,97,100,3,13,2974,0,1
4409,AGGTCGAATCTAGAGA,97,100,3,10,2975,0,1
4410,ACGTCGAATCTAGAGA,97,100,3,13,2978,0,1
4411,ACGTCGAATCTAGAGA,97,100,3,16,2979,0,1
4412,ACGTCGAATCTAGAGA,97,100,3,11,3009,0,1
4413,ACGTCGAATCTAGAGA,97,100,3,9,3011,0,1
4414,ACGTCGAATCTAGAGA,97,100,3,10,3013,0,1
4415,ACGTCGAATCTAGAGA,97,100,3,14,3023,0,1
4416,ACGTCGAATCTAGAGA,97,100,3,12,3025,0,1
4417,ACGTCGAATCTAGAGA,97,100,3,16,3029,0,1
4418,ACGTCGAATCTAGAGA,97,100,3,17,3030,0,1
4420,ACGTCGAATCTAGAGA,97,100,3,14,3042,0,1
4422,ACGTCGAATCTAGAGA,97,100,3,18,3044,0,1
4423,ACGTCGAATCTAGAGA,97,100,3,13,3051,0,1
4424,ACGTCGAATCTAGAGA,97,100,3,13,3055,0,1
4425,ACGTCGAATCAAGAGA,97,100,3,12,3058,0,1
4426,ACGTCGAATCTAGAGA,97,100,3,15,3060,0,1
4428,ACGTAGAATCTAGAGA,98,100,2,10,436,0,1
4429,ACGTCGAATCTAGAGA,98,100,2,10,444,0,1
4430,ACGTCGAATCTAGAGA,98,100,2,10,564,0,1
4431,ACGTCGAATCTGGAGA,98,100,2,13,584,0,1
4432,ACGTCGAATCTAGAGA,98,100,2,10,591,0,1
4433,ACGTCGAATCTAGAGA,98,100,2,11,856,0,1
4434,ACGTCGAATCTAGAGA,98,100,2,15,1212,0,1
4435,ACGTCGAATCTAGAGA,98,100,2,12,1221,0,1
4436,ACGTCGAATCTAGAGA,98,100,2,9,1223,0,1
4437,ACGTCGAATCTAGAGA,98,100,2,12,1224,0,1
4438,ACGTCGAATCTAGAGA,98,100,2,12,1235,0,1
4439,ACGTCGAATCTAGAGA,98,100,2,10,1295,0,1
4440,ACGTCGAATCTAGAGA,98,100,2,11,1488,0,1
4441,ACGTCGAATCTAGAGA,98,100,2,14,1533,0,1
4442,ACGTCGAATCTAGAGA,98,100,2,9,1682,0,1
4444,ACGTCGAATCTAGAGA,98,100,2,10,1725,0,1
4445,ACCTCGAATCTAGAGA,98,100,2,10,1744,0,1
4446,ACGTCGAATCTAGAGA,98,100,2,14,1882,0,1
4447,ACGTCGAATCTAGAGA,98,100,2,11,1962,0,1
4448,ACGTCGAATCTAGAGA,98,100,2,12,1993,0,1
4449,ACGTCGAATCTAGAGA,98,100,2,12,2006,0,1
4450,ACGTCGAATCTAGAGA,98,100,2,12,2013,0,1
4451,ACGTCGAATCTAGAGA,98,100,2,16,2142,0,1
4453,ACGTCGAATCTAGAGA,98,100,2,12,2167,0,1
4454,ACGTCGATTCTAGAGA,98,100,2,12,2189,0,1
4455,ACGTCGAACCTAGAGA,98,100,2,15,2191,0,1
4456,ACGTCGAATCTAGAGA,98,100,2,11,2213,0,1
4457,ACGTCGAATCTAGAGA,98,100,2,11,2214,0,1
4458,ACGTCGAATCTAAAGA,98,100,2,11,2217,0,1
4459,ACGTCGAATCTAGAGA,98,100,2,11,2233,0,1
4460,ACGTCGAATCTAGAGA,98,100,2,14,2245,0,1
4461,ACGTCGAATCTAGAGA,98,100,2,16,2257,0,1
4462,ACGTCGAATCTAGAGA,98,100,2,15,2265,0,1
4464,ACGTTGAATCTAGAGA,98,100,2,12,2296,0,1
4465,ACGTCGAATCTAGAGG,98,100,2,12,2298,0,1
4466,ACGTCGAACCTAGAGA,98,100,2,12,2301,0,1
4468,ACGTCGAATCTAGAAA,98,100,2,12,2361,0,1
4469,ACGTCGAATCTAGAGA,98,100,2,13,2367,0,1
4470,ACGTCGAATCTAGAGA,98,100,2,14,2373,0,1
4471,ACGTCGAATCTAGAGA,98,100,2,10,2388,0,1
4472,ACGTCGAATCTAGAGA,98,100,2,10,2390,0,1
4473,ACGTCGAATCTAGAGA,98,100,2,11,2722,0,1
4474,ACCTCGAATCTAGAGA,98,100,2,11,2723,0,1
4475,ACGTCGAATCTAGAGA,98,100,2,12,2901,0,1
4476,ACGTCGAATCAAGAGA,98,100,2,15,2956,0,1
4477,ACGTCGAATCTAGAGA,98,100,2,14,3005,0,1
4479,ACATCGAATCTAGAGA,98,100,2,14,3069,0,1
4480,ACGTCGAATCTAGAGA,98,100,2,10,3085,0,1
4481,ACGTCGAATCTAGAGA,98,100,2,13,3135,0,1
4484,ACGTCGAATCTAGAGA,98,100,2,11,3912,0,1
4485,ACGTCGAATCTAGAGA,98,100,2,11,3913,0,1
4486,ACGTCGAATCTAGAGA,98,100,2,11,3914,0,1
4487,ACGTCGAATCTAGAGA,99,100,1,10,982,0,1
4488,ACGTCGAATCTAGAGA,99,100,1,10,985,0,1
4489,ACGTCGAATCTAGAGA,99,100,1,13,986,0,1
4490,ACGTCAAATCTAGAGA,99,100,1,10,1031,0,1
4491,ACGTCGAATCTAGAGA,99,100,1,11,1062,0,1
4492,ACGTCGAATCTAGAGA,99,100,1,11,1068,0,1
4493,ACGTCGAATCTAGAGA,99,100,1,11,1076,0,1
4494,ACGTCGAATCTAGAGA,99,100,1,12,1272,0,1
4495,ACGTCGAATCTAGAGA,99,100,1,13,1332,0,1
4496,ACGTCGAATCTAGAGA,99,100,1,12,1553,0,1
4497,ACGTCGAATCTAGGGA,99,100,1,10,1759,0,1
4498,ACGTCGAATCTAGAGA,99,100,1,15,2003,0,1
4499,ACGTCGAATCTTGAGA,99,100,1,14,2177,0,1
4500,ACGTCGAATCTAGAGA,99,100,1,11,2375,0,1
4501,ACGTCGAATCTAGAGA,99,100,1,13,2421,0,1
4502,ACGTCGAATCTAGAGA,99,100,1,12,2425,0,1
4503,ACGTCGAATCTAGAGA,99,100,1,13,2445,0,1
4504,ACGTCGAATCTAGAGA,99,100,1,12,2462,0,1
4505,ACGTCGAATCTAGAGA,99,100,1,12,2464,0,1
4506,ACGTCGAATCTAGAGA,99,100,1,11,2509,0,1
4507,ACGTCGAATCTAGAGA,99,100,1,13,2513,0,1
4508,ACGTCGAATCTGGAGA,99,100,1,14,2521,0,1
4509,ACGTCGAATCTAGAGA,99,100,1,13,2546,0,1
4510,ACCTCGAATCTAGAGA,99,100,1,11,2551,0,1
4511,ACGTCGAATCTAGAGA,99,100,1,11,2563,0,1
4512,ACGTCGAATCTCGAGA,99,100,1,14,2567,0,1
4513,ACGTCGAATCTAGAGA,99,100,1,12,2576,0,1
4514,ACGTCGAACCTAGAGA,99,100,1,12,2583,0,1
4515,ACGTCGAATCTAGAGA,99,100,1,11,2592,0,1
4516,ACGTCGAATCTAGAGA,99,100,1,13,2622,0,1
4517,ACGTCGAATCTAGAGA,99,100,1,14,2633,0,1
4518,ACGTCGAATCTAGAGA,99,100,1,12,2642,0,1
4519,ACGTCGAATCTAGAGA,99,100,1,12,2644,0,1
4520,ACGTCGAATCTAGAGA,99,100,1,15,2654,0,1
4521,ACGTCGAATCTAGAGA,99,100,1,16,2667,0,1
4522,ACGTCGAATCTAGAGA,99,100,1,13,2688,0,1
4523,ACGTCGAATCTAGAGA,99,100,1,10,2693,0,1
4524,AGGTCGAATCTAGAGA,99,100,1,10,2694,0,1
4525,ACGTCGAATCTAGAGA,99,100,1,12,2708,0,1
4526,ACGTCGAATCTAGAGA,99,100,1,14,2725,0,1
4527,ACGTCGAATCTACAGA,99,100,1,13,2736,0,1
4528,ACGTCGAATCTAGAGA,99,100,1,15,2748,0,1
4529,ACGTCGAATCTAGAGA,99,100,1,11,2775,0,1
4530,ACGTCGAATCTAGAGA,99,100,1,12,2795,0,1
4531,ACGTCGAATCAAGAGA,99,100,1,12,2796,0,1
4532,ACGTCGAATCTAGAGA,99,100,1,12,2798,0,1
4533,ACGTCGAATCTAGAGA,99,100,1,10,2799,0,1
4534,ACGTCGAATCTAGAGA,99,100,1,9,2810,0,1
4535,ACGTGGAATCTAGAGA,99,100,1,9,2812,0,1
4536,ACGTCGAATCTAGAGA,99,100,1,14,2848,0,1
4537,ACGTCGAATCTAGAGA,99,100,1,10,2918,0,1
4538,ACGTCGAATCTAGAGA,99,100,1,13,2972,0,1
4539,ACGTCGAATCTTGAGA,99,100,1,15,3022,0,1
4540,ACGTCGAATCTAGAGA,99,100,1,13,3091,0,1
4541,ACGTCGAATCTAGAGA,99,100,1,11,3206,0,1
4542,ACGTCGAATCTAGAGA,99,100,1,10,3840,0,1
4543,ACGTCGAATCTAGAGA,99,100,1,15,3849,0,1
4544,ACGTCGAATCTAGAGA,99,100,1,12,3851,0,1
4545,ACGTCGAATCTAGAGA,99,100,1,16,3854,0,1
4546,ACGTCGAATCTAGAGA,99,100,1,13,3856,0,1
4547,ACGTCGAATCTCGAGA,99,100,1,10,3857,0,1
4548,ACGTCGAATCTAGAGG,99,100,1,10,3858,0,1
4549,ACGTCGAATCTAGAGA,99,100,1,13,3859,0,1
4550,ACGTCGAATCTAGAGA,99,100,1,14,3860,0,1
4551,ACGTCGAATCTAGAGA,99,100,1,14,3863,0,1
4552,ACGTCGAATCTAGAGA,99,100,1,14,3867,0,1
4553,ACGTCGAATCTAGAGA,99,100,1,14,3869,0,1
4554,ACGTCGAATCAAGAGA,99,100,1,14,3870,0,1
4555,ACGTCGTATCTAGAGA,99,100,1,14,3873,0,1
4556,ACGTCGAATCTAGAGA,99,100,1,12,3875,0,1
4557,ACGTCGAATCTAGAGA,99,100,1,12,3876,0,1
4558,ACGTCGAATCTAGAGA,99,100,1,10,3879,0,1
4559,ACGTCGAATCTAGAGA,99,100,1,11,3881,0,1
4560,ACGTGGAATCTAGAGA,99,100,1,12,3886,0,1
4561,ACGTCGAATCTAGAGA,99,100,1,13,3887,0,1
4562,ACGTCGAATCTAGAGA,99,100,1,17,3889,0,1
4563,ACGTCGAATCTAGAGA,99,100,1,13,3892,0,1
4564,ACGTCGAATCTAGAGA,99,100,1,18,3897,0,1
4565,ACGTCGAATCTAGAGA,99,100,1,14,3905,0,1
4566,ACGTCGAATCTAGAGA,99,100,1,13,3908,0,1
